ATCCACAGT.GCCATACAA	ATCCACAGT.GCCATACAA
ATCCATTAG.GGTCGGATA	ATCCATTAG.GGTCGGATA
ATCCGACCA.ATGCCTGTC	ATCCGACCA.ATGCCTGTC
ATCCGACCA.TAACTCCGA	ATCCGACCA.TAACTCCGA
ATCCGACCA.TACTAGTAG	ATCCGACCA.TACTAGTAG
ATCCGACCA.TCGCTTAAC	ATCCGACCA.TCGCTTAAC
ATCCGACCA.TTGAGCTCT	ATCCGACCA.TTGAGCTCT
ATCCGGTCC.ATGAGATCC	ATCCGGTCC.ATGAGATCC
ATCCGGTCC.CGTACACAC	ATCCGGTCC.CGTACACAC
ATCCGTCTC.ACAATTCGG	ATCCGTCTC.ACAATTCGG
ATCCGTCTC.CAATCATAC	ATCCGTCTC.CAATCATAC
ATCCGTCTC.CCACGAAGG	ATCCGTCTC.CCACGAAGG
ATCCGTCTC.TACAACACC	ATCCGTCTC.TACAACACC
ATCCTCCGA.TGGATAGGT	ATCCTCCGA.TGGATAGGT
ATCCTCCGA.TTGTTAGAG	ATCCTCCGA.TTGTTAGAG
ATCCTGCCT.CCTTGTTGC	ATCCTGCCT.CCTTGTTGC
ATCCTGCCT.CGCATCTAC	ATCCTGCCT.CGCATCTAC
ATCCTGCCT.GTAGTGGAG	ATCCTGCCT.GTAGTGGAG
ATCGAATCG.TCCAACGTG	ATCGAATCG.TCCAACGTG
ATCGCCTCT.ATGAGGTAT	ATCGCCTCT.ATGAGGTAT
ATCGCCTCT.TCTATGACA	ATCGCCTCT.TCTATGACA
ATCGTAGTG.CAACCTGGT	ATCGTAGTG.CAACCTGGT
ATCTACATC.ACAAGGTAC	ATCTACATC.ACAAGGTAC
ATCTACATC.TAACGGATA	ATCTACATC.TAACGGATA
ATCTACATC.TGACCTCCT	ATCTACATC.TGACCTCCT
ATCTAGGTT.TAGTCAGAC	ATCTAGGTT.TAGTCAGAC
ATCTAGGTT.TCCGATCTG	ATCTAGGTT.TCCGATCTG
ATCTCGAAC.ACTCATTCA	ATCTCGAAC.ACTCATTCA
ATCTCGAAC.ATGGACGTT	ATCTCGAAC.ATGGACGTT
ATCTCGAAC.TATGTACCT	ATCTCGAAC.TATGTACCT
ATCTCGTGA.AACAGCAGT	ATCTCGTGA.AACAGCAGT
ATCTCGTGA.CATACAACC	ATCTCGTGA.CATACAACC
ATCTCTGCT.CGCCACCAT	ATCTCTGCT.CGCCACCAT
ATCTCTGCT.GACGTCAAT	ATCTCTGCT.GACGTCAAT
ATCTCTGCT.GGAATTGGA	ATCTCTGCT.GGAATTGGA
ATCTCTGCT.GTTGACGTG	ATCTCTGCT.GTTGACGTG
ATCTCTGCT.TAGCACACG	ATCTCTGCT.TAGCACACG
ATCTGCGTA.TCTAGCTGG	ATCTGCGTA.TCTAGCTGG
ATCTGGTAG.AGGATCATG	ATCTGGTAG.AGGATCATG
ATCTGGTAG.CCGATCTCT	ATCTGGTAG.CCGATCTCT
ATCTTACAG.TAAGCCATT	ATCTTACAG.TAAGCCATT
ATGAACTAG.GCGCTACCT	ATGAACTAG.GCGCTACCT
ATGACACAA.CTCTCGATA	ATGACACAA.CTCTCGATA
ATGACACAA.CTTGTAACG	ATGACACAA.CTTGTAACG
ATGAGATCC.CTTCGTGCA	ATGAGATCC.CTTCGTGCA
ATGAGATCC.GTGGTACGG	ATGAGATCC.GTGGTACGG
ATGAGATCC.TACTTACCA	ATGAGATCC.TACTTACCA
ATGAGTGTG.AATGCAGCG	ATGAGTGTG.AATGCAGCG
ATGAGTGTG.ACTAACCGA	ATGAGTGTG.ACTAACCGA
ATGAGTGTG.AGCTTCGAT	ATGAGTGTG.AGCTTCGAT
ATGATAGCT.CTCTCGATA	ATGATAGCT.CTCTCGATA
ATGATAGCT.TAGCGCAGC	ATGATAGCT.TAGCGCAGC
ATGATAGCT.TTAAGTGGT	ATGATAGCT.TTAAGTGGT
ATGCAGTTC.ACCGGTTAC	ATGCAGTTC.ACCGGTTAC
ATGCAGTTC.GCGCTCTAT	ATGCAGTTC.GCGCTCTAT
ATGCAGTTC.TTCATTCGC	ATGCAGTTC.TTCATTCGC
ATGCGCCGT.AATCGTGTT	ATGCGCCGT.AATCGTGTT
ATGCGCCGT.ACAATTCGG	ATGCGCCGT.ACAATTCGG
ATGCGCCGT.TTCATTCGC	ATGCGCCGT.TTCATTCGC
ATGCGGATT.CATTATGTC	ATGCGGATT.CATTATGTC
ATGCGGATT.CCAAGCGAG	ATGCGGATT.CCAAGCGAG
ATGCTCACC.CGCATCTAC	ATGCTCACC.CGCATCTAC
ATGCTTCAG.ATCTTACAG	ATGCTTCAG.ATCTTACAG
ATGCTTCAG.GTACGCGAT	ATGCTTCAG.GTACGCGAT
ATGGACGTT.TCAATCTAG	ATGGACGTT.TCAATCTAG
ATGGAGAGT.CAATACCAC	ATGGAGAGT.CAATACCAC
ATGGAGAGT.CACGTAGAC	ATGGAGAGT.CACGTAGAC
ATGGAGGAA.TGATTGCTG	ATGGAGGAA.TGATTGCTG
ATGGATATC.ACTTCTTGG	ATGGATATC.ACTTCTTGG
ATGGTTCGA.CGTGAGACT	ATGGTTCGA.CGTGAGACT
ATGGTTCGA.GGTCGGATA	ATGGTTCGA.GGTCGGATA
ATGTCCTCC.GGATACCTA	ATGTCCTCC.GGATACCTA
ATGTCCTCC.GGTGTGACC	ATGTCCTCC.GGTGTGACC
ATGTCGCCT.CATCCTCTC	ATGTCGCCT.CATCCTCTC
ATGTCGCCT.CGACCTAGC	ATGTCGCCT.CGACCTAGC
ATTAAGACC.AAGGATACG	ATTAAGACC.AAGGATACG
ATTAAGACC.CCGAAGCGT	ATTAAGACC.CCGAAGCGT
ATTAAGACC.CGATTGAAC	ATTAAGACC.CGATTGAAC
ATTAGCGGT.TCACATACT	ATTAGCGGT.TCACATACT
ATTATGCAG.CAGTTACTG	ATTATGCAG.CAGTTACTG
ATTCACCTC.CGTTAATGG	ATTCACCTC.CGTTAATGG
ATTCACCTC.TCGGACAGT	ATTCACCTC.TCGGACAGT
ATTCATGTG.GACACGCAA	ATTCATGTG.GACACGCAA
ATTCATGTG.GATTAGTGT	ATTCATGTG.GATTAGTGT
ATTCATGTG.TGTGCTAAC	ATTCATGTG.TGTGCTAAC
ATTCCGTAC.CAGTGCCAT	ATTCCGTAC.CAGTGCCAT
ATTCCGTAC.TAGTGATCC	ATTCCGTAC.TAGTGATCC
ATTCCTACG.GTCTCCAGG	ATTCCTACG.GTCTCCAGG
ATTCCTACG.TAGGAGGAT	ATTCCTACG.TAGGAGGAT
ATTCCTACG.TATGATGTG	ATTCCTACG.TATGATGTG
ATTCGCTTA.CGGTGTTAC	ATTCGCTTA.CGGTGTTAC
ATTCGCTTA.TCCAGAACG	ATTCGCTTA.TCCAGAACG
ATTCTCTGG.GCAACACCT	ATTCTCTGG.GCAACACCT
ATTCTCTGG.GCCGAACCA	ATTCTCTGG.GCCGAACCA
ATTGACACG.ATCTAGGTT	ATTGACACG.ATCTAGGTT
ATTGATCAC.CGCCATTAC	ATTGATCAC.CGCCATTAC
ATTGATCAC.TAACCGTGA	ATTGATCAC.TAACCGTGA
ATTGCCGAC.CTGGACTAA	ATTGCCGAC.CTGGACTAA
ATTGCGCTA.ATGAGGTAT	ATTGCGCTA.ATGAGGTAT
ATTGCGCTA.CCGTCAGGT	ATTGCGCTA.CCGTCAGGT
ATTGCGCTA.CCTTCGAGC	ATTGCGCTA.CCTTCGAGC
ATTGGTTCC.ACAGGAACT	ATTGGTTCC.ACAGGAACT
ATTGGTTCC.GGTCGGTCT	ATTGGTTCC.GGTCGGTCT
ATTGGTTCC.GTGGACTGG	ATTGGTTCC.GTGGACTGG
CAACACCTA.CTGGACTAA	CAACACCTA.CTGGACTAA
CAACACTCC.GTGCACGAG	CAACACTCC.GTGCACGAG
CAACCGGTC.ACCAGCGTT	CAACCGGTC.ACCAGCGTT
CAACCGGTC.TCCTCGTCG	CAACCGGTC.TCCTCGTCG
CAACCTGGT.CGAGTAGCA	CAACCTGGT.CGAGTAGCA
CAACGATCG.CCTGACCTC	CAACGATCG.CCTGACCTC
CAACGTCTT.ACTGGTGCT	CAACGTCTT.ACTGGTGCT
CAACTCCAG.CCTGTCGAC	CAACTCCAG.CCTGTCGAC
CAACTCCAG.GATCTGAAT	CAACTCCAG.GATCTGAAT
CAACTCCAG.GTCAGTTGT	CAACTCCAG.GTCAGTTGT
CAAGAACCG.AATTGGATC	CAAGAACCG.AATTGGATC
CAAGAGAGT.AAGGAAGTC	CAAGAGAGT.AAGGAAGTC
CAAGCCTCG.CTAGTGCTG	CAAGCCTCG.CTAGTGCTG
CAAGCGCAT.TAATTCGTG	CAAGCGCAT.TAATTCGTG
CAAGCTGCA.ATGCGTGGA	CAAGCTGCA.ATGCGTGGA
CAAGGTGTG.TAAGCCATT	CAAGGTGTG.TAAGCCATT
CAAGGTGTG.TGATACCGT	CAAGGTGTG.TGATACCGT
CAAGTACGA.CCACGAAGG	CAAGTACGA.CCACGAAGG
CAAGTCACT.TAATCTGGA	CAAGTCACT.TAATCTGGA
CAAGTCACT.TAGCACACG	CAAGTCACT.TAGCACACG
CAAGTCACT.TCCAAGTAA	CAAGTCACT.TCCAAGTAA
CAAGTCGAA.CCTACTAGA	CAAGTCGAA.CCTACTAGA
CAAGTCGAA.GTGAATGCC	CAAGTCGAA.GTGAATGCC
CAATACCAC.TAGTGCACT	CAATACCAC.TAGTGCACT
CAATCAAGT.CCTGACCTC	CAATCAAGT.CCTGACCTC
CAATCAAGT.GCATACATG	CAATCAAGT.GCATACATG
CAATCATAC.AGAAGCTGC	CAATCATAC.AGAAGCTGC
CAATCATAC.CTCAGTGAT	CAATCATAC.CTCAGTGAT
CAATGCATT.AATCCGCTG	CAATGCATT.AATCCGCTG
CAATGCATT.CTGATGCAC	CAATGCATT.CTGATGCAC
CAATGCATT.GACACGCAA	CAATGCATT.GACACGCAA
CAATGTGCT.GGTCCTAAG	CAATGTGCT.GGTCCTAAG
CAATGTGCT.TAAGTGTAG	CAATGTGCT.TAAGTGTAG
CAATTGTCT.TACTTCCAG	CAATTGTCT.TACTTCCAG
CAATTGTCT.TCAAGCGTA	CAATTGTCT.TCAAGCGTA
CACAACCAG.CTTGGATCA	CACAACCAG.CTTGGATCA
CACAACGCT.CAAGGTGTG	CACAACGCT.CAAGGTGTG
CACAACGCT.CCATACGAT	CACAACGCT.CCATACGAT
CACAACGCT.GATGTCTAG	CACAACGCT.GATGTCTAG
CACACCACA.AGACCACGC	CACACCACA.AGACCACGC
CACACCACA.ATGGAGAGT	CACACCACA.ATGGAGAGT
CACACCACA.GGTTAGATG	CACACCACA.GGTTAGATG
CACACCTGT.GCCAACAAT	CACACCTGT.GCCAACAAT
CACACCTGT.TACCTCACT	CACACCTGT.TACCTCACT
CACAGCGAA.AGCTGCACT	CACAGCGAA.AGCTGCACT
CACAGCGAA.CAGGAGCCT	CACAGCGAA.CAGGAGCCT
CACAGCGAA.GACGTCAAT	CACAGCGAA.GACGTCAAT
CACAGCGAA.TATTGCTAC	CACAGCGAA.TATTGCTAC
CACAGCGAA.TGAACCAAT	CACAGCGAA.TGAACCAAT
CACATGTGC.AGAAGTAAC	CACATGTGC.AGAAGTAAC
CACATGTGC.GCATACATG	CACATGTGC.GCATACATG
CACATTCTG.GCGTGATAC	CACATTCTG.GCGTGATAC
CACCAAGAT.CTCCGCATT	CACCAAGAT.CTCCGCATT
CACCAAGAT.TATTCAACG	CACCAAGAT.TATTCAACG
CACCAAGAT.TCTTGGTAG	CACCAAGAT.TCTTGGTAG
CACCAGAAG.ATCATGTTC	CACCAGAAG.ATCATGTTC
CACCTACGC.CATAAGATC	CACCTACGC.CATAAGATC
CACCTACGC.GAATAAGAG	CACCTACGC.GAATAAGAG
CACCTAGCG.GCGATGGTG	CACCTAGCG.GCGATGGTG
CACCTAGCG.TCCAATCAT	CACCTAGCG.TCCAATCAT
CACCTCAAC.CCTGTATCT	CACCTCAAC.CCTGTATCT
CACCTCGGA.AGTGACGAT	CACCTCGGA.AGTGACGAT
CACCTCGGA.ATCATGTTC	CACCTCGGA.ATCATGTTC
CACCTCGGA.CAATCATAC	CACCTCGGA.CAATCATAC
CACCTCGGA.TGCGATACT	CACCTCGGA.TGCGATACT
CACCTTCCT.ACTCCGTCG	CACCTTCCT.ACTCCGTCG
CACCTTCCT.TGTAACAGT	CACCTTCCT.TGTAACAGT
CACGACTCA.ACCAGCGTT	CACGACTCA.ACCAGCGTT
CACGACTCA.GCGGACGAA	CACGACTCA.GCGGACGAA
CACGCGTAA.ATGAACTAG	CACGCGTAA.ATGAACTAG
CACGGAAGT.CATTCGAAT	CACGGAAGT.CATTCGAAT
CACGGATAG.AAGGATACG	CACGGATAG.AAGGATACG
CACGGATAG.TCCAACGTG	CACGGATAG.TCCAACGTG
CACGTAGAC.ACATTCCAC	CACGTAGAC.ACATTCCAC
CACGTAGAC.GTGGAGGTC	CACGTAGAC.GTGGAGGTC
CACGTAGAC.GTTAATTCG	CACGTAGAC.GTTAATTCG
CACGTAGAC.TACAACACC	CACGTAGAC.TACAACACC
CACGTAGAC.TCCTTCAAC	CACGTAGAC.TCCTTCAAC
CACGTAGAC.TGTGTAGAG	CACGTAGAC.TGTGTAGAG
CACGTAGAC.TTAGGAAGG	CACGTAGAC.TTAGGAAGG
CACGTCATA.GTCACAGAG	CACGTCATA.GTCACAGAG
CACTACAGG.TTGTTAGAG	CACTACAGG.TTGTTAGAG
CACTAGACT.GCTTAGAAC	CACTAGACT.GCTTAGAAC
CACTGCTTA.CTGTCACTT	CACTGCTTA.CTGTCACTT
CACTGGTCC.AGATGTTGG	CACTGGTCC.AGATGTTGG
CACTGTATC.CCGCAACAC	CACTGTATC.CCGCAACAC
CACTTCCTT.CAGTCTAAC	CACTTCCTT.CAGTCTAAC
CACTTCCTT.TTAAGTGGT	CACTTCCTT.TTAAGTGGT
CAGAAGTGA.CAAGCTGCA	CAGAAGTGA.CAAGCTGCA
CAGAAGTGA.GGAGTACAG	CAGAAGTGA.GGAGTACAG
CAGAGCACC.GCGCATTAC	CAGAGCACC.GCGCATTAC
CAGATCATT.ACCGCTGTG	CAGATCATT.ACCGCTGTG
CAGATCATT.GGTACGAGC	CAGATCATT.GGTACGAGC
CAGATCGAC.ACCGTACGC	CAGATCGAC.ACCGTACGC
CAGATCGAC.GATTCCTCT	CAGATCGAC.GATTCCTCT
CAGCACGTG.GATTGAGTA	CAGCACGTG.GATTGAGTA
CAGCACGTG.TTCCTAAGG	CAGCACGTG.TTCCTAAGG
CAGCAGTAC.ACATTGACA	CAGCAGTAC.ACATTGACA
CAGCAGTAC.TTCGTGATG	CAGCAGTAC.TTCGTGATG
CAGCGACGT.CACAACGCT	CAGCGACGT.CACAACGCT
CAGCGACGT.CATGGTCGA	CAGCGACGT.CATGGTCGA
CAGCGACGT.GCCATACAA	CAGCGACGT.GCCATACAA
CAGCGACGT.GCGCTTCTC	CAGCGACGT.GCGCTTCTC
CAGCGACGT.TGTTAAGCC	CAGCGACGT.TGTTAAGCC
CAGCGTAAG.CTATCTTGA	CAGCGTAAG.CTATCTTGA
CAGCGTAAG.TACCGCGTT	CAGCGTAAG.TACCGCGTT
CAGCTAGTT.CTTCACTGT	CAGCTAGTT.CTTCACTGT
CAGCTGGAG.CGATTGAAC	CAGCTGGAG.CGATTGAAC
CAGCTTACC.ATCACCGCA	CAGCTTACC.ATCACCGCA
CAGCTTCGA.CTGCTTAGG	CAGCTTCGA.CTGCTTAGG
CAGCTTCGA.GGAGCATCT	CAGCTTCGA.GGAGCATCT
CAGCTTCGA.TTCCAGATT	CAGCTTCGA.TTCCAGATT
CAGGAGCCT.GGATGCGAA	CAGGAGCCT.GGATGCGAA
CAGGATCAA.AATTAGAGG	CAGGATCAA.AATTAGAGG
CAGGATCAA.ATAGCCTAA	CAGGATCAA.ATAGCCTAA
CAGGATCAA.TGTGCCATG	CAGGATCAA.TGTGCCATG
CAGGTATCG.ACACTAACG	CAGGTATCG.ACACTAACG
CAGGTTGTC.GCAGCTTGA	CAGGTTGTC.GCAGCTTGA
CAGTAATGT.AAGGTGCTG	CAGTAATGT.AAGGTGCTG
CAGTAATGT.ATAATCGAG	CAGTAATGT.ATAATCGAG
CAGTAATGT.GGTCGGATA	CAGTAATGT.GGTCGGATA
CAGTAATGT.TTACGGACC	CAGTAATGT.TTACGGACC
CAGTATGAT.CATGGTTAC	CAGTATGAT.CATGGTTAC
CAGTCCTAA.ACATCGTCC	CAGTCCTAA.ACATCGTCC
CAGTCGGTA.CCATACGAT	CAGTCGGTA.CCATACGAT
CAGTCTAAC.CTTCCGTGG	CAGTCTAAC.CTTCCGTGG
CAGTCTAAC.TGCGTATCT	CAGTCTAAC.TGCGTATCT
CAGTGCCAT.ACGGACCAT	CAGTGCCAT.ACGGACCAT
CAGTGCCAT.ATCTACATC	CAGTGCCAT.ATCTACATC
CAGTGCCAT.CCGTTAGAC	CAGTGCCAT.CCGTTAGAC
CAGTTACTG.TAGAGCGTC	CAGTTACTG.TAGAGCGTC
CAGTTGAGT.GCCTGGAAT	CAGTTGAGT.GCCTGGAAT
CAGTTGAGT.TCGCTGATT	CAGTTGAGT.TCGCTGATT
CATAAGATC.CTGCGTCAC	CATAAGATC.CTGCGTCAC
CATACAACC.CCACGAAGG	CATACAACC.CCACGAAGG
CATACAACC.GGTACTTCC	CATACAACC.GGTACTTCC
CATAGGTGT.ATACGAGGT	CATAGGTGT.ATACGAGGT
CATAGGTGT.TATGCCTTC	CATAGGTGT.TATGCCTTC
CATAGGTGT.TGGAGAGTG	CATAGGTGT.TGGAGAGTG
CATAGTATG.CACGACTCA	CATAGTATG.CACGACTCA
CATATGCGA.ATAGTGGTT	CATATGCGA.ATAGTGGTT
CATATGCGA.GCTGTTCGG	CATATGCGA.GCTGTTCGG
CATATGTCG.AAGACTGGT	CATATGTCG.AAGACTGGT
CATATGTCG.AGATGTTGG	CATATGTCG.AGATGTTGG
CATATGTCG.CAGCACGTG	CATATGTCG.CAGCACGTG
CATCAATAG.CATAATTGG	CATCAATAG.CATAATTGG
CATCCACCG.ACTGGACCA	CATCCACCG.ACTGGACCA
CATCCACCG.GAAGGATCA	CATCCACCG.GAAGGATCA
CATCCAGGA.CAACACTCC	CATCCAGGA.CAACACTCC
CATCCAGGA.CTATACTAG	CATCCAGGA.CTATACTAG
CATCCGACA.CTCGCTACG	CATCCGACA.CTCGCTACG
CATCCGACA.GTAACAGTC	CATCCGACA.GTAACAGTC
CATCCTCTC.GATCTACTT	CATCCTCTC.GATCTACTT
CATCGAAGC.GTACAATGC	CATCGAAGC.GTACAATGC
CATCGAAGC.GTGTCCGTG	CATCGAAGC.GTGTCCGTG
CATCGAAGC.TTGATGAGT	CATCGAAGC.TTGATGAGT
CATCGCTGG.AACAGCAGT	CATCGCTGG.AACAGCAGT
CATCGCTGG.CGTGTGTGG	CATCGCTGG.CGTGTGTGG
CATCGCTGG.GAACGCTGT	CATCGCTGG.GAACGCTGT
CATCTCACG.CAGCGACGT	CATCTCACG.CAGCGACGT
CATCTCACG.TCCGATAAC	CATCTCACG.TCCGATAAC
CATCTCGAT.CAGGAGCCT	CATCTCGAT.CAGGAGCCT
CATCTCGAT.CGGTAGCTT	CATCTCGAT.CGGTAGCTT
CATCTCGAT.GTAAGGTCC	CATCTCGAT.GTAAGGTCC
CATGACGTT.AATCTGACC	CATGACGTT.AATCTGACC
CATGACGTT.CCAACAACA	CATGACGTT.CCAACAACA
CATGACGTT.GTGATGTGC	CATGACGTT.GTGATGTGC
CATGCCAGT.AGAAGCTGC	CATGCCAGT.AGAAGCTGC
CATGGACTC.TATCACCTG	CATGGACTC.TATCACCTG
CATGGTTAC.AATAACTCC	CATGGTTAC.AATAACTCC
CATGGTTAC.AGAGAGTGG	CATGGTTAC.AGAGAGTGG
CATGGTTAC.CTCCACGTC	CATGGTTAC.CTCCACGTC
CATGGTTAC.TATGAGACC	CATGGTTAC.TATGAGACC
CATGTCCTG.CACCTTCCT	CATGTCCTG.CACCTTCCT
CATGTCCTG.GTTGCATGG	CATGTCCTG.GTTGCATGG
CATGTGAAC.GAACCAGTT	CATGTGAAC.GAACCAGTT
CATTCAGTT.AGCTCGTCT	CATTCAGTT.AGCTCGTCT
CATTCAGTT.AGTCATACT	CATTCAGTT.AGTCATACT
CATTCAGTT.GTAGCTACA	CATTCAGTT.GTAGCTACA
CATTCAGTT.TGAACGGTT	CATTCAGTT.TGAACGGTT
CATTCCGAG.CAGGAGCCT	CATTCCGAG.CAGGAGCCT
CATTCGAAT.ACACAGAAC	CATTCGAAT.ACACAGAAC
CATTCGAAT.GTTAATTCG	CATTCGAAT.GTTAATTCG
CATTGACAA.AGAAGTAAC	CATTGACAA.AGAAGTAAC
CCAACAACA.GCATGTGGT	CCAACAACA.GCATGTGGT
CCAACGGAA.ACGTGAATC	CCAACGGAA.ACGTGAATC
CCAACGGAA.TGATGTGTG	CCAACGGAA.TGATGTGTG
CCAACGGAA.TTAGTCGGA	CCAACGGAA.TTAGTCGGA
CCAAGCGAG.TGTGTCTAC	CCAAGCGAG.TGTGTCTAC
CCAAGTCGA.CATTGACAA	CCAAGTCGA.CATTGACAA
CCAAGTCGA.CCGAGTACT	CCAAGTCGA.CCGAGTACT
CCAATATAC.TTGTCAACC	CCAATATAC.TTGTCAACC
CCACAAGGT.AGACGCTAT	CCACAAGGT.AGACGCTAT
CCACAAGGT.ATCTTACAG	CCACAAGGT.ATCTTACAG
CCACACAGA.ATATCAGCC	CCACACAGA.ATATCAGCC
CCACGAAGG.ACACACCGT	CCACGAAGG.ACACACCGT
CCACGAAGG.CAACACTCC	CCACGAAGG.CAACACTCC
CCACGCCAT.CAGAAGTGA	CCACGCCAT.CAGAAGTGA
CCACGCCAT.TAGGATTAG	CCACGCCAT.TAGGATTAG
CCACGTTCT.AACTTCTGC	CCACGTTCT.AACTTCTGC
CCACGTTCT.CATAGGTGT	CCACGTTCT.CATAGGTGT
CCACTACCA.AAGCAGCAT	CCACTACCA.AAGCAGCAT
CCACTTCGC.CCGCTATCC	CCACTTCGC.CCGCTATCC
CCACTTCGC.CTTCGACTG	CCACTTCGC.CTTCGACTG
CCAGATCAC.ATGAGCAGG	CCAGATCAC.ATGAGCAGG
CCAGATCAC.CCACTGAAG	CCAGATCAC.CCACTGAAG
CCAGATCAC.CCAGTCTCA	CCAGATCAC.CCAGTCTCA
CCAGATCAC.CCATATGCC	CCAGATCAC.CCATATGCC
CCAGATCAC.GTCATTCTA	CCAGATCAC.GTCATTCTA
CCAGCCAAT.GTAACAGTC	CCAGCCAAT.GTAACAGTC
CCAGCCAAT.TCCTTAGGT	CCAGCCAAT.TCCTTAGGT
CCAGGAGTT.GGATAGTCA	CCAGGAGTT.GGATAGTCA
CCAGTACTC.AAGCCACAC	CCAGTACTC.AAGCCACAC
CCAGTACTC.ACGTCGCTC	CCAGTACTC.ACGTCGCTC
CCAGTCTCA.CAACACCTA	CCAGTCTCA.CAACACCTA
CCAGTCTCA.CTGTGCTCA	CCAGTCTCA.CTGTGCTCA
CCATAAGTA.GCTTACTAG	CCATAAGTA.GCTTACTAG
CCATAAGTA.TGACAAGTT	CCATAAGTA.TGACAAGTT
CCATAATCG.AATGCACTT	CCATAATCG.AATGCACTT
CCATAATCG.CGTGGTACC	CCATAATCG.CGTGGTACC
CCATAATCG.CTTGCACAA	CCATAATCG.CTTGCACAA
CCATAATCG.GACCTTGTG	CCATAATCG.GACCTTGTG
CCATACGAT.TGTTACTGA	CCATACGAT.TGTTACTGA
CCATAGCCA.ACTCCGTCG	CCATAGCCA.ACTCCGTCG
CCATATCTT.GACTCAGTG	CCATATCTT.GACTCAGTG
CCATATGCC.AGCACCAGC	CCATATGCC.AGCACCAGC
CCATATGCC.AGTTCAACC	CCATATGCC.AGTTCAACC
CCATCACGA.CCATGCGTC	CCATCACGA.CCATGCGTC
CCATCTAGG.AGTACTCTC	CCATCTAGG.AGTACTCTC
CCATGATGT.ATCAGTCGA	CCATGATGT.ATCAGTCGA
CCATGATGT.GCGTATAGG	CCATGATGT.GCGTATAGG
CCATGATGT.GCTGATGTC	CCATGATGT.GCTGATGTC
CCATGCGTC.AGCACCGTG	CCATGCGTC.AGCACCGTG
CCATGCGTC.ATGTCCTCC	CCATGCGTC.ATGTCCTCC
CCATGCGTC.CTTACCTAG	CCATGCGTC.CTTACCTAG
CCATGCGTC.TCATGCAGG	CCATGCGTC.TCATGCAGG
CCATTACAG.ACCATGTCT	CCATTACAG.ACCATGTCT
CCGAAGCGT.CGAACAGAG	CCGAAGCGT.CGAACAGAG
CCGAAGCGT.CTCCTGACG	CCGAAGCGT.CTCCTGACG
CCGAAGCGT.GACGCCGTA	CCGAAGCGT.GACGCCGTA
CCGAAGCGT.GGATGCTCG	CCGAAGCGT.GGATGCTCG
CCGACGTCA.ACTGGTGCT	CCGACGTCA.ACTGGTGCT
CCGACGTCA.CGTATAGCG	CCGACGTCA.CGTATAGCG
CCGACTGTT.CCTGTTAGC	CCGACTGTT.CCTGTTAGC
CCGACTGTT.TCACTACGT	CCGACTGTT.TCACTACGT
CCGACTTGG.CCTCCAATC	CCGACTTGG.CCTCCAATC
CCGAGCTGA.AACGATGAC	CCGAGCTGA.AACGATGAC
CCGAGCTGA.CTATGGATG	CCGAGCTGA.CTATGGATG
CCGAGCTGA.CTCTTCAGC	CCGAGCTGA.CTCTTCAGC
CCGAGCTGA.GTTCCAACA	CCGAGCTGA.GTTCCAACA
CCGAGTACT.GTATGTATC	CCGAGTACT.GTATGTATC
CCGATCAGC.TACAGGACT	CCGATCAGC.TACAGGACT
CCGATGTTC.CTTACATGC	CCGATGTTC.CTTACATGC
CCGCAACAC.GATCTAGAG	CCGCAACAC.GATCTAGAG
CCGCAACAC.GGATACAAT	CCGCAACAC.GGATACAAT
CCGCAATGG.ACAGAGATG	CCGCAATGG.ACAGAGATG
CCGCAATGG.GTAGAGAGC	CCGCAATGG.GTAGAGAGC
CCGCACTCA.CTCTAGTAA	CCGCACTCA.CTCTAGTAA
CCGCACTCA.GACACCGAT	CCGCACTCA.GACACCGAT
CCGCAGAAT.TCACAGGTA	CCGCAGAAT.TCACAGGTA
CCGCAGCTA.CACAGCGAA	CCGCAGCTA.CACAGCGAA
CCGCATCCT.TCCAGCAGC	CCGCATCCT.TCCAGCAGC
CCGCTATCC.AGTCGATCA	CCGCTATCC.AGTCGATCA
CCGCTCATG.AGATGAGAT	CCGCTCATG.AGATGAGAT
CCGCTCATG.GAACTGCAA	CCGCTCATG.GAACTGCAA
CCGGATTGC.ACTCTGCTC	CCGGATTGC.ACTCTGCTC
CCGGATTGC.GTAACAGTC	CCGGATTGC.GTAACAGTC
CCGGTGGTT.GCCACGAGT	CCGGTGGTT.GCCACGAGT
CCGGTGGTT.GCCGTCTTC	CCGGTGGTT.GCCGTCTTC
CCGGTGGTT.GTACGTCTA	CCGGTGGTT.GTACGTCTA
CCGGTTCTA.AATCTCCTA	CCGGTTCTA.AATCTCCTA
CCGGTTGAG.TTATCCAAG	CCGGTTGAG.TTATCCAAG
CCGTACGGA.TCCACCGGT	CCGTACGGA.TCCACCGGT
CCGTCAGGT.AGTCCAGTG	CCGTCAGGT.AGTCCAGTG
CCGTTAGAC.AATGCTATC	CCGTTAGAC.AATGCTATC
CCGTTAGAC.TGAACGTCA	CCGTTAGAC.TGAACGTCA
CCGTTCCAA.CCGATCTCT	CCGTTCCAA.CCGATCTCT
CCGTTCCAA.CGTGTGTGG	CCGTTCCAA.CGTGTGTGG
CCTAAGTCT.ATAGAGCAG	CCTAAGTCT.ATAGAGCAG
CCTAAGTCT.ATGAACTAG	CCTAAGTCT.ATGAACTAG
CCTAAGTCT.CGTTGATCC	CCTAAGTCT.CGTTGATCC
CCTAAGTCT.TCACTACGT	CCTAAGTCT.TCACTACGT
CCTACTAGA.AGGTCCGTC	CCTACTAGA.AGGTCCGTC
CCTAGAGTA.CTGAGATAG	CCTAGAGTA.CTGAGATAG
CCTAGCAAT.CTTCCGGTA	CCTAGCAAT.CTTCCGGTA
CCTAGCAAT.GTATCCTGC	CCTAGCAAT.GTATCCTGC
CCTAGTCTC.CGAAGAGGT	CCTAGTCTC.CGAAGAGGT
CCTAGTCTC.CTATTAAGG	CCTAGTCTC.CTATTAAGG
CCTAGTCTC.GTCAGCGTC	CCTAGTCTC.GTCAGCGTC
CCTAGTTAG.TGAACGGTT	CCTAGTTAG.TGAACGGTT
CCTAGTTAG.TTATTCGAC	CCTAGTTAG.TTATTCGAC
CCTATTGGT.CATAGGTGT	CCTATTGGT.CATAGGTGT
CCTCAGGTG.AAGACGAAG	CCTCAGGTG.AAGACGAAG
CCTCATAAC.AGAGCCGCA	CCTCATAAC.AGAGCCGCA
CCTCATAAC.CGTGCTTGA	CCTCATAAC.CGTGCTTGA
CCTCATAAC.GATAAGCTG	CCTCATAAC.GATAAGCTG
CCTCGACCT.ATTCACCTC	CCTCGACCT.ATTCACCTC
CCTCGACCT.TAATGTAGC	CCTCGACCT.TAATGTAGC
CCTCGAGAG.ACCATTCAC	CCTCGAGAG.ACCATTCAC
CCTCGAGAG.GTCGTTGCG	CCTCGAGAG.GTCGTTGCG
CCTCGAGAG.TGGTCTACG	CCTCGAGAG.TGGTCTACG
CCTCGCGTT.CCGTCCACT	CCTCGCGTT.CCGTCCACT
CCTCGCGTT.CGATTCGAG	CCTCGCGTT.CGATTCGAG
CCTCGGTCA.CCAGGAGTT	CCTCGGTCA.CCAGGAGTT
CCTCTCTAG.CGAGTAGCA	CCTCTCTAG.CGAGTAGCA
CCTCTGCAT.ATATGCAGC	CCTCTGCAT.ATATGCAGC
CCTCTGCAT.GCAGCTTGA	CCTCTGCAT.GCAGCTTGA
CCTCTTGTA.CCATGCGTC	CCTCTTGTA.CCATGCGTC
CCTGACCTC.ACAGCATCA	CCTGACCTC.ACAGCATCA
CCTGACCTC.CAGCTAGTT	CCTGACCTC.CAGCTAGTT
CCTGACCTC.CCATGCGTC	CCTGACCTC.CCATGCGTC
CCTGACCTC.GTGTCGAGC	CCTGACCTC.GTGTCGAGC
CCTGCAGAT.ATCAGAAGC	CCTGCAGAT.ATCAGAAGC
CCTGCAGAT.GAGGTCACG	CCTGCAGAT.GAGGTCACG
CCTGCAGAT.TAGAGACTA	CCTGCAGAT.TAGAGACTA
CCTGCAGAT.TTGTAATGC	CCTGCAGAT.TTGTAATGC
CCTGCGTTA.ATGCTGTCG	CCTGCGTTA.ATGCTGTCG
CCTGTATCT.ACGCTAGTG	CCTGTATCT.ACGCTAGTG
CCTGTATCT.CTATTAAGG	CCTGTATCT.CTATTAAGG
CCTGTATCT.TGCAACTCT	CCTGTATCT.TGCAACTCT
CCTGTCATT.ACTGGTGCT	CCTGTCATT.ACTGGTGCT
CCTGTCGAC.TACTTCCAG	CCTGTCGAC.TACTTCCAG
CCTGTTAGC.AGTATGACG	CCTGTTAGC.AGTATGACG
CCTGTTAGC.ATACCGCTT	CCTGTTAGC.ATACCGCTT
CCTGTTAGC.TTCCAGATT	CCTGTTAGC.TTCCAGATT
CCTTAACAT.ACTCTAGGA	CCTTAACAT.ACTCTAGGA
CCTTAACAT.GGATTACGC	CCTTAACAT.GGATTACGC
CCTTCCTCA.GATCGATAC	CCTTCCTCA.GATCGATAC
CCTTCGAGC.ATGGAGGAA	CCTTCGAGC.ATGGAGGAA
CCTTGACGG.AGTTGTGTA	CCTTGACGG.AGTTGTGTA
CCTTGTTGC.ACTACTCAT	CCTTGTTGC.ACTACTCAT
CCTTGTTGC.CTTGATCTA	CCTTGTTGC.CTTGATCTA
CGAACAATC.TCCGGAGCT	CGAACAATC.TCCGGAGCT
CGAAGAGGT.AAGCTGGTC	CGAAGAGGT.AAGCTGGTC
CGAAGAGGT.CGCCACCAT	CGAAGAGGT.CGCCACCAT
CGAATGAGT.CTGCGTCAC	CGAATGAGT.CTGCGTCAC
CGACAGACC.TAGTGCACT	CGACAGACC.TAGTGCACT
CGACAGGAA.ATCATAGAC	CGACAGGAA.ATCATAGAC
CGACCACTT.AGTAGAGGA	CGACCACTT.AGTAGAGGA
CGACCACTT.ATCAGTCGA	CGACCACTT.ATCAGTCGA
CGACCACTT.GGTTGCTAT	CGACCACTT.GGTTGCTAT
CGACCATCA.TTCGCATCC	CGACCATCA.TTCGCATCC
CGACCATCA.TTCTGAATG	CGACCATCA.TTCTGAATG
CGACCTAGC.GTAGGACGC	CGACCTAGC.GTAGGACGC
CGACCTGTA.CTGATGCAC	CGACCTGTA.CTGATGCAC
CGACCTGTA.GTAATATCG	CGACCTGTA.GTAATATCG
CGACGTGAT.ACCATACTT	CGACGTGAT.ACCATACTT
CGAGCCGTT.CAACGCACA	CGAGCCGTT.CAACGCACA
CGAGCTTAC.CAGAGCACC	CGAGCTTAC.CAGAGCACC
CGATACTCT.TTGCTCTGC	CGATACTCT.TTGCTCTGC
CGATCCAGA.TCTTAGCGA	CGATCCAGA.TCTTAGCGA
CGATTCGAG.CGACGTGAT	CGATTCGAG.CGACGTGAT
CGATTGAAC.AGCCTCGCA	CGATTGAAC.AGCCTCGCA
CGATTGAAC.TAGATAGCC	CGATTGAAC.TAGATAGCC
CGCAACCTC.GTATACAGA	CGCAACCTC.GTATACAGA
CGCAATCGA.CAATCAAGT	CGCAATCGA.CAATCAAGT
CGCACTCTT.AGAGCGGAG	CGCACTCTT.AGAGCGGAG
CGCACTCTT.GAGTTATAG	CGCACTCTT.GAGTTATAG
CGCACTCTT.GGTTGCTAT	CGCACTCTT.GGTTGCTAT
CGCACTCTT.TCTGCAACA	CGCACTCTT.TCTGCAACA
CGCACTGAA.ATGGATATC	CGCACTGAA.ATGGATATC
CGCAGTGTC.GAGTGTGCC	CGCAGTGTC.GAGTGTGCC
CGCAGTGTC.GGTAAGGAT	CGCAGTGTC.GGTAAGGAT
CGCATAACT.AATTGGATC	CGCATAACT.AATTGGATC
CGCATAACT.CTGAGTCCA	CGCATAACT.CTGAGTCCA
CGCATCTAC.GATACACTA	CGCATCTAC.GATACACTA
CGCCACCAT.ATGGATATC	CGCCACCAT.ATGGATATC
CGCCTGCAA.ACTCGTAGG	CGCCTGCAA.ACTCGTAGG
CGCCTGCAA.TGTGTCTAC	CGCCTGCAA.TGTGTCTAC
CGCGAGTGT.AACGGAGAT	CGCGAGTGT.AACGGAGAT
CGCGAGTGT.GTCAGTTGT	CGCGAGTGT.GTCAGTTGT
CGCGATGTA.ACACATCTG	CGCGATGTA.ACACATCTG
CGCGATGTA.TAGAGCGTC	CGCGATGTA.TAGAGCGTC
CGCGTGAGA.ACTAACCGA	CGCGTGAGA.ACTAACCGA
CGCGTGAGA.CTCATTAGT	CGCGTGAGA.CTCATTAGT
CGCTGTAGT.ATGAGTGTG	CGCTGTAGT.ATGAGTGTG
CGCTTATGA.CTACGTTGG	CGCTTATGA.CTACGTTGG
CGCTTATGA.TTGTTAGAG	CGCTTATGA.TTGTTAGAG
CGGAACGAG.ATAATCGAG	CGGAACGAG.ATAATCGAG
CGGAACGAG.GGAGAATGA	CGGAACGAG.GGAGAATGA
CGGAACGAG.TTGTCAACC	CGGAACGAG.TTGTCAACC
CGGAAGACG.CACTTGGAT	CGGAAGACG.CACTTGGAT
CGGAAGACG.CTGACGATG	CGGAAGACG.CTGACGATG
CGGAATGCA.CTAGGTACT	CGGAATGCA.CTAGGTACT
CGGACAAGT.ACACTGTGA	CGGACAAGT.ACACTGTGA
CGGACAAGT.GCCTTAGAG	CGGACAAGT.GCCTTAGAG
CGGAGACTT.ATATGCAGC	CGGAGACTT.ATATGCAGC
CGGAGACTT.ATGCCTGTC	CGGAGACTT.ATGCCTGTC
CGGAGACTT.GATATGGAC	CGGAGACTT.GATATGGAC
CGGTAGCTT.CAACCTGGT	CGGTAGCTT.CAACCTGGT
CGGTGAGTC.GAATCACAT	CGGTGAGTC.GAATCACAT
CGGTGAGTC.GTAGCATAC	CGGTGAGTC.GTAGCATAC
CGGTGTTAC.CAATTGTCT	CGGTGTTAC.CAATTGTCT
CGGTGTTAC.GAGATTCCT	CGGTGTTAC.GAGATTCCT
CGGTTCGTA.AATTAGAGG	CGGTTCGTA.AATTAGAGG
CGGTTCGTA.ATATGCAGC	CGGTTCGTA.ATATGCAGC
