TCACGACAA.ACCGTACGC	TCACGACAA.ACCGTACGC
TCACGACAA.GTATTACTG	TCACGACAA.GTATTACTG
TCACGACAA.GTCTTATGC	TCACGACAA.GTCTTATGC
TCACGACAA.GTGAGGACG	TCACGACAA.GTGAGGACG
TCACGACAA.TCGCGTCAT	TCACGACAA.TCGCGTCAT
TCACGACAA.TGGAATCGT	TCACGACAA.TGGAATCGT
TCACGACAA.TTACGCTCG	TCACGACAA.TTACGCTCG
TCACGCGAC.ATCAGTCGA	TCACGCGAC.ATCAGTCGA
TCACGCGAC.GTGACGTAA	TCACGCGAC.GTGACGTAA
TCACTACGT.AGCTCTCCG	TCACTACGT.AGCTCTCCG
TCACTACGT.CATCTCGAT	TCACTACGT.CATCTCGAT
TCACTCGCT.ACGAGCTTC	TCACTCGCT.ACGAGCTTC
TCACTCGCT.CCGTTCCAA	TCACTCGCT.CCGTTCCAA
TCACTCGCT.CTCCAGCGT	TCACTCGCT.CTCCAGCGT
TCACTCGCT.GACGCCGTA	TCACTCGCT.GACGCCGTA
TCACTCGCT.TAGTACGTA	TCACTCGCT.TAGTACGTA
TCAGACAAG.CATAGGTGT	TCAGACAAG.CATAGGTGT
TCAGACAAG.CGTCTGCTG	TCAGACAAG.CGTCTGCTG
TCAGACAAG.TAGTACGTA	TCAGACAAG.TAGTACGTA
TCAGAGCGT.AAGTTGCCA	TCAGAGCGT.AAGTTGCCA
TCAGAGCGT.ATTCGAAGA	TCAGAGCGT.ATTCGAAGA
TCAGAGCGT.CCATCACGA	TCAGAGCGT.CCATCACGA
TCAGAGCGT.GGAACCTAG	TCAGAGCGT.GGAACCTAG
TCAGAGTCA.AGTGTGCAC	TCAGAGTCA.AGTGTGCAC
TCAGAGTCA.ATCAGTCGA	TCAGAGTCA.ATCAGTCGA
TCAGAGTCA.CACAATAAC	TCAGAGTCA.CACAATAAC
TCAGAGTCA.CGTTAATGG	TCAGAGTCA.CGTTAATGG
TCAGAGTCA.GCTACCGAG	TCAGAGTCA.GCTACCGAG
TCAGAGTCA.TAGACCTAC	TCAGAGTCA.TAGACCTAC
TCAGAGTCA.TTATCCAAG	TCAGAGTCA.TTATCCAAG
TCAGCGACC.ATTCGCTTA	TCAGCGACC.ATTCGCTTA
TCAGCGACC.GCGCTAGAA	TCAGCGACC.GCGCTAGAA
TCAGCGACC.TAACACATC	TCAGCGACC.TAACACATC
TCAGCTCAG.AGAGCCGCA	TCAGCTCAG.AGAGCCGCA
TCAGCTCAG.CTCAGCTGG	TCAGCTCAG.CTCAGCTGG
TCAGCTCAG.GGAATTCAC	TCAGCTCAG.GGAATTCAC
TCAGCTCAG.GTGTTGGAA	TCAGCTCAG.GTGTTGGAA
TCAGCTCAG.TAACTCCGA	TCAGCTCAG.TAACTCCGA
TCAGCTCAG.TCATATCGC	TCAGCTCAG.TCATATCGC
TCAGGACTG.CACAGCGAA	TCAGGACTG.CACAGCGAA
TCAGGACTG.TCGTAGGAA	TCAGGACTG.TCGTAGGAA
TCAGGTGCA.ACAAGAATG	TCAGGTGCA.ACAAGAATG
TCAGGTGCA.ACGTAGTAT	TCAGGTGCA.ACGTAGTAT
TCAGGTGCA.ATAATGTGG	TCAGGTGCA.ATAATGTGG
TCAGGTGCA.ATACGAGGT	TCAGGTGCA.ATACGAGGT
TCAGGTGCA.ATGAGCAGG	TCAGGTGCA.ATGAGCAGG
TCAGGTGCA.CACTACAGG	TCAGGTGCA.CACTACAGG
TCAGGTGCA.TATTGCTAC	TCAGGTGCA.TATTGCTAC
TCAGTAAGC.CACTAGACT	TCAGTAAGC.CACTAGACT
TCAGTAAGC.CACTCACTA	TCAGTAAGC.CACTCACTA
TCAGTAAGC.CTCGAACTG	TCAGTAAGC.CTCGAACTG
TCAGTAAGC.GATCTGAAT	TCAGTAAGC.GATCTGAAT
TCAGTAAGC.GGTAAGGAT	TCAGTAAGC.GGTAAGGAT
TCAGTAAGC.TCAATCTAG	TCAGTAAGC.TCAATCTAG
TCAGTGCAA.ATTATGCAG	TCAGTGCAA.ATTATGCAG
TCAGTGCAA.CGTGGTACC	TCAGTGCAA.CGTGGTACC
TCAGTGCAA.GACCGGTAG	TCAGTGCAA.GACCGGTAG
TCAGTGCAA.TCGTGCCAC	TCAGTGCAA.TCGTGCCAC
TCAGTGTTC.ACGTGTAGT	TCAGTGTTC.ACGTGTAGT
TCAGTGTTC.CTAACCGGT	TCAGTGTTC.CTAACCGGT
TCAGTGTTC.CTAGTATAG	TCAGTGTTC.CTAGTATAG
TCAGTGTTC.TGGAACTAA	TCAGTGTTC.TGGAACTAA
TCATATCGC.CGCGCACAT	TCATATCGC.CGCGCACAT
TCATATCGC.TTATTCGAC	TCATATCGC.TTATTCGAC
TCATCAGAG.AGCCTCGCA	TCATCAGAG.AGCCTCGCA
TCATCAGAG.CGTTACACC	TCATCAGAG.CGTTACACC
TCATCAGAG.GTTGCTCAG	TCATCAGAG.GTTGCTCAG
TCATCAGAG.TATACCACT	TCATCAGAG.TATACCACT
TCATCATCT.CACAACGCT	TCATCATCT.CACAACGCT
TCATCATCT.CGAGCCGTT	TCATCATCT.CGAGCCGTT
TCATCATCT.GACGCTTGC	TCATCATCT.GACGCTTGC
TCATCATCT.GCTTGGTTC	TCATCATCT.GCTTGGTTC
TCATCATCT.TATCTGTCA	TCATCATCT.TATCTGTCA
TCATCATCT.TGTGGTCCT	TCATCATCT.TGTGGTCCT
TCATCTGTC.AATCGTGTT	TCATCTGTC.AATCGTGTT
TCATCTGTC.AGTGAGAGA	TCATCTGTC.AGTGAGAGA
TCATCTGTC.ATAGTCTCC	TCATCTGTC.ATAGTCTCC
TCATCTGTC.CACATGTGC	TCATCTGTC.CACATGTGC
TCATCTGTC.GGTAAGGAT	TCATCTGTC.GGTAAGGAT
TCATCTGTC.GTCGCAGGT	TCATCTGTC.GTCGCAGGT
TCATCTGTC.TGAACTTGC	TCATCTGTC.TGAACTTGC
TCATGCAGG.CAGTACATC	TCATGCAGG.CAGTACATC
TCATGCAGG.GGTCCTAAG	TCATGCAGG.GGTCCTAAG
TCATGCTCA.AGATGAAGA	TCATGCTCA.AGATGAAGA
TCATGCTCA.TCGCAAGCA	TCATGCTCA.TCGCAAGCA
TCCAACGTG.ACCATACTT	TCCAACGTG.ACCATACTT
TCCAACGTG.GAACTCGTA	TCCAACGTG.GAACTCGTA
TCCAACGTG.GTATGCCTT	TCCAACGTG.GTATGCCTT
TCCAAGTAA.AACAGATCG	TCCAAGTAA.AACAGATCG
TCCAAGTAA.AGTCGCCGA	TCCAAGTAA.AGTCGCCGA
TCCAAGTAA.CCGAGCTGA	TCCAAGTAA.CCGAGCTGA
TCCAAGTAA.CTGATCAAG	TCCAAGTAA.CTGATCAAG
TCCAAGTAA.GACTAGCAT	TCCAAGTAA.GACTAGCAT
TCCAATCAT.CCACGTTCT	TCCAATCAT.CCACGTTCT
TCCAATCAT.CGACAGACC	TCCAATCAT.CGACAGACC
TCCAATCAT.CGAGTAGCA	TCCAATCAT.CGAGTAGCA
TCCAATCAT.GTGCACGAG	TCCAATCAT.GTGCACGAG
TCCAATCAT.TATTACAGC	TCCAATCAT.TATTACAGC
TCCACCGGT.AATACCTTG	TCCACCGGT.AATACCTTG
TCCACCGGT.ACGCTATGT	TCCACCGGT.ACGCTATGT
TCCACCGGT.TTCCAGGAG	TCCACCGGT.TTCCAGGAG
TCCACCTCA.CCACACAGA	TCCACCTCA.CCACACAGA
TCCACCTCA.GATACTGTG	TCCACCTCA.GATACTGTG
TCCACCTCA.GATGCTCCT	TCCACCTCA.GATGCTCCT
TCCACCTCA.GTAACGCGA	TCCACCTCA.GTAACGCGA
TCCACGTGC.AACGATGAC	TCCACGTGC.AACGATGAC
TCCACGTGC.CCGATGTTC	TCCACGTGC.CCGATGTTC
TCCACGTGC.CGTACACAC	TCCACGTGC.CGTACACAC
TCCAGAACG.AATGCGTGC	TCCAGAACG.AATGCGTGC
TCCAGAACG.ATGCGTGGA	TCCAGAACG.ATGCGTGGA
TCCAGAACG.CAGTGCCAT	TCCAGAACG.CAGTGCCAT
TCCAGCAGC.AGTGTTCTG	TCCAGCAGC.AGTGTTCTG
TCCAGCAGC.ATAATCGAG	TCCAGCAGC.ATAATCGAG
TCCAGCAGC.CAACCGGTC	TCCAGCAGC.CAACCGGTC
TCCAGCAGC.CAACCTGGT	TCCAGCAGC.CAACCTGGT
TCCAGCAGC.CAGTTGAGT	TCCAGCAGC.CAGTTGAGT
TCCAGCAGC.CTCTAAGAG	TCCAGCAGC.CTCTAAGAG
TCCAGCAGC.CTGATCCGA	TCCAGCAGC.CTGATCCGA
TCCAGCAGC.TCACATACT	TCCAGCAGC.TCACATACT
TCCAGCAGC.TTGCCGTAG	TCCAGCAGC.TTGCCGTAG
TCCAGCTAT.CTGTTACCA	TCCAGCTAT.CTGTTACCA
TCCAGCTAT.CTTACCTAG	TCCAGCTAT.CTTACCTAG
TCCAGCTAT.TAGATAGCC	TCCAGCTAT.TAGATAGCC
TCCATCATT.CCATTCTGC	TCCATCATT.CCATTCTGC
TCCATCATT.GGTACTTCC	TCCATCATT.GGTACTTCC
TCCATCATT.TGCCGACTA	TCCATCATT.TGCCGACTA
TCCGATAAC.AAGGTCTGA	TCCGATAAC.AAGGTCTGA
TCCGATAAC.CACATATCA	TCCGATAAC.CACATATCA
TCCGATAAC.GAGATACAC	TCCGATAAC.GAGATACAC
TCCGATCTG.GTAAGGTCC	TCCGATCTG.GTAAGGTCC
TCCGGAGCT.GTGTCGAGC	TCCGGAGCT.GTGTCGAGC
TCCGGAGCT.TACGGTCGT	TCCGGAGCT.TACGGTCGT
TCCGTATAC.AACGTTCTT	TCCGTATAC.AACGTTCTT
TCCGTATAC.CAGGTTGTC	TCCGTATAC.CAGGTTGTC
TCCGTATAC.CTAGTCGTC	TCCGTATAC.CTAGTCGTC
TCCGTATAC.CTTCCGTGG	TCCGTATAC.CTTCCGTGG
TCCGTATAC.GAACAACCA	TCCGTATAC.GAACAACCA
TCCGTATAC.GGATCAGGT	TCCGTATAC.GGATCAGGT
TCCGTATAC.GTATGTATC	TCCGTATAC.GTATGTATC
TCCTATTCC.CGTGAGACT	TCCTATTCC.CGTGAGACT
TCCTATTCC.GATTAGACA	TCCTATTCC.GATTAGACA
TCCTATTCC.GCGCTCTAT	TCCTATTCC.GCGCTCTAT
TCCTATTCC.TGGTAACCA	TCCTATTCC.TGGTAACCA
TCCTCGTCG.ACAACGAGC	TCCTCGTCG.ACAACGAGC
TCCTCGTCG.CAGTGCCAT	TCCTCGTCG.CAGTGCCAT
TCCTCGTCG.CATAGAGAT	TCCTCGTCG.CATAGAGAT
TCCTCGTCG.CTAACACTG	TCCTCGTCG.CTAACACTG
TCCTCGTCG.GCGCTCTAT	TCCTCGTCG.GCGCTCTAT
TCCTCGTCG.GCGGTAGTC	TCCTCGTCG.GCGGTAGTC
TCCTCGTCG.TAGCCAGTG	TCCTCGTCG.TAGCCAGTG
TCCTCGTCG.TTACTTACG	TCCTCGTCG.TTACTTACG
TCCTCTAGT.ACCGACGGT	TCCTCTAGT.ACCGACGGT
TCCTGAGAC.ACAGTATTG	TCCTGAGAC.ACAGTATTG
TCCTGAGAC.ACCGGAGTA	TCCTGAGAC.ACCGGAGTA
TCCTGAGAC.ACCGTCACG	TCCTGAGAC.ACCGTCACG
TCCTGAGAC.CGGATTCTC	TCCTGAGAC.CGGATTCTC
TCCTGAGAC.GGAGACACA	TCCTGAGAC.GGAGACACA
TCCTGAGAC.GTAACCATA	TCCTGAGAC.GTAACCATA
TCCTGAGAC.TTGGACTTC	TCCTGAGAC.TTGGACTTC
TCCTGTCCG.AATGCACTT	TCCTGTCCG.AATGCACTT
TCCTGTCCG.ACCAGCGTT	TCCTGTCCG.ACCAGCGTT
TCCTGTCCG.CTGCGTCAC	TCCTGTCCG.CTGCGTCAC
TCCTGTCCG.GATCTGTTC	TCCTGTCCG.GATCTGTTC
TCCTGTCCG.GTGGATAAG	TCCTGTCCG.GTGGATAAG
TCCTGTCCG.TGTGTCTAC	TCCTGTCCG.TGTGTCTAC
TCCTGTGGA.CCGACTGTT	TCCTGTGGA.CCGACTGTT
TCCTGTGGA.CGAATCCTG	TCCTGTGGA.CGAATCCTG
TCCTGTGGA.TAGCCAGTG	TCCTGTGGA.TAGCCAGTG
TCCTTAGGT.GCCGTTGTT	TCCTTAGGT.GCCGTTGTT
TCCTTAGGT.TACGGTCGT	TCCTTAGGT.TACGGTCGT
TCCTTCAAC.ATCGCCTCT	TCCTTCAAC.ATCGCCTCT
TCCTTCAAC.CCACTACCA	TCCTTCAAC.CCACTACCA
TCCTTCAAC.CCAGCCAAT	TCCTTCAAC.CCAGCCAAT
TCCTTCAAC.GGACAGATT	TCCTTCAAC.GGACAGATT
TCCTTCAAC.TTCAACTAC	TCCTTCAAC.TTCAACTAC
TCCTTCGTA.ATCTAGGTT	TCCTTCGTA.ATCTAGGTT
TCCTTCGTA.CCGAAGCGT	TCCTTCGTA.CCGAAGCGT
TCCTTCGTA.CTCGACTGC	TCCTTCGTA.CTCGACTGC
TCCTTCGTA.GACTTCACC	TCCTTCGTA.GACTTCACC
TCCTTCGTA.TTCCAATTC	TCCTTCGTA.TTCCAATTC
TCGAACGCT.AGAAGAGTC	TCGAACGCT.AGAAGAGTC
TCGAACGCT.CCACACAGA	TCGAACGCT.CCACACAGA
TCGAACGCT.CTGTAGAAG	TCGAACGCT.CTGTAGAAG
TCGAACGCT.TGAGATCAT	TCGAACGCT.TGAGATCAT
TCGAATAGA.ACCGCTGTG	TCGAATAGA.ACCGCTGTG
TCGAATAGA.GAACATGAC	TCGAATAGA.GAACATGAC
TCGAATAGA.GACCGTAGT	TCGAATAGA.GACCGTAGT
TCGAATAGA.GCTAGCTCC	TCGAATAGA.GCTAGCTCC
TCGACGTTG.AACGAGAAT	TCGACGTTG.AACGAGAAT
TCGACGTTG.ACCTCCTAG	TCGACGTTG.ACCTCCTAG
TCGACGTTG.ACGCGTGAC	TCGACGTTG.ACGCGTGAC
TCGACGTTG.CGTACACAC	TCGACGTTG.CGTACACAC
TCGACGTTG.GGTGAGTTC	TCGACGTTG.GGTGAGTTC
TCGACGTTG.TCGCATTCG	TCGACGTTG.TCGCATTCG
TCGATTCAG.ATAGCCTAA	TCGATTCAG.ATAGCCTAA
TCGCAAGCA.AGATCTTCA	TCGCAAGCA.AGATCTTCA
TCGCAAGCA.CAAGCTGCA	TCGCAAGCA.CAAGCTGCA
TCGCAAGCA.CTTCGACTG	TCGCAAGCA.CTTCGACTG
TCGCAAGCA.GATACTGTG	TCGCAAGCA.GATACTGTG
TCGCAAGCA.GCTACCTTA	TCGCAAGCA.GCTACCTTA
TCGCATTCG.AAGACTGGT	TCGCATTCG.AAGACTGGT
TCGCATTCG.CCTAAGAAG	TCGCATTCG.CCTAAGAAG
TCGCATTCG.TCAGAGCGT	TCGCATTCG.TCAGAGCGT
TCGCCAAGC.AGAGGTGAA	TCGCCAAGC.AGAGGTGAA
TCGCCAAGC.ATCGATCCT	TCGCCAAGC.ATCGATCCT
TCGCCAAGC.GGACACTGG	TCGCCAAGC.GGACACTGG
TCGCCAAGC.TATACGTGG	TCGCCAAGC.TATACGTGG
TCGCGTCAT.ATTCCTACG	TCGCGTCAT.ATTCCTACG
TCGCGTCAT.CAATCATAC	TCGCGTCAT.CAATCATAC
TCGCTGATT.ATAGCACGG	TCGCTGATT.ATAGCACGG
TCGCTGATT.TAACGTGTC	TCGCTGATT.TAACGTGTC
TCGCTGATT.TGACGATGA	TCGCTGATT.TGACGATGA
TCGCTGATT.TGTACACGA	TCGCTGATT.TGTACACGA
TCGCTGTAA.CCGGTTCTA	TCGCTGTAA.CCGGTTCTA
TCGCTGTAA.GCAATGAGA	TCGCTGTAA.GCAATGAGA
TCGCTGTAA.GGTAGTGTT	TCGCTGTAA.GGTAGTGTT
TCGCTGTAA.TCTTAAGTG	TCGCTGTAA.TCTTAAGTG
TCGCTGTAA.TGATCTCGG	TCGCTGTAA.TGATCTCGG
TCGCTGTAA.TTGCCGTAG	TCGCTGTAA.TTGCCGTAG
TCGCTTAAC.AATTAGAGG	TCGCTTAAC.AATTAGAGG
TCGCTTAAC.ACAGAAGAG	TCGCTTAAC.ACAGAAGAG
TCGCTTAAC.AGGATCTCA	TCGCTTAAC.AGGATCTCA
TCGCTTAAC.CGTTACACC	TCGCTTAAC.CGTTACACC
TCGCTTAAC.CTTACCTAG	TCGCTTAAC.CTTACCTAG
TCGCTTAAC.TAAGGTCCG	TCGCTTAAC.TAAGGTCCG
TCGGAACGA.AGATGAGAT	TCGGAACGA.AGATGAGAT
TCGGAACGA.CCGATACCG	TCGGAACGA.CCGATACCG
TCGGAACGA.GCCGCCTAA	TCGGAACGA.GCCGCCTAA
TCGGAACGA.GTCACTATG	TCGGAACGA.GTCACTATG
TCGGAACGA.TCCACCGGT	TCGGAACGA.TCCACCGGT
TCGGACAGT.CATATGTCG	TCGGACAGT.CATATGTCG
TCGGACAGT.GTCTGACGT	TCGGACAGT.GTCTGACGT
TCGGATGTT.CGACCATCA	TCGGATGTT.CGACCATCA
TCGGATGTT.CTCGTCTTG	TCGGATGTT.CTCGTCTTG
TCGGATGTT.CTGTACGAC	TCGGATGTT.CTGTACGAC
TCGGATGTT.CTGTAGAAG	TCGGATGTT.CTGTAGAAG
TCGGATGTT.CTTGGTCAT	TCGGATGTT.CTTGGTCAT
TCGGATGTT.GGAGCTCAA	TCGGATGTT.GGAGCTCAA
TCGGTATCA.ACGACATCT	TCGGTATCA.ACGACATCT
TCGGTATCA.AGGATGCGT	TCGGTATCA.AGGATGCGT
TCGGTATCA.TCAGGTGCA	TCGGTATCA.TCAGGTGCA
TCGGTATCA.TCGTTCTCC	TCGGTATCA.TCGTTCTCC
TCGTAATAG.GGTTCTATC	TCGTAATAG.GGTTCTATC
TCGTAATAG.TATGTACCT	TCGTAATAG.TATGTACCT
TCGTAATAG.TCGCTGATT	TCGTAATAG.TCGCTGATT
TCGTACCTT.ATTGATTGG	TCGTACCTT.ATTGATTGG
TCGTACCTT.CTGAGATAG	TCGTACCTT.CTGAGATAG
TCGTAGGAA.CGTGAGACT	TCGTAGGAA.CGTGAGACT
TCGTAGGAA.TATTCAACG	TCGTAGGAA.TATTCAACG
TCGTAGGAA.TCTGCAACA	TCGTAGGAA.TCTGCAACA
TCGTCATTC.ACCTGCAGA	TCGTCATTC.ACCTGCAGA
TCGTCATTC.AGATATGGA	TCGTCATTC.AGATATGGA
TCGTCATTC.CACTGGTCC	TCGTCATTC.CACTGGTCC
TCGTCATTC.CAGGATCAA	TCGTCATTC.CAGGATCAA
TCGTCATTC.CCAGCCAAT	TCGTCATTC.CCAGCCAAT
TCGTCATTC.GTCAGCGTC	TCGTCATTC.GTCAGCGTC
TCGTCCGAT.CGTGTCCGA	TCGTCCGAT.CGTGTCCGA
TCGTCCGAT.TGAGGTCTC	TCGTCCGAT.TGAGGTCTC
TCGTCCGAT.TGCCAGACG	TCGTCCGAT.TGCCAGACG
TCGTCCGAT.TTGGAGAAC	TCGTCCGAT.TTGGAGAAC
TCGTGACGT.ATACTTGCT	TCGTGACGT.ATACTTGCT
TCGTGACGT.CTCCTATCT	TCGTGACGT.CTCCTATCT
TCGTGCCAC.AGCGGTAAG	TCGTGCCAC.AGCGGTAAG
TCGTGCCAC.AGTTACAAG	TCGTGCCAC.AGTTACAAG
TCGTGCCAC.CCGATACCG	TCGTGCCAC.CCGATACCG
TCGTGCCAC.CGCAATCGA	TCGTGCCAC.CGCAATCGA
TCGTGCCAC.CGGTGTTAC	TCGTGCCAC.CGGTGTTAC
TCGTGCCAC.GACATAACG	TCGTGCCAC.GACATAACG
TCGTGCCAC.GGAGAATGA	TCGTGCCAC.GGAGAATGA
TCGTTCTCC.AAGCTGGTC	TCGTTCTCC.AAGCTGGTC
TCGTTCTCC.ACTATTGTC	TCGTTCTCC.ACTATTGTC
TCGTTCTCC.CTCTAAGAG	TCGTTCTCC.CTCTAAGAG
TCGTTCTCC.CTGTCTAGT	TCGTTCTCC.CTGTCTAGT
TCGTTCTCC.GCGATGGTG	TCGTTCTCC.GCGATGGTG
TCTAATACC.ACTCGAGTC	TCTAATACC.ACTCGAGTC
TCTAATACC.CAATGCATT	TCTAATACC.CAATGCATT
TCTAATACC.CCGAAGCGT	TCTAATACC.CCGAAGCGT
TCTAATACC.CTCGTCTTG	TCTAATACC.CTCGTCTTG
TCTACAGTT.ACACCACAT	TCTACAGTT.ACACCACAT
TCTACAGTT.AGTGTGCAC	TCTACAGTT.AGTGTGCAC
TCTACAGTT.ATTCGAAGA	TCTACAGTT.ATTCGAAGA
TCTACAGTT.TGCCTGGTT	TCTACAGTT.TGCCTGGTT
TCTACATCC.AACTTAGCT	TCTACATCC.AACTTAGCT
TCTACATCC.AGTCGCGAC	TCTACATCC.AGTCGCGAC
TCTACATCC.CAGGAGCCT	TCTACATCC.CAGGAGCCT
TCTACATCC.CATCAATAG	TCTACATCC.CATCAATAG
TCTACATCC.CCGCAACAC	TCTACATCC.CCGCAACAC
TCTACATCC.GCGCTACCT	TCTACATCC.GCGCTACCT
TCTACATCC.GCTGACAGA	TCTACATCC.GCTGACAGA
TCTACATCC.TAAGGTGAT	TCTACATCC.TAAGGTGAT
TCTACGCAA.ACACAGAAC	TCTACGCAA.ACACAGAAC
TCTACGCAA.CACACCTGT	TCTACGCAA.CACACCTGT
TCTACGCAA.CGCGTGAGA	TCTACGCAA.CGCGTGAGA
TCTACGCAA.CGTGTCCGA	TCTACGCAA.CGTGTCCGA
TCTACGCAA.CTGATGCAC	TCTACGCAA.CTGATGCAC
TCTACGCAA.GAGTCGTAC	TCTACGCAA.GAGTCGTAC
TCTACGCAA.GCGGTAAGT	TCTACGCAA.GCGGTAAGT
TCTACGCAA.GTTGACGTG	TCTACGCAA.GTTGACGTG
TCTACGCAA.TGGTCCTAG	TCTACGCAA.TGGTCCTAG
TCTACGCAA.TTGCCGTAG	TCTACGCAA.TTGCCGTAG
TCTAGCTGG.ACACGTTGC	TCTAGCTGG.ACACGTTGC
TCTAGCTGG.CAACTCCAG	TCTAGCTGG.CAACTCCAG
TCTAGCTGG.TACGACCAT	TCTAGCTGG.TACGACCAT
TCTAGGATG.AGAATCAGA	TCTAGGATG.AGAATCAGA
TCTAGGATG.TAGCTGTTG	TCTAGGATG.TAGCTGTTG
TCTAGGATG.TGCCAGACG	TCTAGGATG.TGCCAGACG
TCTAGTGAC.AAGTTGCCA	TCTAGTGAC.AAGTTGCCA
TCTAGTGAC.CACACCACA	TCTAGTGAC.CACACCACA
TCTAGTGAC.CTCTAGTAA	TCTAGTGAC.CTCTAGTAA
TCTATGACA.AAGCCAAGT	TCTATGACA.AAGCCAAGT
TCTATGACA.ACGATGGAA	TCTATGACA.ACGATGGAA
TCTATGACA.ACTGACTAC	TCTATGACA.ACTGACTAC
TCTATGACA.GTACGAACG	TCTATGACA.GTACGAACG
TCTATTAGG.CCGAAGCGT	TCTATTAGG.CCGAAGCGT
TCTATTAGG.CGCTTCACG	TCTATTAGG.CGCTTCACG
TCTATTAGG.CGGAGACTT	TCTATTAGG.CGGAGACTT
TCTATTAGG.GCACGTAGA	TCTATTAGG.GCACGTAGA
TCTATTAGG.GGATGCGAA	TCTATTAGG.GGATGCGAA
TCTATTAGG.TAAGTGTAG	TCTATTAGG.TAAGTGTAG
TCTCAGGAT.ACCATCTAA	TCTCAGGAT.ACCATCTAA
TCTCAGGAT.ACGGACCAT	TCTCAGGAT.ACGGACCAT
TCTCAGGAT.AGTCATACT	TCTCAGGAT.AGTCATACT
TCTCAGGAT.ATGACACAA	TCTCAGGAT.ATGACACAA
TCTCAGGAT.CGCATAACT	TCTCAGGAT.CGCATAACT
TCTCAGGAT.CTGCAAGCC	TCTCAGGAT.CTGCAAGCC
TCTCAGGAT.CTGGTCGGT	TCTCAGGAT.CTGGTCGGT
TCTCAGGAT.GGTCGGTCT	TCTCAGGAT.GGTCGGTCT
TCTCAGGAT.TACGACTTG	TCTCAGGAT.TACGACTTG
TCTCAGGAT.TCCAACGTG	TCTCAGGAT.TCCAACGTG
TCTCATCGG.CCGACGTCA	TCTCATCGG.CCGACGTCA
TCTCATCGG.TATAGTGCG	TCTCATCGG.TATAGTGCG
TCTCATCGG.TCGTCCGAT	TCTCATCGG.TCGTCCGAT
TCTCCGCGT.CCTCTTGTA	TCTCCGCGT.CCTCTTGTA
TCTCCGCGT.GTCAGTTGT	TCTCCGCGT.GTCAGTTGT
TCTCGATGC.ACAATTCGG	TCTCGATGC.ACAATTCGG
TCTCGATGC.AGTTAGGTC	TCTCGATGC.AGTTAGGTC
TCTCGATGC.CCTAAGAAG	TCTCGATGC.CCTAAGAAG
TCTCGATGC.CCTCGCGTT	TCTCGATGC.CCTCGCGTT
TCTCGATGC.CTCTAGTAA	TCTCGATGC.CTCTAGTAA
TCTCGATGC.GTGGTTACC	TCTCGATGC.GTGGTTACC
TCTCGATGC.TAGGATTAG	TCTCGATGC.TAGGATTAG
TCTCGATGC.TGCCTGGTT	TCTCGATGC.TGCCTGGTT
TCTCGATGC.TGTCACATA	TCTCGATGC.TGTCACATA
TCTCGTATC.AATCTCCTA	TCTCGTATC.AATCTCCTA
TCTCGTATC.CCTAGCAAT	TCTCGTATC.CCTAGCAAT
TCTCGTATC.GGTGCGTAG	TCTCGTATC.GGTGCGTAG
TCTCGTATC.TGCAGCCTT	TCTCGTATC.TGCAGCCTT
TCTCGTATC.TGTCTACAC	TCTCGTATC.TGTCTACAC
TCTGAGATA.CGCAGTGTC	TCTGAGATA.CGCAGTGTC
TCTGAGATA.CGTCATGGA	TCTGAGATA.CGTCATGGA
TCTGAGATA.CTCGACGAT	TCTGAGATA.CTCGACGAT
TCTGAGATA.CTTCGTGCA	TCTGAGATA.CTTCGTGCA
TCTGAGATA.GGATGCGAA	TCTGAGATA.GGATGCGAA
TCTGAGATA.TCGGATGTT	TCTGAGATA.TCGGATGTT
TCTGAGATA.TCTTAGCGA	TCTGAGATA.TCTTAGCGA
TCTGATGAA.CCGATGTTC	TCTGATGAA.CCGATGTTC
TCTGATGAA.TACACGGTC	TCTGATGAA.TACACGGTC
TCTGATGAA.TGCAACTCT	TCTGATGAA.TGCAACTCT
TCTGCGCTG.GAGTATCGC	TCTGCGCTG.GAGTATCGC
TCTGCGCTG.TACTTCCAG	TCTGCGCTG.TACTTCCAG
TCTGCGCTG.TCGTAATAG	TCTGCGCTG.TCGTAATAG
TCTGCGCTG.TTCATCCAA	TCTGCGCTG.TTCATCCAA
TCTGGAGGA.AATCTGACC	TCTGGAGGA.AATCTGACC
TCTGGAGGA.AGACATATC	TCTGGAGGA.AGACATATC
TCTGGAGGA.CCGAGTACT	TCTGGAGGA.CCGAGTACT
TCTGGAGGA.CCGCTATCC	TCTGGAGGA.CCGCTATCC
TCTGGAGGA.GTTGACCAT	TCTGGAGGA.GTTGACCAT
TCTGGAGGA.TAGGAGGAT	TCTGGAGGA.TAGGAGGAT
TCTGGAGGA.TCGTGACGT	TCTGGAGGA.TCGTGACGT
TCTGTGAAG.AGCCGGATC	TCTGTGAAG.AGCCGGATC
TCTGTGAAG.GATCGCACT	TCTGTGAAG.GATCGCACT
TCTGTGAAG.GGATAGTCA	TCTGTGAAG.GGATAGTCA
TCTTAAGTG.ACTGTGTCA	TCTTAAGTG.ACTGTGTCA
TCTTAAGTG.CAGCGTAAG	TCTTAAGTG.CAGCGTAAG
TCTTAAGTG.GTAGCCTTG	TCTTAAGTG.GTAGCCTTG
TCTTAGCGA.ACCATTCAC	TCTTAGCGA.ACCATTCAC
TCTTAGCGA.ACGTAGTAT	TCTTAGCGA.ACGTAGTAT
TCTTAGCGA.CTACCTGCG	TCTTAGCGA.CTACCTGCG
TCTTAGCGA.GGTCGGTCT	TCTTAGCGA.GGTCGGTCT
TCTTAGCGA.GGTGTGACC	TCTTAGCGA.GGTGTGACC
TCTTAGCGA.TGAGTGACT	TCTTAGCGA.TGAGTGACT
TCTTGGTAG.AATGCTGAT	TCTTGGTAG.AATGCTGAT
TCTTGGTAG.AGATCTGAC	TCTTGGTAG.AGATCTGAC
TCTTGGTAG.CATGCCAGT	TCTTGGTAG.CATGCCAGT
TCTTGGTAG.CGTTCCATT	TCTTGGTAG.CGTTCCATT
TCTTGGTAG.TGGTCTACG	TCTTGGTAG.TGGTCTACG
TCTTGGTAG.TGTCAACCT	TCTTGGTAG.TGTCAACCT
TCTTGGTAG.TTGCAGTCA	TCTTGGTAG.TTGCAGTCA
TGAACCAAT.CAATCATAC	TGAACCAAT.CAATCATAC
TGAACCAAT.CAGAGCACC	TGAACCAAT.CAGAGCACC
TGAACCAAT.CATAATTGG	TGAACCAAT.CATAATTGG
TGAACCAAT.GAGGACTTA	TGAACCAAT.GAGGACTTA
TGAACCAAT.GGTAACTAC	TGAACCAAT.GGTAACTAC
TGAACCAAT.TAGCCAGTG	TGAACCAAT.TAGCCAGTG
TGAACCAAT.TATGCCTTC	TGAACCAAT.TATGCCTTC
TGAACCAAT.TCATCTGTC	TGAACCAAT.TCATCTGTC
TGAACGGTT.ACGATGACC	TGAACGGTT.ACGATGACC
TGAACGGTT.AGCATTGTT	TGAACGGTT.AGCATTGTT
TGAACGGTT.CAAGAGGAG	TGAACGGTT.CAAGAGGAG
TGAACGGTT.CCACGTTCT	TGAACGGTT.CCACGTTCT
TGAACGGTT.CCTTAACAT	TGAACGGTT.CCTTAACAT
TGAACGGTT.CTAACCGGT	TGAACGGTT.CTAACCGGT
TGAACGGTT.CTGAGGTTA	TGAACGGTT.CTGAGGTTA
TGAACGGTT.GGTACTTCC	TGAACGGTT.GGTACTTCC
TGAACGGTT.GTACGCGAT	TGAACGGTT.GTACGCGAT
TGAACGGTT.GTTATCGAT	TGAACGGTT.GTTATCGAT
TGAACGGTT.TACACGGTC	TGAACGGTT.TACACGGTC
TGAACGGTT.TCCAGCAGC	TGAACGGTT.TCCAGCAGC
TGAACGTCA.ACAGGTATC	TGAACGTCA.ACAGGTATC
TGAACGTCA.CAAGTACGA	TGAACGTCA.CAAGTACGA
TGAACGTCA.CGCGTGAGA	TGAACGTCA.CGCGTGAGA
TGAACGTCA.CGGTTCGTA	TGAACGTCA.CGGTTCGTA
TGAACGTCA.GATCTGAAT	TGAACGTCA.GATCTGAAT
TGAACTTGC.AATATCAGC	TGAACTTGC.AATATCAGC
TGAACTTGC.AGATCTTCA	TGAACTTGC.AGATCTTCA
TGAACTTGC.ATGGATATC	TGAACTTGC.ATGGATATC
TGAACTTGC.ATGTCGCCT	TGAACTTGC.ATGTCGCCT
TGAACTTGC.CGTGTGTGG	TGAACTTGC.CGTGTGTGG
TGAAGACCA.AATCTGACC	TGAAGACCA.AATCTGACC
TGAAGACCA.AGGATGCGT	TGAAGACCA.AGGATGCGT
TGAAGACCA.CTTGATCTA	TGAAGACCA.CTTGATCTA
TGAAGACCA.GGTGTGACC	TGAAGACCA.GGTGTGACC
TGAAGACCA.TCAGACAAG	TGAAGACCA.TCAGACAAG
TGAAGACCA.TCAGTGTTC	TGAAGACCA.TCAGTGTTC
TGAAGACCA.TGTCGTACA	TGAAGACCA.TGTCGTACA
TGACAAGTT.AGACGCCTG	TGACAAGTT.AGACGCCTG
TGACAAGTT.ATACAACCG	TGACAAGTT.ATACAACCG
TGACAAGTT.ATGAGCAGG	TGACAAGTT.ATGAGCAGG
TGACAAGTT.CGTGTATTC	TGACAAGTT.CGTGTATTC
TGACAAGTT.CTCGACGAT	TGACAAGTT.CTCGACGAT
TGACAAGTT.GATACCGGA	TGACAAGTT.GATACCGGA
TGACAAGTT.GGAATTCAC	TGACAAGTT.GGAATTCAC
TGACAAGTT.TCTTAGCGA	TGACAAGTT.TCTTAGCGA
TGACAAGTT.TTGTAATGC	TGACAAGTT.TTGTAATGC
TGACCAAGT.ACTATCCTG	TGACCAAGT.ACTATCCTG
TGACCAAGT.GCGTGATAC	TGACCAAGT.GCGTGATAC
TGACCTATG.CCAGTCTCA	TGACCTATG.CCAGTCTCA
TGACCTATG.TTGCCAGAT	TGACCTATG.TTGCCAGAT
TGACCTCCT.CCATACGAT	TGACCTCCT.CCATACGAT
TGACCTCCT.GAACAACCA	TGACCTCCT.GAACAACCA
TGACCTCCT.GTATACAGA	TGACCTCCT.GTATACAGA
TGACCTCCT.TCGGTATCA	TGACCTCCT.TCGGTATCA
TGACGATGA.ACCACGGAT	TGACGATGA.ACCACGGAT
TGACGATGA.ATAGTCAGT	TGACGATGA.ATAGTCAGT
TGACGATGA.CATCGAAGC	TGACGATGA.CATCGAAGC
TGACGATGA.GCTGTTCGG	TGACGATGA.GCTGTTCGG
TGACGATGA.TTCCGAGCG	TGACGATGA.TTCCGAGCG
TGACGGTTG.AAGTTCTCT	TGACGGTTG.AAGTTCTCT
TGACGGTTG.ACTCGAGTC	TGACGGTTG.ACTCGAGTC
TGACGGTTG.GGATACCTA	TGACGGTTG.GGATACCTA
TGACTGAGA.AACTTGTCG	TGACTGAGA.AACTTGTCG
TGACTGAGA.CATAGAGAT	TGACTGAGA.CATAGAGAT
TGACTGAGA.CTGAGTCCA	TGACTGAGA.CTGAGTCCA
TGACTGAGA.CTTAATCGT	TGACTGAGA.CTTAATCGT
TGACTGAGA.GGTAAGGAT	TGACTGAGA.GGTAAGGAT
TGAGAATCC.AGACATCCA	TGAGAATCC.AGACATCCA
TGAGAATCC.CACTTCCTT	TGAGAATCC.CACTTCCTT
TGAGAATCC.CGGTTCGTA	TGAGAATCC.CGGTTCGTA
TGAGAATCC.GCGGAGATT	TGAGAATCC.GCGGAGATT
TGAGAATCC.GGTCGGATA	TGAGAATCC.GGTCGGATA
TGAGAATCC.GTGCTCGGA	TGAGAATCC.GTGCTCGGA
TGAGAATCC.TAGTAACGG	TGAGAATCC.TAGTAACGG
TGAGAATCC.TCTAGCTGG	TGAGAATCC.TCTAGCTGG
TGAGACAGC.AGTGTTCTG	TGAGACAGC.AGTGTTCTG
TGAGACAGC.CCGCTCATG	TGAGACAGC.CCGCTCATG
TGAGACAGC.CTGCATGTT	TGAGACAGC.CTGCATGTT
TGAGACAGC.GAGGTCCTT	TGAGACAGC.GAGGTCCTT
TGAGACAGC.TAGCACTAT	TGAGACAGC.TAGCACTAT
TGAGAGGAC.TAGACACGT	TGAGAGGAC.TAGACACGT
TGAGATCAT.AGTCGATCA	TGAGATCAT.AGTCGATCA
TGAGATCAT.CGCGAGTGT	TGAGATCAT.CGCGAGTGT
TGAGATCAT.CTTGATCTA	TGAGATCAT.CTTGATCTA
TGAGCAGAT.AAGGATCGT	TGAGCAGAT.AAGGATCGT
TGAGCAGAT.CCAGATCAC	TGAGCAGAT.CCAGATCAC
TGAGCAGAT.GATCTAGAG	TGAGCAGAT.GATCTAGAG
TGAGCAGAT.TTCCAATTC	TGAGCAGAT.TTCCAATTC
TGAGCTAGA.AACGAGAAT	TGAGCTAGA.AACGAGAAT
TGAGCTAGA.CATGCCAGT	TGAGCTAGA.CATGCCAGT
TGAGCTAGA.CGTCAGCAC	TGAGCTAGA.CGTCAGCAC
TGAGCTAGA.GGATTACGC	TGAGCTAGA.GGATTACGC
TGAGCTAGA.TAACGTGTC	TGAGCTAGA.TAACGTGTC
TGAGCTAGA.TAAGGTCCG	TGAGCTAGA.TAAGGTCCG
TGAGCTAGA.TCGTAGGAA	TGAGCTAGA.TCGTAGGAA
TGAGGTCTC.ATTGCCGAC	TGAGGTCTC.ATTGCCGAC
TGAGGTCTC.TAGGTTAGT	TGAGGTCTC.TAGGTTAGT
TGAGTGACT.AAGGTGCTG	TGAGTGACT.AAGGTGCTG
TGAGTGACT.AATGCCTCA	TGAGTGACT.AATGCCTCA
TGAGTGACT.AGAGCCGCA	TGAGTGACT.AGAGCCGCA
TGAGTGACT.CTGATCCGA	TGAGTGACT.CTGATCCGA
TGAGTGACT.GTCAGCGTC	TGAGTGACT.GTCAGCGTC
TGAGTTAAG.CGAACAGAG	TGAGTTAAG.CGAACAGAG
TGAGTTAAG.GTCCTAGTT	TGAGTTAAG.GTCCTAGTT
TGATACCGT.ATTGATTGG	TGATACCGT.ATTGATTGG
TGATACCGT.CATGTCCTG	TGATACCGT.CATGTCCTG
TGATACCGT.CCGAATATG	TGATACCGT.CCGAATATG
TGATACCGT.CTCAGCTGG	TGATACCGT.CTCAGCTGG
TGATAGAGG.CCAGTTACG	TGATAGAGG.CCAGTTACG
TGATAGAGG.CGTGCTTGA	TGATAGAGG.CGTGCTTGA
TGATAGAGG.GACAATGTT	TGATAGAGG.GACAATGTT
TGATAGAGG.GCGGTAGTC	TGATAGAGG.GCGGTAGTC
