GGTGGAGCT.ACTGTAATC	GGTGGAGCT.ACTGTAATC
GGTGGAGCT.ATGGATATC	GGTGGAGCT.ATGGATATC
GGTGGAGCT.CACTACAGG	GGTGGAGCT.CACTACAGG
GGTGGAGCT.CAGCTAGTT	GGTGGAGCT.CAGCTAGTT
GGTGGAGCT.CTACGTTGG	GGTGGAGCT.CTACGTTGG
GGTGGAGCT.CTGCGTCAC	GGTGGAGCT.CTGCGTCAC
GGTGGAGCT.GATGTTACA	GGTGGAGCT.GATGTTACA
GGTGGAGCT.GCAGGAGAA	GGTGGAGCT.GCAGGAGAA
GGTGGAGCT.TATCAGTGC	GGTGGAGCT.TATCAGTGC
GGTGGAGCT.TCGATTCAG	GGTGGAGCT.TCGATTCAG
GGTGTGACC.AGTTAGGTC	GGTGTGACC.AGTTAGGTC
GGTGTGACC.TGAACGGTT	GGTGTGACC.TGAACGGTT
GGTGTTCAT.CCACGGATC	GGTGTTCAT.CCACGGATC
GGTGTTCAT.CTCTACGCA	GGTGTTCAT.CTCTACGCA
GGTGTTCAT.CTTCTATGA	GGTGTTCAT.CTTCTATGA
GGTGTTCAT.TGCGACGTT	GGTGTTCAT.TGCGACGTT
GGTTAACAG.AGCGGAACA	GGTTAACAG.AGCGGAACA
GGTTAACAG.ATCTACATC	GGTTAACAG.ATCTACATC
GGTTAACAG.ATGCTTCAG	GGTTAACAG.ATGCTTCAG
GGTTAACAG.CGTATTCCT	GGTTAACAG.CGTATTCCT
GGTTAACAG.CTATAGCTC	GGTTAACAG.CTATAGCTC
GGTTAACAG.GATCTAGAG	GGTTAACAG.GATCTAGAG
GGTTAACAG.TAGCAGAGT	GGTTAACAG.TAGCAGAGT
GGTTAACAG.TTATTCGAC	GGTTAACAG.TTATTCGAC
GGTTACGCA.ACAGAAGAG	GGTTACGCA.ACAGAAGAG
GGTTACGCA.AGCTGCACT	GGTTACGCA.AGCTGCACT
GGTTACGCA.GCTGACAGA	GGTTACGCA.GCTGACAGA
GGTTAGATG.TCAAGGTCG	GGTTAGATG.TCAAGGTCG
GGTTCAGAC.ATGAACTAG	GGTTCAGAC.ATGAACTAG
GGTTCAGAC.CGTGGTACC	GGTTCAGAC.CGTGGTACC
GGTTCAGAC.TCGCGTCAT	GGTTCAGAC.TCGCGTCAT
GGTTCAGAC.TGCGTATCT	GGTTCAGAC.TGCGTATCT
GGTTCAGAC.TGGTCTACG	GGTTCAGAC.TGGTCTACG
GGTTCGCAA.ACTCGCTGT	GGTTCGCAA.ACTCGCTGT
GGTTCGCAA.AGGAATTGG	GGTTCGCAA.AGGAATTGG
GGTTCGCAA.AGTTGAGCG	GGTTCGCAA.AGTTGAGCG
GGTTCGCAA.CCTAGAGTA	GGTTCGCAA.CCTAGAGTA
GGTTCGCAA.CGTGTCCGA	GGTTCGCAA.CGTGTCCGA
GGTTCGCAA.CTCATGCCA	GGTTCGCAA.CTCATGCCA
GGTTCGCAA.TGCGATACT	GGTTCGCAA.TGCGATACT
GGTTCGCAA.TTCCGCCAG	GGTTCGCAA.TTCCGCCAG
GGTTCTATC.ACCACTAGG	GGTTCTATC.ACCACTAGG
GGTTCTATC.AGACTTCGT	GGTTCTATC.AGACTTCGT
GGTTCTATC.ATGGAGAGT	GGTTCTATC.ATGGAGAGT
GGTTCTATC.CCACGAAGG	GGTTCTATC.CCACGAAGG
GGTTCTATC.TATGATGTG	GGTTCTATC.TATGATGTG
GGTTCTATC.TCTAGCTGG	GGTTCTATC.TCTAGCTGG
GGTTCTATC.TTCCAGATT	GGTTCTATC.TTCCAGATT
GGTTGAAGG.ACAGGTATC	GGTTGAAGG.ACAGGTATC
GGTTGAAGG.GCTAGTGGA	GGTTGAAGG.GCTAGTGGA
GGTTGAAGG.GTGTTGGAA	GGTTGAAGG.GTGTTGGAA
GGTTGAAGG.TGACCTCCT	GGTTGAAGG.TGACCTCCT
GGTTGCTAT.CCTCGCGTT	GGTTGCTAT.CCTCGCGTT
GGTTGCTAT.GTGCATCAA	GGTTGCTAT.GTGCATCAA
GGTTGCTAT.TAGTCGCAT	GGTTGCTAT.TAGTCGCAT
GTAACAGTC.CAACCTGGT	GTAACAGTC.CAACCTGGT
GTAACAGTC.TCGCTTAAC	GTAACAGTC.TCGCTTAAC
GTAACAGTC.TGCCAGACG	GTAACAGTC.TGCCAGACG
GTAACCATA.AAGACTGGT	GTAACCATA.AAGACTGGT
GTAACCATA.CTTCCGTGG	GTAACCATA.CTTCCGTGG
GTAACCATA.GTGACTCTC	GTAACCATA.GTGACTCTC
GTAACCATA.TCTCCGCGT	GTAACCATA.TCTCCGCGT
GTAACCATA.TGGAAGATT	GTAACCATA.TGGAAGATT
GTAACGCGA.GCAGATCCG	GTAACGCGA.GCAGATCCG
GTAACGCGA.GTCTGACGT	GTAACGCGA.GTCTGACGT
GTAACGCGA.GTGCGTTCC	GTAACGCGA.GTGCGTTCC
GTAACTCAT.CACGGATAG	GTAACTCAT.CACGGATAG
GTAACTCAT.CCATAGCCA	GTAACTCAT.CCATAGCCA
GTAACTCAT.GGTGTTCAT	GTAACTCAT.GGTGTTCAT
GTAACTCAT.TTGCCAGAT	GTAACTCAT.TTGCCAGAT
GTAACTCAT.TTGGAGAAC	GTAACTCAT.TTGGAGAAC
GTAAGGTCC.ACTCCAACT	GTAAGGTCC.ACTCCAACT
GTAAGGTCC.CTAGAGGTA	GTAAGGTCC.CTAGAGGTA
GTAAGGTCC.CTGGTACAT	GTAAGGTCC.CTGGTACAT
GTAAGGTCC.GCGGAGATT	GTAAGGTCC.GCGGAGATT
GTAAGGTCC.TCCGATCTG	GTAAGGTCC.TCCGATCTG
GTAAGTGAG.ACGATGACC	GTAAGTGAG.ACGATGACC
GTAAGTGAG.ACGTAGTAT	GTAAGTGAG.ACGTAGTAT
GTAAGTGAG.ACGTTCAAT	GTAAGTGAG.ACGTTCAAT
GTAAGTGAG.GACGTCAAT	GTAAGTGAG.GACGTCAAT
GTAAGTGAG.GGTGGAGCT	GTAAGTGAG.GGTGGAGCT
GTAAGTGAG.GTAGCATAC	GTAAGTGAG.GTAGCATAC
GTAAGTGAG.GTGCTCGGA	GTAAGTGAG.GTGCTCGGA
GTAAGTGAG.TATCATGCT	GTAAGTGAG.TATCATGCT
GTAATATCG.AGATGAGAT	GTAATATCG.AGATGAGAT
GTAATATCG.AGCTTCGAT	GTAATATCG.AGCTTCGAT
GTAATATCG.CGAGCCGTT	GTAATATCG.CGAGCCGTT
GTAATATCG.GAGCCATCC	GTAATATCG.GAGCCATCC
GTAATATCG.GGTCGGATA	GTAATATCG.GGTCGGATA
GTAATATCG.TCGTCATTC	GTAATATCG.TCGTCATTC
GTAATCAGC.ACTACTCAT	GTAATCAGC.ACTACTCAT
GTAATCAGC.CAACACCTA	GTAATCAGC.CAACACCTA
GTAATCAGC.GAACAACCA	GTAATCAGC.GAACAACCA
GTAATCAGC.GAGCAGGAA	GTAATCAGC.GAGCAGGAA
GTAATCAGC.TACAAGAGG	GTAATCAGC.TACAAGAGG
GTAATCAGC.TCCGATCTG	GTAATCAGC.TCCGATCTG
GTACAATGC.CCATAATCG	GTACAATGC.CCATAATCG
GTACAATGC.GTGTCGAGC	GTACAATGC.GTGTCGAGC
GTACCACAA.ACACGTTGC	GTACCACAA.ACACGTTGC
GTACCACAA.AGTCGCCGA	GTACCACAA.AGTCGCCGA
GTACCACAA.CCACAAGGT	GTACCACAA.CCACAAGGT
GTACCACAA.GCCGTGAAC	GTACCACAA.GCCGTGAAC
GTACCACAA.TGAGTGACT	GTACCACAA.TGAGTGACT
GTACCACAA.TTCACTCCT	GTACCACAA.TTCACTCCT
GTACCTAAC.CCATTCTGC	GTACCTAAC.CCATTCTGC
GTACGAACG.AGCTCTCCG	GTACGAACG.AGCTCTCCG
GTACGAACG.GCCTTCCAT	GTACGAACG.GCCTTCCAT
GTACGCGAT.TATCTAGGT	GTACGCGAT.TATCTAGGT
GTACGCGAT.TTGAGCTCT	GTACGCGAT.TTGAGCTCT
GTACGTCTA.AAGACTGGT	GTACGTCTA.AAGACTGGT
GTACGTCTA.AGCGGTAAG	GTACGTCTA.AGCGGTAAG
GTACGTCTA.CAGTAATGT	GTACGTCTA.CAGTAATGT
GTACGTCTA.CAGTGCTGC	GTACGTCTA.CAGTGCTGC
GTACTCTAC.ACACGTTGC	GTACTCTAC.ACACGTTGC
GTACTCTAC.CTCTGCGGT	GTACTCTAC.CTCTGCGGT
GTACTCTAC.TACCTCACT	GTACTCTAC.TACCTCACT
GTAGAAGTT.AATAGACGC	GTAGAAGTT.AATAGACGC
GTAGAAGTT.AGTTAGGTC	GTAGAAGTT.AGTTAGGTC
GTAGAAGTT.ATATAGCGT	GTAGAAGTT.ATATAGCGT
GTAGAAGTT.CACATGTGC	GTAGAAGTT.CACATGTGC
GTAGAAGTT.CGAAGAGGT	GTAGAAGTT.CGAAGAGGT
GTAGAAGTT.GTACGAACG	GTAGAAGTT.GTACGAACG
GTAGACTCT.ACCATTCAC	GTAGACTCT.ACCATTCAC
GTAGACTCT.CTTCACTGT	GTAGACTCT.CTTCACTGT
GTAGACTCT.GAGGTGAGC	GTAGACTCT.GAGGTGAGC
GTAGACTCT.TACGGTCGT	GTAGACTCT.TACGGTCGT
GTAGAGAGC.AAGCCACAC	GTAGAGAGC.AAGCCACAC
GTAGAGAGC.CAGGAGCCT	GTAGAGAGC.CAGGAGCCT
GTAGAGAGC.GACCGCTTC	GTAGAGAGC.GACCGCTTC
GTAGAGAGC.TCTCGATGC	GTAGAGAGC.TCTCGATGC
GTAGAGAGC.TTACCTCTC	GTAGAGAGC.TTACCTCTC
GTAGAGAGC.TTCATTCGC	GTAGAGAGC.TTCATTCGC
GTAGCATAC.AGCCACTTC	GTAGCATAC.AGCCACTTC
GTAGCATAC.CCATCTAGG	GTAGCATAC.CCATCTAGG
GTAGCATAC.GCTACCGAG	GTAGCATAC.GCTACCGAG
GTAGCATAC.TACGACCAT	GTAGCATAC.TACGACCAT
GTAGCATAC.TGACAAGTT	GTAGCATAC.TGACAAGTT
GTAGCATAC.TTGATGCTG	GTAGCATAC.TTGATGCTG
GTAGCCTTG.AACGGTAGC	GTAGCCTTG.AACGGTAGC
GTAGCCTTG.TATTGACTG	GTAGCCTTG.TATTGACTG
GTAGCTACA.ACAGAGATG	GTAGCTACA.ACAGAGATG
GTAGCTACA.ACGTATGTC	GTAGCTACA.ACGTATGTC
GTAGCTACA.GCTACCGAG	GTAGCTACA.GCTACCGAG
GTAGGACGC.ATGGAGGAA	GTAGGACGC.ATGGAGGAA
GTAGGACGC.ATTATGCAG	GTAGGACGC.ATTATGCAG
GTAGGACGC.TGTTAAGCC	GTAGGACGC.TGTTAAGCC
GTAGTGGAG.GAATCACAT	GTAGTGGAG.GAATCACAT
GTAGTGGAG.GCTGAGCAG	GTAGTGGAG.GCTGAGCAG
GTAGTGGAG.TCTATTAGG	GTAGTGGAG.TCTATTAGG
GTAGTGGAG.TGACTGAGA	GTAGTGGAG.TGACTGAGA
GTAGTGGAG.TTAACGTTC	GTAGTGGAG.TTAACGTTC
GTAGTTGGT.CAATGTGCT	GTAGTTGGT.CAATGTGCT
GTAGTTGGT.CCTCCTTGT	GTAGTTGGT.CCTCCTTGT
GTAGTTGGT.GCTTGGTTC	GTAGTTGGT.GCTTGGTTC
GTATACAGA.AATCTCCTA	GTATACAGA.AATCTCCTA
GTATACAGA.CAAGCCTCG	GTATACAGA.CAAGCCTCG
GTATACAGA.GCCATCGCT	GTATACAGA.GCCATCGCT
GTATACAGA.GGTCGGTCT	GTATACAGA.GGTCGGTCT
GTATACAGA.TCCTGTCCG	GTATACAGA.TCCTGTCCG
GTATACAGA.TTCCGAGCG	GTATACAGA.TTCCGAGCG
GTATCCTGC.ACATCGTCC	GTATCCTGC.ACATCGTCC
GTATCCTGC.ACCGACGGT	GTATCCTGC.ACCGACGGT
GTATCCTGC.AGATCGAGT	GTATCCTGC.AGATCGAGT
GTATCCTGC.ATGCAGTTC	GTATCCTGC.ATGCAGTTC
GTATCCTGC.ATTCATGTG	GTATCCTGC.ATTCATGTG
GTATCCTGC.TCAGTAAGC	GTATCCTGC.TCAGTAAGC
GTATCGTCG.AACAACCTA	GTATCGTCG.AACAACCTA
GTATCGTCG.TGCAGATGC	GTATCGTCG.TGCAGATGC
GTATGATCT.CAGAAGTGA	GTATGATCT.CAGAAGTGA
GTATGCCTT.AACTCCATG	GTATGCCTT.AACTCCATG
GTATGCCTT.ACCATGTCT	GTATGCCTT.ACCATGTCT
GTATGCCTT.CAGTATGAT	GTATGCCTT.CAGTATGAT
GTATGCCTT.CATAGTATG	GTATGCCTT.CATAGTATG
GTATGCCTT.CGGTGAGTC	GTATGCCTT.CGGTGAGTC
GTATGCCTT.GCAACTCGC	GTATGCCTT.GCAACTCGC
GTATGCCTT.GGTGAGCGT	GTATGCCTT.GGTGAGCGT
GTATGCCTT.TAATCTGGA	GTATGCCTT.TAATCTGGA
GTATGCCTT.TACGGTCGT	GTATGCCTT.TACGGTCGT
GTATGCCTT.TCTTAAGTG	GTATGCCTT.TCTTAAGTG
GTATGTATC.CGTACATCT	GTATGTATC.CGTACATCT
GTATGTATC.TATGATGTG	GTATGTATC.TATGATGTG
GTATGTATC.TGAACGTCA	GTATGTATC.TGAACGTCA
GTATTACTG.AACCGCTGA	GTATTACTG.AACCGCTGA
GTATTACTG.ACAACGAGC	GTATTACTG.ACAACGAGC
GTATTACTG.ATGCTCACC	GTATTACTG.ATGCTCACC
GTATTACTG.CAGGTTGTC	GTATTACTG.CAGGTTGTC
GTATTACTG.CTGTGCTCA	GTATTACTG.CTGTGCTCA
GTCAACTGA.CACACCTGT	GTCAACTGA.CACACCTGT
GTCAACTGA.CGCAACCTC	GTCAACTGA.CGCAACCTC
GTCAACTGA.CGTTGATCC	GTCAACTGA.CGTTGATCC
GTCAACTGA.CTCAGGTAC	GTCAACTGA.CTCAGGTAC
GTCAACTGA.GTACTCTAC	GTCAACTGA.GTACTCTAC
GTCAACTGA.TCAACACTC	GTCAACTGA.TCAACACTC
GTCAACTGA.TTCACCTTG	GTCAACTGA.TTCACCTTG
GTCAACTGA.TTGCCGTAG	GTCAACTGA.TTGCCGTAG
GTCAAGATC.ACGGTGTAC	GTCAAGATC.ACGGTGTAC
GTCAAGATC.CACAACCAG	GTCAAGATC.CACAACCAG
GTCAAGATC.TGACAAGTT	GTCAAGATC.TGACAAGTT
GTCAAGATC.TTCCAGGAG	GTCAAGATC.TTCCAGGAG
GTCACAGAG.CCTATTCAA	GTCACAGAG.CCTATTCAA
GTCACAGAG.CGTAATGAC	GTCACAGAG.CGTAATGAC
GTCACAGAG.GGTACTTCC	GTCACAGAG.GGTACTTCC
GTCACAGAG.GTCTCCAGG	GTCACAGAG.GTCTCCAGG
GTCACAGAG.GTGAGGACG	GTCACAGAG.GTGAGGACG
GTCACAGAG.TCTAGTGAC	GTCACAGAG.TCTAGTGAC
GTCACAGAG.TGAGAGGAC	GTCACAGAG.TGAGAGGAC
GTCACTATG.ACACCGCCA	GTCACTATG.ACACCGCCA
GTCACTATG.AGACATATC	GTCACTATG.AGACATATC
GTCACTATG.AGCGCATGA	GTCACTATG.AGCGCATGA
GTCACTATG.CTCTGCGGT	GTCACTATG.CTCTGCGGT
GTCACTATG.GACTCAGTG	GTCACTATG.GACTCAGTG
GTCACTATG.GGACACTGG	GTCACTATG.GGACACTGG
GTCACTATG.GTGATGTGC	GTCACTATG.GTGATGTGC
GTCACTATG.TCCTGTCCG	GTCACTATG.TCCTGTCCG
GTCAGACCG.CTGCGATTC	GTCAGACCG.CTGCGATTC
GTCAGACCG.TTCCAGGAG	GTCAGACCG.TTCCAGGAG
GTCAGCGTC.CTGGTGACA	GTCAGCGTC.CTGGTGACA
GTCAGCGTC.GCAACTCGC	GTCAGCGTC.GCAACTCGC
GTCAGCGTC.TCCTTAGGT	GTCAGCGTC.TCCTTAGGT
GTCAGTTGT.ACTCCAACT	GTCAGTTGT.ACTCCAACT
GTCAGTTGT.AGTCAGTTG	GTCAGTTGT.AGTCAGTTG
GTCAGTTGT.CAGTAATGT	GTCAGTTGT.CAGTAATGT
GTCAGTTGT.GTGGAGGTC	GTCAGTTGT.GTGGAGGTC
GTCATTCTA.ATATCCGAT	GTCATTCTA.ATATCCGAT
GTCATTCTA.GTGGTTACC	GTCATTCTA.GTGGTTACC
GTCATTCTA.TACTCGACC	GTCATTCTA.TACTCGACC
GTCCACAAC.ACGTCGCTC	GTCCACAAC.ACGTCGCTC
GTCCACAAC.CATGGTTAC	GTCCACAAC.CATGGTTAC
GTCCACAAC.CGGATTCTC	GTCCACAAC.CGGATTCTC
GTCCGCTCA.CCGATCTCT	GTCCGCTCA.CCGATCTCT
GTCCGCTCA.TAGGATTAG	GTCCGCTCA.TAGGATTAG
GTCCGCTCA.TGAACCAAT	GTCCGCTCA.TGAACCAAT
GTCCGCTCA.TGACCTCCT	GTCCGCTCA.TGACCTCCT
GTCCGTAAG.ATAGCCTAA	GTCCGTAAG.ATAGCCTAA
GTCCGTAAG.CACTTGGAT	GTCCGTAAG.CACTTGGAT
GTCCGTAAG.GTCACAGAG	GTCCGTAAG.GTCACAGAG
GTCCGTAAG.TGACGATGA	GTCCGTAAG.TGACGATGA
GTCCTAGTT.AATATCAGC	GTCCTAGTT.AATATCAGC
GTCCTAGTT.GAACTCGTA	GTCCTAGTT.GAACTCGTA
GTCCTTCAT.CGCGATGTA	GTCCTTCAT.CGCGATGTA
GTCCTTCAT.CTATCTTGA	GTCCTTCAT.CTATCTTGA
GTCCTTCAT.CTTGGATCA	GTCCTTCAT.CTTGGATCA
GTCCTTCAT.TGCGACGTT	GTCCTTCAT.TGCGACGTT
GTCGACATT.AAGACGAAG	GTCGACATT.AAGACGAAG
GTCGACATT.AGTGAACGG	GTCGACATT.AGTGAACGG
GTCGACATT.ATCCGGTCC	GTCGACATT.ATCCGGTCC
GTCGACATT.CATCTCACG	GTCGACATT.CATCTCACG
GTCGACATT.CCGCACTCA	GTCGACATT.CCGCACTCA
GTCGACATT.GATCGCACT	GTCGACATT.GATCGCACT
GTCGACATT.GCATACATG	GTCGACATT.GCATACATG
GTCGACATT.GCCGTGAAC	GTCGACATT.GCCGTGAAC
GTCGACATT.GGTAGCATC	GTCGACATT.GGTAGCATC
GTCGACATT.TCACGCGAC	GTCGACATT.TCACGCGAC
GTCGAGTAC.ACCATTCAC	GTCGAGTAC.ACCATTCAC
GTCGAGTAC.GCTCAGCCA	GTCGAGTAC.GCTCAGCCA
GTCGAGTAC.TGCTCAGCG	GTCGAGTAC.TGCTCAGCG
GTCGAGTAC.TTCCTTGAC	GTCGAGTAC.TTCCTTGAC
GTCGCAGGT.AGATGTTGG	GTCGCAGGT.AGATGTTGG
GTCGCAGGT.ATAGTGGTT	GTCGCAGGT.ATAGTGGTT
GTCGCAGGT.ATCGGTGGT	GTCGCAGGT.ATCGGTGGT
GTCGCAGGT.CGCATAACT	GTCGCAGGT.CGCATAACT
GTCGCAGGT.GTCGACATT	GTCGCAGGT.GTCGACATT
GTCGCAGGT.TAATGTAGC	GTCGCAGGT.TAATGTAGC
GTCGCAGGT.TTGATGCTG	GTCGCAGGT.TTGATGCTG
GTCGTCGAC.AACAATGCA	GTCGTCGAC.AACAATGCA
GTCGTCGAC.CTCCGCATT	GTCGTCGAC.CTCCGCATT
GTCGTCGAC.GATCGCACT	GTCGTCGAC.GATCGCACT
GTCGTCGAC.TAGATAGCC	GTCGTCGAC.TAGATAGCC
GTCGTGTTA.CGCGTGAGA	GTCGTGTTA.CGCGTGAGA
GTCGTGTTA.TCACACTGC	GTCGTGTTA.TCACACTGC
GTCGTTAGA.TAACGTGTC	GTCGTTAGA.TAACGTGTC
GTCGTTGCG.ACCGTCCTA	GTCGTTGCG.ACCGTCCTA
GTCGTTGCG.ACTCGTCTA	GTCGTTGCG.ACTCGTCTA
GTCGTTGCG.CGAGTAGCA	GTCGTTGCG.CGAGTAGCA
GTCTACCAA.AGAAGAGTC	GTCTACCAA.AGAAGAGTC
GTCTACCAA.ATGGACGTT	GTCTACCAA.ATGGACGTT
GTCTACCAA.CCATAAGTA	GTCTACCAA.CCATAAGTA
GTCTACCAA.CCTAGAGTA	GTCTACCAA.CCTAGAGTA
GTCTACCAA.GCTACAATG	GTCTACCAA.GCTACAATG
GTCTACCAA.GTTGACCAT	GTCTACCAA.GTTGACCAT
GTCTACCAA.TATTGACTG	GTCTACCAA.TATTGACTG
GTCTACCAA.TCAGAGCGT	GTCTACCAA.TCAGAGCGT
GTCTACCAA.TGACTGAGA	GTCTACCAA.TGACTGAGA
GTCTACCAA.TGGAGAACC	GTCTACCAA.TGGAGAACC
GTCTACCAA.TTAAGTGGT	GTCTACCAA.TTAAGTGGT
GTCTCCAGG.AACGCCTAC	GTCTCCAGG.AACGCCTAC
GTCTCCAGG.ACGACATCT	GTCTCCAGG.ACGACATCT
GTCTCCAGG.CTGGTACAT	GTCTCCAGG.CTGGTACAT
GTCTCCAGG.TAGGATTAG	GTCTCCAGG.TAGGATTAG
GTCTCTTCA.AGTACTACA	GTCTCTTCA.AGTACTACA
GTCTCTTCA.ATGAGATCC	GTCTCTTCA.ATGAGATCC
GTCTCTTCA.CACCAGAAG	GTCTCTTCA.CACCAGAAG
GTCTCTTCA.TAGATAGCC	GTCTCTTCA.TAGATAGCC
GTCTCTTCA.TAGCAGAGT	GTCTCTTCA.TAGCAGAGT
GTCTCTTCA.TGCCACCGA	GTCTCTTCA.TGCCACCGA
GTCTGACGT.AACGCATTG	GTCTGACGT.AACGCATTG
GTCTGACGT.ATATCCGAT	GTCTGACGT.ATATCCGAT
GTCTGACGT.CCGATCAGC	GTCTGACGT.CCGATCAGC
GTCTGACGT.CGTGTGTGG	GTCTGACGT.CGTGTGTGG
GTCTGACGT.TCAGCGACC	GTCTGACGT.TCAGCGACC
GTCTGACGT.TGCTCACAC	GTCTGACGT.TGCTCACAC
GTCTGACGT.TTATTCGAC	GTCTGACGT.TTATTCGAC
GTCTGAGCC.CCAATGCCT	GTCTGAGCC.CCAATGCCT
GTCTGAGCC.CCGACTTGG	GTCTGAGCC.CCGACTTGG
GTCTGAGCC.GACTCTCAC	GTCTGAGCC.GACTCTCAC
GTCTGAGCC.GAGACGATC	GTCTGAGCC.GAGACGATC
GTCTGAGCC.TCAGGTGCA	GTCTGAGCC.TCAGGTGCA
GTCTTATGC.AACTCCATG	GTCTTATGC.AACTCCATG
GTCTTATGC.CCTCTCTAG	GTCTTATGC.CCTCTCTAG
GTCTTATGC.GGAGACACA	GTCTTATGC.GGAGACACA
GTCTTCATA.ACTGCTAGT	GTCTTCATA.ACTGCTAGT
GTCTTCATA.CAGGATCAA	GTCTTCATA.CAGGATCAA
GTCTTCATA.CCACGAAGG	GTCTTCATA.CCACGAAGG
GTCTTCATA.GTCTTCATA	GTCTTCATA.GTCTTCATA
GTCTTCTCG.AACTCCATG	GTCTTCTCG.AACTCCATG
GTCTTCTCG.ACCGAGTAG	GTCTTCTCG.ACCGAGTAG
GTCTTCTCG.ACTCCGGTT	GTCTTCTCG.ACTCCGGTT
GTCTTCTCG.CTACTGTCA	GTCTTCTCG.CTACTGTCA
GTCTTCTCG.GGAAGGTAT	GTCTTCTCG.GGAAGGTAT
GTCTTCTCG.GTCAAGATC	GTCTTCTCG.GTCAAGATC
GTCTTCTCG.TCAGTGTTC	GTCTTCTCG.TCAGTGTTC
GTCTTCTCG.TTAACGGAG	GTCTTCTCG.TTAACGGAG
GTGAACCAC.ATACGAGGT	GTGAACCAC.ATACGAGGT
GTGAACCAC.CAAGTACGA	GTGAACCAC.CAAGTACGA
GTGAACCAC.CCACGTTCT	GTGAACCAC.CCACGTTCT
GTGAACCAC.GCGCTACCT	GTGAACCAC.GCGCTACCT
GTGAACCAC.TCCTCTAGT	GTGAACCAC.TCCTCTAGT
GTGAATGCC.ACACACCGT	GTGAATGCC.ACACACCGT
GTGAATGCC.CAATGCATT	GTGAATGCC.CAATGCATT
GTGAATGCC.CTATACTAG	GTGAATGCC.CTATACTAG
GTGAATGCC.CTTAGGACT	GTGAATGCC.CTTAGGACT
GTGAATGCC.TCTTAGCGA	GTGAATGCC.TCTTAGCGA
GTGAATGCC.TGATGTGTG	GTGAATGCC.TGATGTGTG
GTGACGTAA.ACATGGATT	GTGACGTAA.ACATGGATT
GTGACGTAA.CATAATTGG	GTGACGTAA.CATAATTGG
GTGACGTAA.GATGTCTAG	GTGACGTAA.GATGTCTAG
GTGACGTAA.GGTAATCTA	GTGACGTAA.GGTAATCTA
GTGACTCTC.AGTGTGCAC	GTGACTCTC.AGTGTGCAC
GTGACTCTC.CGAATCCTG	GTGACTCTC.CGAATCCTG
GTGACTCTC.CGACCACTT	GTGACTCTC.CGACCACTT
GTGACTCTC.GGTTAGATG	GTGACTCTC.GGTTAGATG
GTGACTCTC.TAGACCATG	GTGACTCTC.TAGACCATG
GTGACTCTC.TCAGACAAG	GTGACTCTC.TCAGACAAG
GTGACTCTC.TTAACGGAG	GTGACTCTC.TTAACGGAG
GTGAGGACG.AACCATGGT	GTGAGGACG.AACCATGGT
GTGAGGACG.AGAGAGTGG	GTGAGGACG.AGAGAGTGG
GTGAGGACG.ATATTCGCA	GTGAGGACG.ATATTCGCA
GTGAGGACG.CCGCACTCA	GTGAGGACG.CCGCACTCA
GTGAGGACG.CCTAGAGTA	GTGAGGACG.CCTAGAGTA
GTGAGGACG.CTCGTTCAC	GTGAGGACG.CTCGTTCAC
GTGAGGACG.TATCTAGGT	GTGAGGACG.TATCTAGGT
GTGAGGACG.TGGAGAACC	GTGAGGACG.TGGAGAACC
GTGAGGACG.TGTCACATA	GTGAGGACG.TGTCACATA
GTGATGTGC.AGTGACGAT	GTGATGTGC.AGTGACGAT
GTGATGTGC.CAATTGTCT	GTGATGTGC.CAATTGTCT
GTGATGTGC.CATTGACAA	GTGATGTGC.CATTGACAA
GTGATGTGC.CGAGCTTAC	GTGATGTGC.CGAGCTTAC
GTGATGTGC.CGCAACCTC	GTGATGTGC.CGCAACCTC
GTGATGTGC.TGTCAACCT	GTGATGTGC.TGTCAACCT
GTGCACGAG.ATACCGAAG	GTGCACGAG.ATACCGAAG
GTGCACGAG.CAGGAGCCT	GTGCACGAG.CAGGAGCCT
GTGCACGAG.GAGACGATC	GTGCACGAG.GAGACGATC
GTGCACGAG.GATTGGAAG	GTGCACGAG.GATTGGAAG
GTGCACGAG.GCACATGTT	GTGCACGAG.GCACATGTT
GTGCACGAG.TCGTGACGT	GTGCACGAG.TCGTGACGT
GTGCACGAG.TTCCGAGCG	GTGCACGAG.TTCCGAGCG
GTGCATCAA.CATCAATAG	GTGCATCAA.CATCAATAG
GTGCATCAA.GAACATGAC	GTGCATCAA.GAACATGAC
GTGCCATGA.ACGCACACT	GTGCCATGA.ACGCACACT
GTGCCATGA.CGTGGTACC	GTGCCATGA.CGTGGTACC
GTGCCATGA.GAGTTAACT	GTGCCATGA.GAGTTAACT
GTGCCATGA.GTATCCTGC	GTGCCATGA.GTATCCTGC
GTGCCATGA.TACAAGAGG	GTGCCATGA.TACAAGAGG
GTGCCATGA.TTCCAGGAG	GTGCCATGA.TTCCAGGAG
GTGCGAGTA.GCCTGGAAT	GTGCGAGTA.GCCTGGAAT
GTGCGAGTA.GGTCTCATG	GTGCGAGTA.GGTCTCATG
GTGCGAGTA.TGTAGCAAG	GTGCGAGTA.TGTAGCAAG
GTGCGTTCC.AACCGCTGA	GTGCGTTCC.AACCGCTGA
GTGCGTTCC.AATGCCTCA	GTGCGTTCC.AATGCCTCA
GTGCGTTCC.ACTACCATC	GTGCGTTCC.ACTACCATC
GTGCGTTCC.ATAGTCTCC	GTGCGTTCC.ATAGTCTCC
GTGCGTTCC.CAGCTTCGA	GTGCGTTCC.CAGCTTCGA
GTGCGTTCC.CGATTGAAC	GTGCGTTCC.CGATTGAAC
GTGCGTTCC.GATGTAAGG	GTGCGTTCC.GATGTAAGG
GTGCGTTCC.GGATAATAC	GTGCGTTCC.GGATAATAC
GTGCGTTCC.GTAGGACGC	GTGCGTTCC.GTAGGACGC
GTGCGTTCC.TAACATTGG	GTGCGTTCC.TAACATTGG
GTGCGTTCC.TCCGGAGCT	GTGCGTTCC.TCCGGAGCT
GTGCTAAGC.ACAGAAGAG	GTGCTAAGC.ACAGAAGAG
GTGCTAAGC.CCGCAACAC	GTGCTAAGC.CCGCAACAC
GTGCTAAGC.CTAGTATAG	GTGCTAAGC.CTAGTATAG
GTGCTAAGC.GAGCACATT	GTGCTAAGC.GAGCACATT
GTGCTCGGA.ATCGCCTCT	GTGCTCGGA.ATCGCCTCT
GTGCTCGGA.CTCGACTGC	GTGCTCGGA.CTCGACTGC
GTGCTCTTG.CATAGTATG	GTGCTCTTG.CATAGTATG
GTGCTCTTG.GATCGATAC	GTGCTCTTG.GATCGATAC
GTGCTCTTG.GCCTTCCAT	GTGCTCTTG.GCCTTCCAT
GTGCTCTTG.TAACCGTGA	GTGCTCTTG.TAACCGTGA
GTGCTCTTG.TCGGACAGT	GTGCTCTTG.TCGGACAGT
GTGCTCTTG.TGGTGCCTG	GTGCTCTTG.TGGTGCCTG
GTGCTGACT.ACAAGAATG	GTGCTGACT.ACAAGAATG
GTGCTGACT.ACCGAGTAG	GTGCTGACT.ACCGAGTAG
GTGCTGACT.AGAAGTAAC	GTGCTGACT.AGAAGTAAC
GTGCTGACT.GAGTCTTCG	GTGCTGACT.GAGTCTTCG
GTGCTGACT.TCACTCGCT	GTGCTGACT.TCACTCGCT
GTGGACTGG.AAGCTGGTC	GTGGACTGG.AAGCTGGTC
GTGGACTGG.ATGGTTCGA	GTGGACTGG.ATGGTTCGA
GTGGACTGG.GACAGGTTA	GTGGACTGG.GACAGGTTA
GTGGAGGTC.ACAGCATCA	GTGGAGGTC.ACAGCATCA
GTGGAGGTC.ATCCGGTCC	GTGGAGGTC.ATCCGGTCC
GTGGAGGTC.CACCTAGCG	GTGGAGGTC.CACCTAGCG
GTGGAGGTC.CTGTGCTCA	GTGGAGGTC.CTGTGCTCA
GTGGAGGTC.GATCGATAC	GTGGAGGTC.GATCGATAC
GTGGAGGTC.GCACATGTT	GTGGAGGTC.GCACATGTT
GTGGAGGTC.TGGTGGTAA	GTGGAGGTC.TGGTGGTAA
GTGGATAAG.AACTCCATG	GTGGATAAG.AACTCCATG
GTGGATAAG.ACGCACACT	GTGGATAAG.ACGCACACT
GTGGATAAG.CCTAAGTCT	GTGGATAAG.CCTAAGTCT
GTGGATAAG.GCTTCACTC	GTGGATAAG.GCTTCACTC
GTGGTACGG.AATACTCCG	GTGGTACGG.AATACTCCG
GTGGTACGG.ACTGGACCA	GTGGTACGG.ACTGGACCA
GTGGTACGG.AGATATGGA	GTGGTACGG.AGATATGGA
GTGGTACGG.CACTCACTA	GTGGTACGG.CACTCACTA
GTGGTACGG.TATGACCGA	GTGGTACGG.TATGACCGA
GTGGTTACC.ACTCACGAA	GTGGTTACC.ACTCACGAA
GTGGTTACC.ATTAGCGGT	GTGGTTACC.ATTAGCGGT
GTGGTTACC.CCTTGTTGC	GTGGTTACC.CCTTGTTGC
GTGGTTACC.CGGTGAGTC	GTGGTTACC.CGGTGAGTC
GTGGTTACC.CTGCAAGCC	GTGGTTACC.CTGCAAGCC
GTGGTTACC.GATAGTTCT	GTGGTTACC.GATAGTTCT
GTGTACCGT.AGTAACGTA	GTGTACCGT.AGTAACGTA
GTGTACCGT.TCCAACGTG	GTGTACCGT.TCCAACGTG
GTGTACCGT.TCGTACCTT	GTGTACCGT.TCGTACCTT
GTGTATCTG.AGTAACGTA	GTGTATCTG.AGTAACGTA
GTGTATCTG.CAACCTGGT	GTGTATCTG.CAACCTGGT
GTGTATCTG.TCTCGATGC	GTGTATCTG.TCTCGATGC
GTGTCACAC.AGAGAGTGG	GTGTCACAC.AGAGAGTGG
GTGTCACAC.GGACTATTC	GTGTCACAC.GGACTATTC
GTGTCACAC.TAAGGTGAT	GTGTCACAC.TAAGGTGAT
GTGTCACAC.TCGCGTCAT	GTGTCACAC.TCGCGTCAT
GTGTCCGTG.CTCAGTGAT	GTGTCCGTG.CTCAGTGAT
GTGTCCGTG.CTCTAAGAG	GTGTCCGTG.CTCTAAGAG
GTGTCGAGC.AGAGCCGCA	GTGTCGAGC.AGAGCCGCA
GTGTCGAGC.CGCACTCTT	GTGTCGAGC.CGCACTCTT
GTGTCGAGC.TGCCATCTC	GTGTCGAGC.TGCCATCTC
GTGTCTGGA.AAGGAACAG	GTGTCTGGA.AAGGAACAG
GTGTCTGGA.CGCGTACTA	GTGTCTGGA.CGCGTACTA
GTGTCTGGA.CTTCCGTGG	GTGTCTGGA.CTTCCGTGG
GTGTTCCAG.AACTTCTGC	GTGTTCCAG.AACTTCTGC
GTGTTCCAG.AATACTCCG	GTGTTCCAG.AATACTCCG
GTGTTCCAG.CCGCATCCT	GTGTTCCAG.CCGCATCCT
GTGTTGGAA.GCTACCTTA	GTGTTGGAA.GCTACCTTA
GTTAATTCG.ACACTAACG	GTTAATTCG.ACACTAACG
GTTAATTCG.CTGCTTAGG	GTTAATTCG.CTGCTTAGG
GTTAATTCG.GTTGACCAT	GTTAATTCG.GTTGACCAT
GTTAATTCG.TGGACTGCC	GTTAATTCG.TGGACTGCC
GTTACTACT.GCGCTTCTC	GTTACTACT.GCGCTTCTC
GTTAGAGAC.AGAAGTAAC	GTTAGAGAC.AGAAGTAAC
GTTAGAGAC.ATGTCCTCC	GTTAGAGAC.ATGTCCTCC
GTTAGAGAC.CACGCGTAA	GTTAGAGAC.CACGCGTAA
GTTAGAGAC.GTATACAGA	GTTAGAGAC.GTATACAGA
GTTAGAGAC.TAACGTGTC	GTTAGAGAC.TAACGTGTC
GTTAGATTG.ACTGGTCAG	GTTAGATTG.ACTGGTCAG
GTTAGATTG.CGATAGGTG	GTTAGATTG.CGATAGGTG
GTTAGATTG.CGCCTGCAA	GTTAGATTG.CGCCTGCAA
GTTAGATTG.CGTCTGCTG	GTTAGATTG.CGTCTGCTG
GTTAGATTG.GGACACTGG	GTTAGATTG.GGACACTGG
GTTAGTCAA.ATGGAGGAA	GTTAGTCAA.ATGGAGGAA
GTTAGTCAA.CAAGAGGAG	GTTAGTCAA.CAAGAGGAG
GTTAGTCAA.GACAATGTT	GTTAGTCAA.GACAATGTT
GTTATCGAT.AATCTCCTA	GTTATCGAT.AATCTCCTA
GTTATCGAT.ATGTCGCCT	GTTATCGAT.ATGTCGCCT
GTTATCGAT.CTTCCTGAT	GTTATCGAT.CTTCCTGAT
GTTATCGAT.GTTGACCAT	GTTATCGAT.GTTGACCAT
GTTCACTCC.AGGTCAGCA	GTTCACTCC.AGGTCAGCA
GTTCACTCC.CCTCATAAC	GTTCACTCC.CCTCATAAC
GTTCAGAAG.AAGGAACAG	GTTCAGAAG.AAGGAACAG
GTTCAGAAG.ACTCGTAGG	GTTCAGAAG.ACTCGTAGG
GTTCAGAAG.CTTCTCATC	GTTCAGAAG.CTTCTCATC
GTTCAGAAG.GCCTGGAAT	GTTCAGAAG.GCCTGGAAT
GTTCAGAAG.TCACATACT	GTTCAGAAG.TCACATACT
GTTCCAACA.ACAGCGGTC	GTTCCAACA.ACAGCGGTC
GTTCCAACA.ACGATGACC	GTTCCAACA.ACGATGACC
GTTCCAACA.ACTTGATCT	GTTCCAACA.ACTTGATCT
GTTCCAACA.TACGACCAT	GTTCCAACA.TACGACCAT
GTTGACCAT.CATCTCACG	GTTGACCAT.CATCTCACG
GTTGACGTG.ACCTAGCAC	GTTGACGTG.ACCTAGCAC
GTTGACGTG.CAGCTTCGA	GTTGACGTG.CAGCTTCGA
GTTGACGTG.CCGCTCATG	GTTGACGTG.CCGCTCATG
GTTGACGTG.CTAATACGC	GTTGACGTG.CTAATACGC
GTTGACGTG.CTTCGTGCA	GTTGACGTG.CTTCGTGCA
GTTGACGTG.GATCGATAC	GTTGACGTG.GATCGATAC
GTTGACGTG.GATCTAGAG	GTTGACGTG.GATCTAGAG
GTTGACGTG.TAGAGACTA	GTTGACGTG.TAGAGACTA
GTTGATGCA.AATCTGACC	GTTGATGCA.AATCTGACC
GTTGATGCA.ATAATCGAG	GTTGATGCA.ATAATCGAG
GTTGATGCA.CCTATTGGT	GTTGATGCA.CCTATTGGT
GTTGATGCA.CTAACCGGT	GTTGATGCA.CTAACCGGT
GTTGATGCA.CTCGCAAGA	GTTGATGCA.CTCGCAAGA
GTTGCATGG.CCTCTTGTA	GTTGCATGG.CCTCTTGTA
