GCCGAGTCT.TGATAGAGG	GCCGAGTCT.TGATAGAGG
GCCGCCTAA.AATATCGCT	GCCGCCTAA.AATATCGCT
GCCGCCTAA.ATTATGCAG	GCCGCCTAA.ATTATGCAG
GCCGCCTAA.CGCATAACT	GCCGCCTAA.CGCATAACT
GCCGCCTAA.CGGAATGCA	GCCGCCTAA.CGGAATGCA
GCCGCCTAA.GTTGCTCAG	GCCGCCTAA.GTTGCTCAG
GCCGCCTAA.TCGTCCGAT	GCCGCCTAA.TCGTCCGAT
GCCGCCTAA.TGTGTAGAG	GCCGCCTAA.TGTGTAGAG
GCCGCCTAA.TTAGGAAGG	GCCGCCTAA.TTAGGAAGG
GCCGCTATC.ATCCATTAG	GCCGCTATC.ATCCATTAG
GCCGTCTTC.AAGTCATGA	GCCGTCTTC.AAGTCATGA
GCCGTGAAC.ATCGCCTCT	GCCGTGAAC.ATCGCCTCT
GCCGTGAAC.ATCTCTGCT	GCCGTGAAC.ATCTCTGCT
GCCGTGAAC.CATCCACCG	GCCGTGAAC.CATCCACCG
GCCGTGAAC.CTACTGTCA	GCCGTGAAC.CTACTGTCA
GCCGTGAAC.CTTAGAAGG	GCCGTGAAC.CTTAGAAGG
GCCGTTGTT.ACGTATGTC	GCCGTTGTT.ACGTATGTC
GCCGTTGTT.CAGGAGCCT	GCCGTTGTT.CAGGAGCCT
GCCGTTGTT.CTCATGCCA	GCCGTTGTT.CTCATGCCA
GCCGTTGTT.GATCTAGAG	GCCGTTGTT.GATCTAGAG
GCCGTTGTT.GCTGTTCGG	GCCGTTGTT.GCTGTTCGG
GCCGTTGTT.GTGCGAGTA	GCCGTTGTT.GTGCGAGTA
GCCGTTGTT.GTTGATGCA	GCCGTTGTT.GTTGATGCA
GCCGTTGTT.TAACCGTGA	GCCGTTGTT.TAACCGTGA
GCCGTTGTT.TATCGAGCC	GCCGTTGTT.TATCGAGCC
GCCTAACGG.ACTTCTAAC	GCCTAACGG.ACTTCTAAC
GCCTAACGG.AGACTTCGT	GCCTAACGG.AGACTTCGT
GCCTAACGG.AGATCTTCA	GCCTAACGG.AGATCTTCA
GCCTAACGG.CGTACACAC	GCCTAACGG.CGTACACAC
GCCTGCATC.AGTTCAACC	GCCTGCATC.AGTTCAACC
GCCTGCATC.ATCATAGAC	GCCTGCATC.ATCATAGAC
GCCTGCATC.GGAGCATCT	GCCTGCATC.GGAGCATCT
GCCTGCATC.TATGAGACC	GCCTGCATC.TATGAGACC
GCCTGGAAT.ACGTCGCTC	GCCTGGAAT.ACGTCGCTC
GCCTGGAAT.AGTCGCGAC	GCCTGGAAT.AGTCGCGAC
GCCTGGAAT.AGTCTAAGC	GCCTGGAAT.AGTCTAAGC
GCCTGGAAT.AGTGTCTCT	GCCTGGAAT.AGTGTCTCT
GCCTGGAAT.CCGCATCCT	GCCTGGAAT.CCGCATCCT
GCCTGGAAT.CCGCTATCC	GCCTGGAAT.CCGCTATCC
GCCTGGAAT.CCTACTAGA	GCCTGGAAT.CCTACTAGA
GCCTGGAAT.CTAGGTACT	GCCTGGAAT.CTAGGTACT
GCCTGGAAT.GCTTGGTTC	GCCTGGAAT.GCTTGGTTC
GCCTGGAAT.GGATCAGGT	GCCTGGAAT.GGATCAGGT
GCCTGGAAT.TGGAACTAA	GCCTGGAAT.TGGAACTAA
GCCTTAGAG.AACGCATTG	GCCTTAGAG.AACGCATTG
GCCTTAGAG.AATGCTGAT	GCCTTAGAG.AATGCTGAT
GCCTTAGAG.GAGTCCAAT	GCCTTAGAG.GAGTCCAAT
GCCTTAGAG.GAGTCGTAC	GCCTTAGAG.GAGTCGTAC
GCCTTAGAG.GTTCACTCC	GCCTTAGAG.GTTCACTCC
GCCTTAGAG.TCCAATCAT	GCCTTAGAG.TCCAATCAT
GCCTTATCT.AGTACTCTC	GCCTTATCT.AGTACTCTC
GCCTTATCT.CTCTACGCA	GCCTTATCT.CTCTACGCA
GCCTTATCT.TACTGATGA	GCCTTATCT.TACTGATGA
GCCTTCCAT.AACGGTAGC	GCCTTCCAT.AACGGTAGC
GCCTTCCAT.CTATCTTGA	GCCTTCCAT.CTATCTTGA
GCCTTCCAT.GGAAGTATG	GCCTTCCAT.GGAAGTATG
GCCTTGTGA.CCTCTGCAT	GCCTTGTGA.CCTCTGCAT
GCCTTGTGA.CGGTGTTAC	GCCTTGTGA.CGGTGTTAC
GCCTTGTGA.TATGCCTTC	GCCTTGTGA.TATGCCTTC
GCCTTGTGA.TGATTGTGC	GCCTTGTGA.TGATTGTGC
GCGAACTCG.AACGTTCTT	GCGAACTCG.AACGTTCTT
GCGAACTCG.AAGACGAAG	GCGAACTCG.AAGACGAAG
GCGAACTCG.CCACAAGGT	GCGAACTCG.CCACAAGGT
GCGAACTCG.CGAGCTTAC	GCGAACTCG.CGAGCTTAC
GCGAACTCG.CGCATCTAC	GCGAACTCG.CGCATCTAC
GCGAACTCG.GGTCTCATG	GCGAACTCG.GGTCTCATG
GCGAACTCG.TCAAGGTCG	GCGAACTCG.TCAAGGTCG
GCGAAGACA.AGTCCGTGT	GCGAAGACA.AGTCCGTGT
GCGAAGACA.ATATCCGAT	GCGAAGACA.ATATCCGAT
GCGAAGACA.CAGGTTGTC	GCGAAGACA.CAGGTTGTC
GCGAAGACA.CGTGCCTAT	GCGAAGACA.CGTGCCTAT
GCGAAGACA.GACGGACTA	GCGAAGACA.GACGGACTA
GCGAAGACA.GGTAGCATC	GCGAAGACA.GGTAGCATC
GCGAAGACA.TCAATGGAC	GCGAAGACA.TCAATGGAC
GCGAAGCTC.AAGGAAGTC	GCGAAGCTC.AAGGAAGTC
GCGAAGCTC.GAGTGCATA	GCGAAGCTC.GAGTGCATA
GCGAAGCTC.GGAGCATCT	GCGAAGCTC.GGAGCATCT
GCGAAGCTC.TTCAGTGCC	GCGAAGCTC.TTCAGTGCC
GCGACAACC.AATGCAGCG	GCGACAACC.AATGCAGCG
GCGACAACC.CATAGGTGT	GCGACAACC.CATAGGTGT
GCGACAACC.TACGAACTC	GCGACAACC.TACGAACTC
GCGACAACC.TGCTCCTCC	GCGACAACC.TGCTCCTCC
GCGACACAG.AGGAAGGTG	GCGACACAG.AGGAAGGTG
GCGACACAG.GAGACGATC	GCGACACAG.GAGACGATC
GCGACACAG.GCCTTATCT	GCGACACAG.GCCTTATCT
GCGACACAG.TGGACTGCC	GCGACACAG.TGGACTGCC
GCGACCTGT.GGATGCTCG	GCGACCTGT.GGATGCTCG
GCGACCTGT.TAACGGATA	GCGACCTGT.TAACGGATA
GCGAGCAAG.AGTTCGATA	GCGAGCAAG.AGTTCGATA
GCGAGCAAG.CAGCTTCGA	GCGAGCAAG.CAGCTTCGA
GCGAGCAAG.CAGGATCAA	GCGAGCAAG.CAGGATCAA
GCGAGCAAG.CCACAAGGT	GCGAGCAAG.CCACAAGGT
GCGAGCAAG.GGTTCTATC	GCGAGCAAG.GGTTCTATC
GCGAGCAAG.TCACTCGCT	GCGAGCAAG.TCACTCGCT
GCGAGTCTA.AGTATGACG	GCGAGTCTA.AGTATGACG
GCGAGTCTA.GGTGATAGG	GCGAGTCTA.GGTGATAGG
GCGAGTCTA.GTGACGTAA	GCGAGTCTA.GTGACGTAA
GCGATATGA.AATATCGCT	GCGATATGA.AATATCGCT
GCGATATGA.ACCGTCACG	GCGATATGA.ACCGTCACG
GCGATATGA.AGTATGACG	GCGATATGA.AGTATGACG
GCGATATGA.GAACTGCAA	GCGATATGA.GAACTGCAA
GCGATATGA.GTCTTATGC	GCGATATGA.GTCTTATGC
GCGATATGA.TGAGAGGAC	GCGATATGA.TGAGAGGAC
GCGATGGTG.AGACATCCA	GCGATGGTG.AGACATCCA
GCGATGGTG.AGTTCAACC	GCGATGGTG.AGTTCAACC
GCGATGGTG.CTACGAGAA	GCGATGGTG.CTACGAGAA
GCGATGGTG.TTCCAGATT	GCGATGGTG.TTCCAGATT
GCGCATTAC.AACTGCGAC	GCGCATTAC.AACTGCGAC
GCGCATTAC.ACCTGTACC	GCGCATTAC.ACCTGTACC
GCGCATTAC.CACGTCATA	GCGCATTAC.CACGTCATA
GCGCATTAC.CATCCAGGA	GCGCATTAC.CATCCAGGA
GCGCATTAC.CGCATAACT	GCGCATTAC.CGCATAACT
GCGCTACCT.ACCGGAGTA	GCGCTACCT.ACCGGAGTA
GCGCTACCT.CGCTTATGA	GCGCTACCT.CGCTTATGA
GCGCTACCT.TTGGACTTC	GCGCTACCT.TTGGACTTC
GCGCTAGAA.CCTTCCTCA	GCGCTAGAA.CCTTCCTCA
GCGCTCTAT.ATCCAATGA	GCGCTCTAT.ATCCAATGA
GCGCTCTAT.TACAAGAGG	GCGCTCTAT.TACAAGAGG
GCGCTCTAT.TACGTTACC	GCGCTCTAT.TACGTTACC
GCGCTCTAT.TTCACCTTG	GCGCTCTAT.TTCACCTTG
GCGCTTCTC.AACGCCTAC	GCGCTTCTC.AACGCCTAC
GCGCTTCTC.AGGATGCGT	GCGCTTCTC.AGGATGCGT
GCGCTTCTC.AGTGTCTCT	GCGCTTCTC.AGTGTCTCT
GCGCTTCTC.ATGCCTTCA	GCGCTTCTC.ATGCCTTCA
GCGCTTCTC.CAGTGCTGC	GCGCTTCTC.CAGTGCTGC
GCGGACGAA.CAATCATAC	GCGGACGAA.CAATCATAC
GCGGAGATT.AATACTCCG	GCGGAGATT.AATACTCCG
GCGGAGATT.CTATAGCTC	GCGGAGATT.CTATAGCTC
GCGGAGATT.GCTATGTAA	GCGGAGATT.GCTATGTAA
GCGGTAAGT.CAGTTGAGT	GCGGTAAGT.CAGTTGAGT
GCGGTAAGT.CTGTAGAAG	GCGGTAAGT.CTGTAGAAG
GCGGTAGTC.CAATTGTCT	GCGGTAGTC.CAATTGTCT
GCGGTAGTC.CCAATATAC	GCGGTAGTC.CCAATATAC
GCGGTAGTC.CCTGACCTC	GCGGTAGTC.CCTGACCTC
GCGGTAGTC.CTGAGATAG	GCGGTAGTC.CTGAGATAG
GCGGTAGTC.TGATGTGTG	GCGGTAGTC.TGATGTGTG
GCGGTAGTC.TGTATCGTG	GCGGTAGTC.TGTATCGTG
GCGTAACAA.ACTAAGTTC	GCGTAACAA.ACTAAGTTC
GCGTAACAA.ATAGTGGTT	GCGTAACAA.ATAGTGGTT
GCGTAACAA.CCACACAGA	GCGTAACAA.CCACACAGA
GCGTAACAA.GCTACAATG	GCGTAACAA.GCTACAATG
GCGTAACAA.GGTTCGCAA	GCGTAACAA.GGTTCGCAA
GCGTATAGG.ACTGGACCA	GCGTATAGG.ACTGGACCA
GCGTATAGG.AGATGTTGG	GCGTATAGG.AGATGTTGG
GCGTATAGG.CTCGAACTG	GCGTATAGG.CTCGAACTG
GCGTATAGG.CTTCGTGCA	GCGTATAGG.CTTCGTGCA
GCGTATAGG.GCCTAACGG	GCGTATAGG.GCCTAACGG
GCGTATAGG.GTACGCGAT	GCGTATAGG.GTACGCGAT
GCGTATAGG.GTCAATACA	GCGTATAGG.GTCAATACA
GCGTATAGG.GTCGTTGCG	GCGTATAGG.GTCGTTGCG
GCGTATAGG.TACGTTACC	GCGTATAGG.TACGTTACC
GCGTATAGG.TGATACCGT	GCGTATAGG.TGATACCGT
GCGTATAGG.TTGCGAACA	GCGTATAGG.TTGCGAACA
GCGTCGTCT.ACTCCAACT	GCGTCGTCT.ACTCCAACT
GCGTCGTCT.CAGCACGTG	GCGTCGTCT.CAGCACGTG
GCGTCGTCT.CTACGAGAA	GCGTCGTCT.CTACGAGAA
GCGTCGTCT.CTTGCGACC	GCGTCGTCT.CTTGCGACC
GCGTCGTCT.TCATCAGAG	GCGTCGTCT.TCATCAGAG
GCGTGAGCT.ACCTGCAGA	GCGTGAGCT.ACCTGCAGA
GCGTGAGCT.GACAATGTT	GCGTGAGCT.GACAATGTT
GCGTGAGCT.GATGTAAGG	GCGTGAGCT.GATGTAAGG
GCGTGAGCT.GTCACAGAG	GCGTGAGCT.GTCACAGAG
GCGTGAGCT.TCAACACTC	GCGTGAGCT.TCAACACTC
GCGTGAGCT.TCCACGTGC	GCGTGAGCT.TCCACGTGC
GCGTGAGCT.TGCCACCGA	GCGTGAGCT.TGCCACCGA
GCGTGATAC.ACCGAGACA	GCGTGATAC.ACCGAGACA
GCGTTCAGA.ACACAGAAC	GCGTTCAGA.ACACAGAAC
GCGTTCAGA.AGGATCATG	GCGTTCAGA.AGGATCATG
GCGTTCAGA.ATAAGTTCG	GCGTTCAGA.ATAAGTTCG
GCGTTCAGA.CTGTCTAGT	GCGTTCAGA.CTGTCTAGT
GCGTTCAGA.GCAACTCGC	GCGTTCAGA.GCAACTCGC
GCGTTCAGA.GTTCACTCC	GCGTTCAGA.GTTCACTCC
GCTACAATG.CAGCGACGT	GCTACAATG.CAGCGACGT
GCTACAATG.CCATATCTT	GCTACAATG.CCATATCTT
GCTACAATG.GGAGTACAG	GCTACAATG.GGAGTACAG
GCTACCGAG.GAGGTCACG	GCTACCGAG.GAGGTCACG
GCTACCGAG.GATATATCC	GCTACCGAG.GATATATCC
GCTACCGAG.GTTGACCAT	GCTACCGAG.GTTGACCAT
GCTACCTTA.AGCATATGG	GCTACCTTA.AGCATATGG
GCTACCTTA.CATAATTGG	GCTACCTTA.CATAATTGG
GCTACCTTA.CGTATTCCT	GCTACCTTA.CGTATTCCT
GCTAGCTCC.AATGCGTGC	GCTAGCTCC.AATGCGTGC
GCTAGCTCC.ATAATGTGG	GCTAGCTCC.ATAATGTGG
GCTAGCTCC.GGAACTGCT	GCTAGCTCC.GGAACTGCT
GCTAGCTCC.TGGACGAGA	GCTAGCTCC.TGGACGAGA
GCTAGTGGA.CCTTGCTTG	GCTAGTGGA.CCTTGCTTG
GCTAGTGGA.TAGCCAGTG	GCTAGTGGA.TAGCCAGTG
GCTAGTGGA.TCATGCAGG	GCTAGTGGA.TCATGCAGG
GCTATGTAA.CACACTGCC	GCTATGTAA.CACACTGCC
GCTATGTAA.GGTAGCATC	GCTATGTAA.GGTAGCATC
GCTATGTAA.TAGGATGCC	GCTATGTAA.TAGGATGCC
GCTATGTAA.TTACGCTCG	GCTATGTAA.TTACGCTCG
GCTCAATGA.AGCTTGGTG	GCTCAATGA.AGCTTGGTG
GCTCAATGA.GATCTGAAT	GCTCAATGA.GATCTGAAT
GCTCAATGA.GATGTCTAG	GCTCAATGA.GATGTCTAG
GCTCAATGA.GGACTCCTT	GCTCAATGA.GGACTCCTT
GCTCAATGA.TAGCACTAT	GCTCAATGA.TAGCACTAT
GCTCAATGA.TTCAGTGCC	GCTCAATGA.TTCAGTGCC
GCTCAGCCA.GCACCATCG	GCTCAGCCA.GCACCATCG
GCTCAGCCA.GCTTGTCCT	GCTCAGCCA.GCTTGTCCT
GCTCAGCCA.TGTCGTACA	GCTCAGCCA.TGTCGTACA
GCTCAGCCA.TTCGCTGAG	GCTCAGCCA.TTCGCTGAG
GCTCCTAGC.ATATCCGAT	GCTCCTAGC.ATATCCGAT
GCTCCTAGC.CAACTCCAG	GCTCCTAGC.CAACTCCAG
GCTCCTAGC.CCACATTAG	GCTCCTAGC.CCACATTAG
GCTCCTAGC.CCAGGAGTT	GCTCCTAGC.CCAGGAGTT
GCTCCTAGC.CGGTTCGTA	GCTCCTAGC.CGGTTCGTA
GCTCTCCAA.CTGATCCGA	GCTCTCCAA.CTGATCCGA
GCTCTCCAA.GAATTGTTG	GCTCTCCAA.GAATTGTTG
GCTCTCCAA.TAATTCGTG	GCTCTCCAA.TAATTCGTG
GCTCTGTGT.AGTGGAATG	GCTCTGTGT.AGTGGAATG
GCTCTGTGT.CCGATGTTC	GCTCTGTGT.CCGATGTTC
GCTCTGTGT.TACCGCGTT	GCTCTGTGT.TACCGCGTT
GCTCTGTGT.TCCTCTAGT	GCTCTGTGT.TCCTCTAGT
GCTCTGTGT.TCTACGCAA	GCTCTGTGT.TCTACGCAA
GCTCTGTGT.TGGATAGGT	GCTCTGTGT.TGGATAGGT
GCTCTGTGT.TTCGCATCC	GCTCTGTGT.TTCGCATCC
GCTGACAGA.ACGACAGTC	GCTGACAGA.ACGACAGTC
GCTGACAGA.CACCTCAAC	GCTGACAGA.CACCTCAAC
GCTGACAGA.CCTGTATCT	GCTGACAGA.CCTGTATCT
GCTGACAGA.GGTGTTCAT	GCTGACAGA.GGTGTTCAT
GCTGACAGA.TCTGATGAA	GCTGACAGA.TCTGATGAA
GCTGACAGA.TCTGTGAAG	GCTGACAGA.TCTGTGAAG
GCTGACAGA.TGCTTACGG	GCTGACAGA.TGCTTACGG
GCTGACAGA.TGTATCGTG	GCTGACAGA.TGTATCGTG
GCTGAGCAG.AGGTATTCC	GCTGAGCAG.AGGTATTCC
GCTGAGCAG.CACTGTATC	GCTGAGCAG.CACTGTATC
GCTGAGCAG.CTTATTGAG	GCTGAGCAG.CTTATTGAG
GCTGAGCAG.GTCTCTTCA	GCTGAGCAG.GTCTCTTCA
GCTGATGTC.AACCGCTGA	GCTGATGTC.AACCGCTGA
GCTGATGTC.AGCAACATT	GCTGATGTC.AGCAACATT
GCTGATGTC.CAGTAATGT	GCTGATGTC.CAGTAATGT
GCTGATGTC.CTCTTCAGC	GCTGATGTC.CTCTTCAGC
GCTGATGTC.GCATACATG	GCTGATGTC.GCATACATG
GCTGATGTC.GCGACACAG	GCTGATGTC.GCGACACAG
GCTGATGTC.GTAAGTGAG	GCTGATGTC.GTAAGTGAG
GCTGGTAAC.GAGATGTAT	GCTGGTAAC.GAGATGTAT
GCTGGTAAC.GATCGCGAA	GCTGGTAAC.GATCGCGAA
GCTGGTTCG.AAGACTGGT	GCTGGTTCG.AAGACTGGT
GCTGGTTCG.AAGGAACAG	GCTGGTTCG.AAGGAACAG
GCTGGTTCG.AATCCGCTG	GCTGGTTCG.AATCCGCTG
GCTGGTTCG.CACATTCTG	GCTGGTTCG.CACATTCTG
GCTGGTTCG.GTGCTGACT	GCTGGTTCG.GTGCTGACT
GCTGGTTCG.TGTTGTCGA	GCTGGTTCG.TGTTGTCGA
GCTGTTCGG.CTTAATCGT	GCTGTTCGG.CTTAATCGT
GCTGTTCGG.GCGATATGA	GCTGTTCGG.GCGATATGA
GCTGTTCGG.TATCCTCAG	GCTGTTCGG.TATCCTCAG
GCTGTTCGG.TCGCTTAAC	GCTGTTCGG.TCGCTTAAC
GCTTACGTT.CAATTGTCT	GCTTACGTT.CAATTGTCT
GCTTACGTT.CAGTACATC	GCTTACGTT.CAGTACATC
GCTTACGTT.CGCAGTGTC	GCTTACGTT.CGCAGTGTC
GCTTACGTT.CGTACATCT	GCTTACGTT.CGTACATCT
GCTTACGTT.GTGGATAAG	GCTTACGTT.GTGGATAAG
GCTTACGTT.TCTCGATGC	GCTTACGTT.TCTCGATGC
GCTTACTAG.CCGAGTACT	GCTTACTAG.CCGAGTACT
GCTTACTAG.CTTGATCTA	GCTTACTAG.CTTGATCTA
GCTTAGAAC.ACTTCAGTA	GCTTAGAAC.ACTTCAGTA
GCTTCACTC.CCAATGCCT	GCTTCACTC.CCAATGCCT
GCTTCACTC.CCGGTGGTT	GCTTCACTC.CCGGTGGTT
GCTTCACTC.CTAACCGGT	GCTTCACTC.CTAACCGGT
GCTTCACTC.GTACAATGC	GCTTCACTC.GTACAATGC
GCTTCACTC.TAACACATC	GCTTCACTC.TAACACATC
GCTTCTACG.GACTTCACC	GCTTCTACG.GACTTCACC
GCTTCTGAA.CACTCACTA	GCTTCTGAA.CACTCACTA
GCTTCTGAA.TAAGGTGAT	GCTTCTGAA.TAAGGTGAT
GCTTCTGAA.TCAATGGAC	GCTTCTGAA.TCAATGGAC
GCTTCTGAA.TCCAACGTG	GCTTCTGAA.TCCAACGTG
GCTTCTGAA.TGTCATAGC	GCTTCTGAA.TGTCATAGC
GCTTCTGAA.TTACTTACG	GCTTCTGAA.TTACTTACG
GCTTGGTTC.CCGCACTCA	GCTTGGTTC.CCGCACTCA
GCTTGGTTC.CGCCATTAC	GCTTGGTTC.CGCCATTAC
GCTTGGTTC.TCCTTCGTA	GCTTGGTTC.TCCTTCGTA
GCTTGGTTC.TTACACCTT	GCTTGGTTC.TTACACCTT
GCTTGTCCT.CATGTCCTG	GCTTGTCCT.CATGTCCTG
GCTTGTCCT.CTGACGGAT	GCTTGTCCT.CTGACGGAT
GGAACCTAG.AGCCAGGAC	GGAACCTAG.AGCCAGGAC
GGAACCTAG.AGTACTACA	GGAACCTAG.AGTACTACA
GGAACCTAG.TACAACACC	GGAACCTAG.TACAACACC
GGAACCTAG.TAGCGCAGC	GGAACCTAG.TAGCGCAGC
GGAACCTAG.TCAAGGTCG	GGAACCTAG.TCAAGGTCG
GGAACTGCT.ACGAATCGC	GGAACTGCT.ACGAATCGC
GGAACTGCT.TATTACTCG	GGAACTGCT.TATTACTCG
GGAAGAAGC.GCACCATCG	GGAAGAAGC.GCACCATCG
GGAAGAAGC.GGAAGAAGC	GGAAGAAGC.GGAAGAAGC
GGAAGGTAT.ACCGATCGA	GGAAGGTAT.ACCGATCGA
GGAAGGTAT.AGATGAGAT	GGAAGGTAT.AGATGAGAT
GGAAGGTAT.CCACGCCAT	GGAAGGTAT.CCACGCCAT
GGAAGGTAT.CTTAGGACT	GGAAGGTAT.CTTAGGACT
GGAAGGTAT.GTAGAGAGC	GGAAGGTAT.GTAGAGAGC
GGAAGTATG.CAGTCTAAC	GGAAGTATG.CAGTCTAAC
GGAAGTATG.CATTATGTC	GGAAGTATG.CATTATGTC
GGAAGTATG.GCACGTAGA	GGAAGTATG.GCACGTAGA
GGAATTCAC.ACTCTCACA	GGAATTCAC.ACTCTCACA
GGAATTCAC.ATGAGCAGG	GGAATTCAC.ATGAGCAGG
GGAATTCAC.CCATATCTT	GGAATTCAC.CCATATCTT
GGAATTCAC.GCGAGTCTA	GGAATTCAC.GCGAGTCTA
GGAATTCAC.GTAATCAGC	GGAATTCAC.GTAATCAGC
GGAATTGGA.ACGCAAGAT	GGAATTGGA.ACGCAAGAT
GGAATTGGA.ACGGTGTAC	GGAATTGGA.ACGGTGTAC
GGAATTGGA.CACCTAGCG	GGAATTGGA.CACCTAGCG
GGAATTGGA.CAGGAGCCT	GGAATTGGA.CAGGAGCCT
GGAATTGGA.CCTAGCAAT	GGAATTGGA.CCTAGCAAT
GGAATTGGA.CGCACTCTT	GGAATTGGA.CGCACTCTT
GGAATTGGA.CTCCGCATT	GGAATTGGA.CTCCGCATT
GGAATTGGA.GCCGCCTAA	GGAATTGGA.GCCGCCTAA
GGAATTGGA.TAGCTAAGA	GGAATTGGA.TAGCTAAGA
GGAATTGGA.TTCATCCAA	GGAATTGGA.TTCATCCAA
GGACACTGG.AACGCTCAA	GGACACTGG.AACGCTCAA
GGACACTGG.CACCTACGC	GGACACTGG.CACCTACGC
GGACACTGG.CGGTGTTAC	GGACACTGG.CGGTGTTAC
GGACACTGG.TCGCGTCAT	GGACACTGG.TCGCGTCAT
GGACAGATT.ATCAAGCAT	GGACAGATT.ATCAAGCAT
GGACAGATT.CGCACTCTT	GGACAGATT.CGCACTCTT
GGACAGATT.GAGACATTG	GGACAGATT.GAGACATTG
GGACAGATT.GCGAGTCTA	GGACAGATT.GCGAGTCTA
GGACAGATT.GTCTGACGT	GGACAGATT.GTCTGACGT
GGACAGATT.TACGGTCGT	GGACAGATT.TACGGTCGT
GGACAGATT.TCCTATTCC	GGACAGATT.TCCTATTCC
GGACAGATT.TGTAGATCG	GGACAGATT.TGTAGATCG
GGACAGATT.TGTCGTGAG	GGACAGATT.TGTCGTGAG
GGACAGATT.TTCTGGTGC	GGACAGATT.TTCTGGTGC
GGACGAGCA.CACACCACA	GGACGAGCA.CACACCACA
GGACGAGCA.CAGTGCTGC	GGACGAGCA.CAGTGCTGC
GGACGAGCA.CCGCATCCT	GGACGAGCA.CCGCATCCT
GGACGAGCA.TAGTCGCAT	GGACGAGCA.TAGTCGCAT
GGACTATTC.CATTCCGAG	GGACTATTC.CATTCCGAG
GGACTATTC.GACCTTGTG	GGACTATTC.GACCTTGTG
GGACTCCTT.CTCGTCTTG	GGACTCCTT.CTCGTCTTG
GGACTCCTT.GAGCCGTTA	GGACTCCTT.GAGCCGTTA
GGACTCCTT.TAGTCGCAT	GGACTCCTT.TAGTCGCAT
GGAGAATGA.ACCAGCGTT	GGAGAATGA.ACCAGCGTT
GGAGAATGA.AGACATATC	GGAGAATGA.AGACATATC
GGAGAATGA.AGTAATCAG	GGAGAATGA.AGTAATCAG
GGAGAATGA.CCAATATAC	GGAGAATGA.CCAATATAC
GGAGAATGA.CGACCATCA	GGAGAATGA.CGACCATCA
GGAGAATGA.CGCATAACT	GGAGAATGA.CGCATAACT
GGAGAATGA.GCTACAATG	GGAGAATGA.GCTACAATG
GGAGACACA.ACGTGAATC	GGAGACACA.ACGTGAATC
GGAGACACA.ATGCTTCAG	GGAGACACA.ATGCTTCAG
GGAGACACA.TGACCTATG	GGAGACACA.TGACCTATG
GGAGACACA.TGAGACAGC	GGAGACACA.TGAGACAGC
GGAGATGAG.GGATTCGTC	GGAGATGAG.GGATTCGTC
GGAGATGAG.GGTGTTCAT	GGAGATGAG.GGTGTTCAT
GGAGCATCT.GTCTCCAGG	GGAGCATCT.GTCTCCAGG
GGAGCTCAA.ATGTCCTCC	GGAGCTCAA.ATGTCCTCC
GGAGCTCAA.CGACCATCA	GGAGCTCAA.CGACCATCA
GGAGCTCAA.GGTAGCATC	GGAGCTCAA.GGTAGCATC
GGAGCTCAA.GTAGTTGGT	GGAGCTCAA.GTAGTTGGT
GGAGTACAG.AGACGCTAT	GGAGTACAG.AGACGCTAT
GGAGTACAG.CAAGCGCAT	GGAGTACAG.CAAGCGCAT
GGAGTACAG.CATTGTTCA	GGAGTACAG.CATTGTTCA
GGAGTACAG.CCTCTCTAG	GGAGTACAG.CCTCTCTAG
GGAGTACAG.CGTATTCCT	GGAGTACAG.CGTATTCCT
GGAGTTAGC.AGAGCGCGA	GGAGTTAGC.AGAGCGCGA
GGAGTTAGC.CCAATGCCT	GGAGTTAGC.CCAATGCCT
GGAGTTAGC.GCACTGGAT	GGAGTTAGC.GCACTGGAT
GGATAATAC.ACGCGACAG	GGATAATAC.ACGCGACAG
GGATAATAC.AGTCCGTGT	GGATAATAC.AGTCCGTGT
GGATAATAC.ATTGGTTCC	GGATAATAC.ATTGGTTCC
GGATAATAC.CAGAGCACC	GGATAATAC.CAGAGCACC
GGATAATAC.CGTACATCT	GGATAATAC.CGTACATCT
GGATAATAC.TAGATAGCC	GGATAATAC.TAGATAGCC
GGATAATAC.TCAGACAAG	GGATAATAC.TCAGACAAG
GGATACAAT.AATGCTATC	GGATACAAT.AATGCTATC
GGATACAAT.CAACGCACA	GGATACAAT.CAACGCACA
GGATACAAT.CACTCACTA	GGATACAAT.CACTCACTA
GGATACAAT.GACGTCAAT	GGATACAAT.GACGTCAAT
GGATACAAT.GGTGGAGCT	GGATACAAT.GGTGGAGCT
GGATACAAT.TCACGACAA	GGATACAAT.TCACGACAA
GGATACCTA.CCAGTACTC	GGATACCTA.CCAGTACTC
GGATACCTA.GATGCGACG	GGATACCTA.GATGCGACG
GGATACCTA.TACGACTTG	GGATACCTA.TACGACTTG
GGATACCTA.TCCAACGTG	GGATACCTA.TCCAACGTG
GGATAGTCA.ACAACCGGA	GGATAGTCA.ACAACCGGA
GGATAGTCA.CACGGATAG	GGATAGTCA.CACGGATAG
GGATAGTCA.CATCCGACA	GGATAGTCA.CATCCGACA
GGATAGTCA.CTCCGCATT	GGATAGTCA.CTCCGCATT
GGATAGTCA.TCAGAGTCA	GGATAGTCA.TCAGAGTCA
GGATCAATG.AGTGGAATG	GGATCAATG.AGTGGAATG
GGATCAATG.CTGTTACCA	GGATCAATG.CTGTTACCA
GGATCAATG.GAACTCGTA	GGATCAATG.GAACTCGTA
GGATCAATG.GCGTGATAC	GGATCAATG.GCGTGATAC
GGATCAATG.TGGATTAGC	GGATCAATG.TGGATTAGC
GGATCAATG.TTCTCCACA	GGATCAATG.TTCTCCACA
GGATCAGGT.CACAATAAC	GGATCAGGT.CACAATAAC
GGATCAGGT.CCTAAGAAG	GGATCAGGT.CCTAAGAAG
GGATCAGGT.GACACCGAT	GGATCAGGT.GACACCGAT
GGATCAGGT.TGAAGACCA	GGATCAGGT.TGAAGACCA
GGATCAGGT.TGCATACAT	GGATCAGGT.TGCATACAT
GGATCGTTC.CTATACTAG	GGATCGTTC.CTATACTAG
GGATCGTTC.GGATTCGTC	GGATCGTTC.GGATTCGTC
GGATCGTTC.TACCGATTG	GGATCGTTC.TACCGATTG
GGATCGTTC.TGCTTACGG	GGATCGTTC.TGCTTACGG
GGATGCGAA.ATAGTCTCC	GGATGCGAA.ATAGTCTCC
GGATGCGAA.CACAACCAG	GGATGCGAA.CACAACCAG
GGATGCGAA.CGGACAAGT	GGATGCGAA.CGGACAAGT
GGATGCGAA.GAGATACAC	GGATGCGAA.GAGATACAC
GGATGCGAA.TATCACCTG	GGATGCGAA.TATCACCTG
GGATGCTCG.CTGTGGTGG	GGATGCTCG.CTGTGGTGG
GGATGCTCG.GTAGAAGTT	GGATGCTCG.GTAGAAGTT
GGATTACGC.AAGAGAGAG	GGATTACGC.AAGAGAGAG
GGATTACGC.CCATAAGTA	GGATTACGC.CCATAAGTA
GGATTACGC.CTGCTGCTT	GGATTACGC.CTGCTGCTT
GGATTACGC.GACACGCAA	GGATTACGC.GACACGCAA
GGATTACGC.GTCAGTTGT	GGATTACGC.GTCAGTTGT
GGATTACGC.TGATTATCG	GGATTACGC.TGATTATCG
GGATTCGTC.ACCATACTT	GGATTCGTC.ACCATACTT
GGATTCGTC.ACTCCAACT	GGATTCGTC.ACTCCAACT
GGATTCGTC.AGTGATGCG	GGATTCGTC.AGTGATGCG
GGATTCGTC.ATTCACCTC	GGATTCGTC.ATTCACCTC
GGATTCGTC.CCACTACCA	GGATTCGTC.CCACTACCA
GGATTCGTC.CTCTCAGTC	GGATTCGTC.CTCTCAGTC
GGATTCGTC.GTTAGTCAA	GGATTCGTC.GTTAGTCAA
GGATTCGTC.TAACACATC	GGATTCGTC.TAACACATC
GGATTCGTC.TAGCACTAT	GGATTCGTC.TAGCACTAT
GGATTCGTC.TCGTGACGT	GGATTCGTC.TCGTGACGT
GGATTCGTC.TTACTAGTC	GGATTCGTC.TTACTAGTC
GGTAACTAC.CCATGATGT	GGTAACTAC.CCATGATGT
GGTAACTAC.TTGGACTTC	GGTAACTAC.TTGGACTTC
GGTAAGGAT.AGTCGCCGA	GGTAAGGAT.AGTCGCCGA
GGTAAGGAT.ATTGACACG	GGTAAGGAT.ATTGACACG
GGTAAGTGA.CATCCTCTC	GGTAAGTGA.CATCCTCTC
GGTAAGTGA.CCATCACGA	GGTAAGTGA.CCATCACGA
GGTAAGTGA.CTTCGTGCA	GGTAAGTGA.CTTCGTGCA
GGTAAGTGA.GACTTCACC	GGTAAGTGA.GACTTCACC
GGTAATCTA.CGTTAATGG	GGTAATCTA.CGTTAATGG
GGTAATCTA.GCGAACTCG	GGTAATCTA.GCGAACTCG
GGTAATCTA.TTGCGAACA	GGTAATCTA.TTGCGAACA
GGTACGAGC.AGGATCTCA	GGTACGAGC.AGGATCTCA
GGTACGAGC.ATATAGCGT	GGTACGAGC.ATATAGCGT
GGTACGAGC.CCAACGGAA	GGTACGAGC.CCAACGGAA
GGTACGAGC.GTGTCTGGA	GGTACGAGC.GTGTCTGGA
GGTACGAGC.GTTCACTCC	GGTACGAGC.GTTCACTCC
GGTACGAGC.TACTAGTAG	GGTACGAGC.TACTAGTAG
GGTACGAGC.TCACTACGT	GGTACGAGC.TCACTACGT
GGTACGAGC.TCGTCATTC	GGTACGAGC.TCGTCATTC
GGTACGAGC.TCTTAAGTG	GGTACGAGC.TCTTAAGTG
GGTACGAGC.TGATCGGAA	GGTACGAGC.TGATCGGAA
GGTACTTCC.AACGCCTAC	GGTACTTCC.AACGCCTAC
GGTACTTCC.TATAGTGCG	GGTACTTCC.TATAGTGCG
GGTAGACAT.AGCATTGTT	GGTAGACAT.AGCATTGTT
GGTAGACAT.CCAATATAC	GGTAGACAT.CCAATATAC
GGTAGACAT.CCGAATATG	GGTAGACAT.CCGAATATG
GGTAGACAT.TAACCGTGA	GGTAGACAT.TAACCGTGA
GGTAGACAT.TAGTCGCAT	GGTAGACAT.TAGTCGCAT
GGTAGACAT.TGATAGAGG	GGTAGACAT.TGATAGAGG
GGTAGACAT.TGGATTAGC	GGTAGACAT.TGGATTAGC
GGTAGCATC.AATCTCCTA	GGTAGCATC.AATCTCCTA
GGTAGCATC.CGGTGAGTC	GGTAGCATC.CGGTGAGTC
GGTAGTGTT.AGGTCAGCA	GGTAGTGTT.AGGTCAGCA
GGTCCTAAG.AACAATGCA	GGTCCTAAG.AACAATGCA
GGTCCTAAG.ATAGCTTGC	GGTCCTAAG.ATAGCTTGC
GGTCCTAAG.CCGGATTGC	GGTCCTAAG.CCGGATTGC
GGTCCTAAG.TAGTTGACG	GGTCCTAAG.TAGTTGACG
GGTCCTAAG.TCTCAGGAT	GGTCCTAAG.TCTCAGGAT
GGTCCTAAG.TGAGTGACT	GGTCCTAAG.TGAGTGACT
GGTCCTAAG.TGTGGTCCT	GGTCCTAAG.TGTGGTCCT
GGTCCTGGT.ACGATGACC	GGTCCTGGT.ACGATGACC
GGTCCTGGT.ATATAGCGT	GGTCCTGGT.ATATAGCGT
GGTCCTGGT.CGACCATCA	GGTCCTGGT.CGACCATCA
GGTCCTGGT.GTGTCGAGC	GGTCCTGGT.GTGTCGAGC
GGTCCTGGT.TGGAACTAA	GGTCCTGGT.TGGAACTAA
GGTCGGATA.AACGGTAGC	GGTCGGATA.AACGGTAGC
GGTCGGATA.ACTCGTAGG	GGTCGGATA.ACTCGTAGG
GGTCGGATA.AGATGTTGG	GGTCGGATA.AGATGTTGG
GGTCGGATA.AGGTATTCC	GGTCGGATA.AGGTATTCC
GGTCGGATA.ATGGAGAGT	GGTCGGATA.ATGGAGAGT
GGTCGGATA.ATTATGCAG	GGTCGGATA.ATTATGCAG
GGTCGGATA.CCGGTTGAG	GGTCGGATA.CCGGTTGAG
GGTCGGATA.TATCCTCAG	GGTCGGATA.TATCCTCAG
GGTCGGATA.TTGCTCTGC	GGTCGGATA.TTGCTCTGC
GGTCGGTCT.ACACACCGT	GGTCGGTCT.ACACACCGT
GGTCTCATG.AATACCTTG	GGTCTCATG.AATACCTTG
GGTCTCATG.TCGCCAAGC	GGTCTCATG.TCGCCAAGC
GGTCTCATG.TGTCATAGC	GGTCTCATG.TGTCATAGC
GGTCTTGCA.ATCCACAGT	GGTCTTGCA.ATCCACAGT
GGTCTTGCA.GACACGCAA	GGTCTTGCA.GACACGCAA
GGTCTTGCA.TCGAATAGA	GGTCTTGCA.TCGAATAGA
GGTGAGCGT.AATACTCCG	GGTGAGCGT.AATACTCCG
GGTGAGCGT.GCTAGTGGA	GGTGAGCGT.GCTAGTGGA
GGTGAGCGT.TCGCTTAAC	GGTGAGCGT.TCGCTTAAC
GGTGAGCGT.TTCCAATTC	GGTGAGCGT.TTCCAATTC
GGTGAGTTC.CATTGTTCA	GGTGAGTTC.CATTGTTCA
GGTGAGTTC.CCACGAAGG	GGTGAGTTC.CCACGAAGG
GGTGAGTTC.TCACATACT	GGTGAGTTC.TCACATACT
GGTGATAGG.AAGCTGGTC	GGTGATAGG.AAGCTGGTC
GGTGATAGG.ACTCTGCTC	GGTGATAGG.ACTCTGCTC
GGTGATAGG.AGAGCGCGA	GGTGATAGG.AGAGCGCGA
GGTGATAGG.ATGCAGTTC	GGTGATAGG.ATGCAGTTC
GGTGATAGG.CAAGCTGCA	GGTGATAGG.CAAGCTGCA
GGTGATAGG.CTCAGTGAT	GGTGATAGG.CTCAGTGAT
GGTGATAGG.GTGGATAAG	GGTGATAGG.GTGGATAAG
GGTGATAGG.TCATCATCT	GGTGATAGG.TCATCATCT
GGTGCGTAG.AACGATGAC	GGTGCGTAG.AACGATGAC
GGTGCGTAG.CCTCGAGAG	GGTGCGTAG.CCTCGAGAG
GGTGCGTAG.CTTGATCTA	GGTGCGTAG.CTTGATCTA
GGTGCGTAG.TCAATGGAC	GGTGCGTAG.TCAATGGAC
GGTGGAGCT.AATACCTTG	GGTGGAGCT.AATACCTTG
GGTGGAGCT.ACACACCGT	GGTGGAGCT.ACACACCGT
GGTGGAGCT.ACCACGCTA	GGTGGAGCT.ACCACGCTA
