AGCTGCACT.ACCATCTAA	AGCTGCACT.ACCATCTAA
AGCTGCACT.GAACGCTGT	AGCTGCACT.GAACGCTGT
AGCTTCGAT.CGTGACCAG	AGCTTCGAT.CGTGACCAG
AGCTTCGAT.GAACAACCA	AGCTTCGAT.GAACAACCA
AGCTTCGAT.GAGACGATC	AGCTTCGAT.GAGACGATC
AGCTTCGAT.GTCTTATGC	AGCTTCGAT.GTCTTATGC
AGCTTCGAT.GTGTCTGGA	AGCTTCGAT.GTGTCTGGA
AGCTTCGAT.TCCTTCGTA	AGCTTCGAT.TCCTTCGTA
AGCTTCGAT.TGGACGAGA	AGCTTCGAT.TGGACGAGA
AGCTTGGTG.ATAAGTTCG	AGCTTGGTG.ATAAGTTCG
AGGAAGGTG.ACCTTGAAG	AGGAAGGTG.ACCTTGAAG
AGGAAGGTG.CGTGTATTC	AGGAAGGTG.CGTGTATTC
AGGAAGGTG.CTCCAGCGT	AGGAAGGTG.CTCCAGCGT
AGGAATTGG.GATGCAGAA	AGGAATTGG.GATGCAGAA
AGGAATTGG.GATGTAAGG	AGGAATTGG.GATGTAAGG
AGGAATTGG.GTAACGCGA	AGGAATTGG.GTAACGCGA
AGGAGCAAT.AACGAGGTG	AGGAGCAAT.AACGAGGTG
AGGAGCAAT.AAGAGAACT	AGGAGCAAT.AAGAGAACT
AGGAGCAAT.GCCTTCCAT	AGGAGCAAT.GCCTTCCAT
AGGAGCAAT.GCTACCGAG	AGGAGCAAT.GCTACCGAG
AGGAGCAAT.TGAACCAAT	AGGAGCAAT.TGAACCAAT
AGGAGGTGA.ACTCTCACA	AGGAGGTGA.ACTCTCACA
AGGAGGTGA.CGTTCGTAC	AGGAGGTGA.CGTTCGTAC
AGGAGGTGA.GGAAGGTAT	AGGAGGTGA.GGAAGGTAT
AGGAGGTGA.TCTTGGTAG	AGGAGGTGA.TCTTGGTAG
AGGATCATG.GTGTTCCAG	AGGATCATG.GTGTTCCAG
AGGATCATG.TCTATGACA	AGGATCATG.TCTATGACA
AGGATCTCA.ACTCGTAGG	AGGATCTCA.ACTCGTAGG
AGGATCTCA.ACTTCTTGG	AGGATCTCA.ACTTCTTGG
AGGATCTCA.AGATCTGAC	AGGATCTCA.AGATCTGAC
AGGATCTCA.AGCCTCTAG	AGGATCTCA.AGCCTCTAG
AGGATCTCA.TAGGTTAGT	AGGATCTCA.TAGGTTAGT
AGGATGCGT.AGTTCGATA	AGGATGCGT.AGTTCGATA
AGGATGCGT.ATGCGGATT	AGGATGCGT.ATGCGGATT
AGGATGCGT.CTACGTTGG	AGGATGCGT.CTACGTTGG
AGGATGCGT.CTCGACTGC	AGGATGCGT.CTCGACTGC
AGGATGCGT.GTTCCAACA	AGGATGCGT.GTTCCAACA
AGGATGCGT.GTTGACGTG	AGGATGCGT.GTTGACGTG
AGGATTACT.AATATCAGC	AGGATTACT.AATATCAGC
AGGATTACT.CATTCAGTT	AGGATTACT.CATTCAGTT
AGGATTACT.TGTCATAGC	AGGATTACT.TGTCATAGC
AGGATTACT.TTAGATCGG	AGGATTACT.TTAGATCGG
AGGATTACT.TTCCGAGCG	AGGATTACT.TTCCGAGCG
AGGATTGAG.CAAGCTGCA	AGGATTGAG.CAAGCTGCA
AGGATTGAG.CGCAGTGTC	AGGATTGAG.CGCAGTGTC
AGGATTGAG.GGTGTGACC	AGGATTGAG.GGTGTGACC
AGGATTGAG.TCGCTGTAA	AGGATTGAG.TCGCTGTAA
AGGATTGAG.TTACTTACG	AGGATTGAG.TTACTTACG
AGGATTGAG.TTCCAATTC	AGGATTGAG.TTCCAATTC
AGGTACCAA.CGCCATTAC	AGGTACCAA.CGCCATTAC
AGGTATTCC.AGACATCCA	AGGTATTCC.AGACATCCA
AGGTCACGT.ACTACCATC	AGGTCACGT.ACTACCATC
AGGTCACGT.ACTGGACCA	AGGTCACGT.ACTGGACCA
AGGTCACGT.AGTGAACGG	AGGTCACGT.AGTGAACGG
AGGTCACGT.CAGCACGTG	AGGTCACGT.CAGCACGTG
AGGTCACGT.CCGCTATCC	AGGTCACGT.CCGCTATCC
AGGTCACGT.GTCAGTTGT	AGGTCACGT.GTCAGTTGT
AGGTCAGCA.ACTATCCTG	AGGTCAGCA.ACTATCCTG
AGGTCAGCA.ATCAAGCAT	AGGTCAGCA.ATCAAGCAT
AGGTCCGTC.AACAATGCA	AGGTCCGTC.AACAATGCA
AGGTCCGTC.AATAGACGC	AGGTCCGTC.AATAGACGC
AGGTCCGTC.AATCTGACC	AGGTCCGTC.AATCTGACC
AGGTCCGTC.AATTCGGAA	AGGTCCGTC.AATTCGGAA
AGGTCCGTC.CCTAGTCTC	AGGTCCGTC.CCTAGTCTC
AGGTCCGTC.CTCGTGTCC	AGGTCCGTC.CTCGTGTCC
AGGTCCGTC.CTGAGTCCA	AGGTCCGTC.CTGAGTCCA
AGGTCCGTC.GAGATACAC	AGGTCCGTC.GAGATACAC
AGGTCCGTC.GTAGAGAGC	AGGTCCGTC.GTAGAGAGC
AGGTCCGTC.TCCAAGTAA	AGGTCCGTC.TCCAAGTAA
AGGTCCGTC.TTCTGAATG	AGGTCCGTC.TTCTGAATG
AGGTGTACA.AGTAAGCCA	AGGTGTACA.AGTAAGCCA
AGGTGTACA.CACACCACA	AGGTGTACA.CACACCACA
AGGTGTACA.CCTAGTTAG	AGGTGTACA.CCTAGTTAG
AGGTGTACA.TGCACGATG	AGGTGTACA.TGCACGATG
AGGTGTACA.TTGCCAGAT	AGGTGTACA.TTGCCAGAT
AGTAACGTA.ACTCGCTGT	AGTAACGTA.ACTCGCTGT
AGTAACGTA.ATTCGAAGA	AGTAACGTA.ATTCGAAGA
AGTAACGTA.CATATGTCG	AGTAACGTA.CATATGTCG
AGTAACGTA.TCCAAGTAA	AGTAACGTA.TCCAAGTAA
AGTAAGCCA.CAGTATGAT	AGTAAGCCA.CAGTATGAT
AGTAAGCCA.CTGACGGAT	AGTAAGCCA.CTGACGGAT
AGTAAGCCA.TCTAGTGAC	AGTAAGCCA.TCTAGTGAC
AGTAATCAG.AGGTGCGAG	AGTAATCAG.AGGTGCGAG
AGTAATCAG.ATAATCGAG	AGTAATCAG.ATAATCGAG
AGTAATCAG.GATATGGAC	AGTAATCAG.GATATGGAC
AGTAATGGT.ACTTAGCTT	AGTAATGGT.ACTTAGCTT
AGTAATGGT.CGCTGTAGT	AGTAATGGT.CGCTGTAGT
AGTACGAAT.AATGCTGAT	AGTACGAAT.AATGCTGAT
AGTACGAAT.GGATCAGGT	AGTACGAAT.GGATCAGGT
AGTACGAAT.TAATGTAGC	AGTACGAAT.TAATGTAGC
AGTACGAAT.TGTATCGTG	AGTACGAAT.TGTATCGTG
AGTACTACA.ATGCGCCGT	AGTACTACA.ATGCGCCGT
AGTACTACA.CACTAGACT	AGTACTACA.CACTAGACT
AGTACTACA.TCCAAGTAA	AGTACTACA.TCCAAGTAA
AGTACTCTC.AGTATGACG	AGTACTCTC.AGTATGACG
AGTACTCTC.CTGACGGAT	AGTACTCTC.CTGACGGAT
AGTACTCTC.TGAGTTAAG	AGTACTCTC.TGAGTTAAG
AGTAGAGGA.AACAACCTA	AGTAGAGGA.AACAACCTA
AGTAGAGGA.AATGCGTGC	AGTAGAGGA.AATGCGTGC
AGTAGAGGA.ACCGTACGC	AGTAGAGGA.ACCGTACGC
AGTAGAGGA.CAAGTCACT	AGTAGAGGA.CAAGTCACT
AGTAGAGGA.GCTTCTGAA	AGTAGAGGA.GCTTCTGAA
AGTAGAGGA.GCTTGTCCT	AGTAGAGGA.GCTTGTCCT
AGTATGACG.AGGAATTGG	AGTATGACG.AGGAATTGG
AGTATGACG.GCACAACTC	AGTATGACG.GCACAACTC
AGTATGACG.GTTCAGAAG	AGTATGACG.GTTCAGAAG
AGTATGACG.TCGTAATAG	AGTATGACG.TCGTAATAG
AGTATGACG.TGAACTTGC	AGTATGACG.TGAACTTGC
AGTATGACG.TTACGCTCG	AGTATGACG.TTACGCTCG
AGTATGACG.TTACTAGTC	AGTATGACG.TTACTAGTC
AGTCAGTTG.ACTCACGAA	AGTCAGTTG.ACTCACGAA
AGTCAGTTG.AGACGCTAT	AGTCAGTTG.AGACGCTAT
AGTCATACT.CACTTCCTT	AGTCATACT.CACTTCCTT
AGTCCAGTG.AGCATTCCA	AGTCCAGTG.AGCATTCCA
AGTCCAGTG.GAGTCCAAT	AGTCCAGTG.GAGTCCAAT
AGTCCAGTG.TGGTCGCTA	AGTCCAGTG.TGGTCGCTA
AGTCCGTGT.AGAGGTGAA	AGTCCGTGT.AGAGGTGAA
AGTCCGTGT.CTCGACTGC	AGTCCGTGT.CTCGACTGC
AGTCCGTGT.TAGACCATG	AGTCCGTGT.TAGACCATG
AGTCGATCA.AGTGTTCTG	AGTCGATCA.AGTGTTCTG
AGTCGATCA.CACTTGGAT	AGTCGATCA.CACTTGGAT
AGTCGATCA.CAGTACATC	AGTCGATCA.CAGTACATC
AGTCGATCA.GTTCACTCC	AGTCGATCA.GTTCACTCC
AGTCGATCA.TCAATGGAC	AGTCGATCA.TCAATGGAC
AGTCGATCA.TGCAACTCT	AGTCGATCA.TGCAACTCT
AGTCGATCA.TGTGTCTAC	AGTCGATCA.TGTGTCTAC
AGTCGCCGA.ACTCTGCTC	AGTCGCCGA.ACTCTGCTC
AGTCGCCGA.AGTTCGATA	AGTCGCCGA.AGTTCGATA
AGTCGCCGA.GCACCATCG	AGTCGCCGA.GCACCATCG
AGTCGCCGA.GTAAGGTCC	AGTCGCCGA.GTAAGGTCC
AGTCGCCGA.TTAGCGTCT	AGTCGCCGA.TTAGCGTCT
AGTCGCGAC.ACGACGATT	AGTCGCGAC.ACGACGATT
AGTCGCGAC.AGCAAGTCC	AGTCGCGAC.AGCAAGTCC
AGTCGCGAC.CATTATGTC	AGTCGCGAC.CATTATGTC
AGTCGCGAC.CGCTTGTAG	AGTCGCGAC.CGCTTGTAG
AGTCGCGAC.GTTCAGAAG	AGTCGCGAC.GTTCAGAAG
AGTCGCGAC.TCAAGCGTA	AGTCGCGAC.TCAAGCGTA
AGTCGTCCG.AATATCGCT	AGTCGTCCG.AATATCGCT
AGTCGTCCG.ACCGGAGTA	AGTCGTCCG.ACCGGAGTA
AGTCGTCCG.ATGTCCTCC	AGTCGTCCG.ATGTCCTCC
AGTCGTCCG.GACACGCAA	AGTCGTCCG.GACACGCAA
AGTCGTCCG.TTCCTCGGT	AGTCGTCCG.TTCCTCGGT
AGTCTAAGC.GTAGCCTTG	AGTCTAAGC.GTAGCCTTG
AGTCTAAGC.TCCAGAACG	AGTCTAAGC.TCCAGAACG
AGTCTGGAA.AGACTAGTA	AGTCTGGAA.AGACTAGTA
AGTCTGGAA.GGTAAGTGA	AGTCTGGAA.GGTAAGTGA
AGTCTGGAA.TCAGCGACC	AGTCTGGAA.TCAGCGACC
AGTGAACGG.CGTTCCATT	AGTGAACGG.CGTTCCATT
AGTGAACGG.GAGGTCCTT	AGTGAACGG.GAGGTCCTT
AGTGAACGG.GCAACTCGC	AGTGAACGG.GCAACTCGC
AGTGACGAT.AATCTGACC	AGTGACGAT.AATCTGACC
AGTGACGAT.ATAGTCAGT	AGTGACGAT.ATAGTCAGT
AGTGACGAT.GGTGAGTTC	AGTGACGAT.GGTGAGTTC
AGTGACGAT.TCTACAGTT	AGTGACGAT.TCTACAGTT
AGTGAGAGA.CGCAGTGTC	AGTGAGAGA.CGCAGTGTC
AGTGAGAGA.CTTCGTGCA	AGTGAGAGA.CTTCGTGCA
AGTGAGAGA.TATTGACTG	AGTGAGAGA.TATTGACTG
AGTGGAATG.CACATGTGC	AGTGGAATG.CACATGTGC
AGTGGAATG.TCCTCTAGT	AGTGGAATG.TCCTCTAGT
AGTGGAATG.TCGTACCTT	AGTGGAATG.TCGTACCTT
AGTGTCTCT.ATTAAGACC	AGTGTCTCT.ATTAAGACC
AGTGTCTCT.CAGTAATGT	AGTGTCTCT.CAGTAATGT
AGTGTCTCT.TCCTTAGGT	AGTGTCTCT.TCCTTAGGT
AGTGTGCAC.AACGAGGTG	AGTGTGCAC.AACGAGGTG
AGTGTGCAC.AAGGTGCTG	AGTGTGCAC.AAGGTGCTG
AGTGTGCAC.ATGCAGTTC	AGTGTGCAC.ATGCAGTTC
AGTGTGCAC.ATGGAGAGT	AGTGTGCAC.ATGGAGAGT
AGTGTGCAC.GCATTGATC	AGTGTGCAC.GCATTGATC
AGTGTGCAC.GGTAGTGTT	AGTGTGCAC.GGTAGTGTT
AGTGTGCAC.TATGAAGAC	AGTGTGCAC.TATGAAGAC
AGTGTGCAC.TCGGACAGT	AGTGTGCAC.TCGGACAGT
AGTGTGCAC.TTCGCTGAG	AGTGTGCAC.TTCGCTGAG
AGTGTTCTG.ACTCTAGGA	AGTGTTCTG.ACTCTAGGA
AGTGTTCTG.AGCGGAACA	AGTGTTCTG.AGCGGAACA
AGTGTTCTG.TATGCCTTC	AGTGTTCTG.TATGCCTTC
AGTTACAAG.AGTCGTCCG	AGTTACAAG.AGTCGTCCG
AGTTACAAG.ATATCAGCC	AGTTACAAG.ATATCAGCC
AGTTACAAG.CTATTAAGG	AGTTACAAG.CTATTAAGG
AGTTACAAG.TACTTCCAG	AGTTACAAG.TACTTCCAG
AGTTACAAG.TGTTACTGA	AGTTACAAG.TGTTACTGA
AGTTAGGTC.AACTGCGAC	AGTTAGGTC.AACTGCGAC
AGTTAGGTC.AAGCACAAC	AGTTAGGTC.AAGCACAAC
AGTTAGGTC.ACGGTGCCT	AGTTAGGTC.ACGGTGCCT
AGTTAGGTC.AGAAGTCCT	AGTTAGGTC.AGAAGTCCT
AGTTAGGTC.CACGACTCA	AGTTAGGTC.CACGACTCA
AGTTAGGTC.GTTATCGAT	AGTTAGGTC.GTTATCGAT
AGTTATCGC.AGCGGAACA	AGTTATCGC.AGCGGAACA
AGTTATCGC.GTGTCCGTG	AGTTATCGC.GTGTCCGTG
AGTTATCGC.TCCAGCTAT	AGTTATCGC.TCCAGCTAT
AGTTCAACC.AGGAGCAAT	AGTTCAACC.AGGAGCAAT
AGTTCAACC.ATGAGCAGG	AGTTCAACC.ATGAGCAGG
AGTTCAACC.TGGATAGGT	AGTTCAACC.TGGATAGGT
AGTTCGATA.ATGAACTAG	AGTTCGATA.ATGAACTAG
AGTTCGATA.GCCTGGAAT	AGTTCGATA.GCCTGGAAT
AGTTCGATA.GGATCAATG	AGTTCGATA.GGATCAATG
AGTTCGATA.TCAACACTC	AGTTCGATA.TCAACACTC
AGTTGAGCG.CCACATTAG	AGTTGAGCG.CCACATTAG
AGTTGCCTT.ATAAGTTCG	AGTTGCCTT.ATAAGTTCG
AGTTGCCTT.TAGACCATG	AGTTGCCTT.TAGACCATG
AGTTGTGTA.ACAAGAATG	AGTTGTGTA.ACAAGAATG
AGTTGTGTA.ACCGCTGTG	AGTTGTGTA.ACCGCTGTG
AGTTGTGTA.ACCTCCTAG	AGTTGTGTA.ACCTCCTAG
AGTTGTGTA.CTTGCACAA	AGTTGTGTA.CTTGCACAA
ATAACGACA.AACGCCTAC	ATAACGACA.AACGCCTAC
ATAACGACA.AAGCAATCG	ATAACGACA.AAGCAATCG
ATAACGACA.ATGCTCACC	ATAACGACA.ATGCTCACC
ATAACGACA.ATGTGACGA	ATAACGACA.ATGTGACGA
ATAACGACA.CTCAGGTAC	ATAACGACA.CTCAGGTAC
ATAACGACA.GCCAATGAA	ATAACGACA.GCCAATGAA
ATAACGACA.GTAGACTCT	ATAACGACA.GTAGACTCT
ATAACGACA.TTGTCAACC	ATAACGACA.TTGTCAACC
ATAAGACAG.CTACGAGAA	ATAAGACAG.CTACGAGAA
ATAAGACAG.CTGGTACAT	ATAAGACAG.CTGGTACAT
ATAAGACAG.GGAAGAAGC	ATAAGACAG.GGAAGAAGC
ATAAGACAG.TCAGTAAGC	ATAAGACAG.TCAGTAAGC
ATAAGACAG.TTAACGTTC	ATAAGACAG.TTAACGTTC
ATAAGACAG.TTACCTCTC	ATAAGACAG.TTACCTCTC
ATAAGTTCG.CTCGTCTTG	ATAAGTTCG.CTCGTCTTG
ATAAGTTCG.CTGGTACAT	ATAAGTTCG.CTGGTACAT
ATAAGTTCG.GCAATGAGA	ATAAGTTCG.GCAATGAGA
ATAAGTTCG.TATCGGAAC	ATAAGTTCG.TATCGGAAC
ATAATCGAG.ACAGCATCA	ATAATCGAG.ACAGCATCA
ATAATCGAG.CTACGGTAT	ATAATCGAG.CTACGGTAT
ATAATCGAG.TGTAGCAAG	ATAATCGAG.TGTAGCAAG
ATACAACCG.AACACACTC	ATACAACCG.AACACACTC
ATACAACCG.AGCATATGG	ATACAACCG.AGCATATGG
ATACAACCG.AGCCACTTC	ATACAACCG.AGCCACTTC
ATACAACCG.AGTGATGCG	ATACAACCG.AGTGATGCG
ATACAACCG.GCGAACTCG	ATACAACCG.GCGAACTCG
ATACAACCG.TACGTTACC	ATACAACCG.TACGTTACC
ATACCGAAG.CCACATTAG	ATACCGAAG.CCACATTAG
ATACCGAAG.CCGCATCCT	ATACCGAAG.CCGCATCCT
ATACCGAAG.GCTTCTACG	ATACCGAAG.GCTTCTACG
ATACCGAAG.TGCTCACAC	ATACCGAAG.TGCTCACAC
ATACCGCTT.ATCATTACG	ATACCGCTT.ATCATTACG
ATACCGCTT.ATTGCGCTA	ATACCGCTT.ATTGCGCTA
ATACCGCTT.CCGAATATG	ATACCGCTT.CCGAATATG
ATACCGCTT.TGGTGGTAA	ATACCGCTT.TGGTGGTAA
ATACGAGGT.ATTATGCAG	ATACGAGGT.ATTATGCAG
ATACGAGGT.CATAAGATC	ATACGAGGT.CATAAGATC
ATACGAGGT.CTTGCGACC	ATACGAGGT.CTTGCGACC
ATACGAGGT.GTGTCACAC	ATACGAGGT.GTGTCACAC
ATACGAGGT.TCGTTCTCC	ATACGAGGT.TCGTTCTCC
ATACTTGCT.CACACTGCC	ATACTTGCT.CACACTGCC
ATACTTGCT.CGGTTCTAT	ATACTTGCT.CGGTTCTAT
ATACTTGCT.CGGTTGCGA	ATACTTGCT.CGGTTGCGA
ATACTTGCT.TATACGTGG	ATACTTGCT.TATACGTGG
ATAGACCGA.CAAGTCGAA	ATAGACCGA.CAAGTCGAA
ATAGACCGA.CACTCACTA	ATAGACCGA.CACTCACTA
ATAGACCGA.GGTCGGTCT	ATAGACCGA.GGTCGGTCT
ATAGACCGA.TCAAGCGTA	ATAGACCGA.TCAAGCGTA
ATAGAGCAG.ACGCAAGAT	ATAGAGCAG.ACGCAAGAT
ATAGAGCAG.ATGGACGTT	ATAGAGCAG.ATGGACGTT
ATAGAGCAG.ATTGGTTCC	ATAGAGCAG.ATTGGTTCC
ATAGAGCAG.GGTTAGATG	ATAGAGCAG.GGTTAGATG
ATAGAGCAG.TAAGTACAC	ATAGAGCAG.TAAGTACAC
ATAGCACGG.ATATAGCGT	ATAGCACGG.ATATAGCGT
ATAGCACGG.CCGCATCCT	ATAGCACGG.CCGCATCCT
ATAGCACGG.GCGCTCTAT	ATAGCACGG.GCGCTCTAT
ATAGCACGG.TTGCAGTCA	ATAGCACGG.TTGCAGTCA
ATAGCCTAA.ACTACTCAT	ATAGCCTAA.ACTACTCAT
ATAGCCTAA.ACTCGAGTC	ATAGCCTAA.ACTCGAGTC
ATAGCCTAA.AGCCACTTC	ATAGCCTAA.AGCCACTTC
ATAGCCTAA.ATCAAGAGA	ATAGCCTAA.ATCAAGAGA
ATAGCCTAA.CTACGAGAA	ATAGCCTAA.CTACGAGAA
ATAGCCTAA.TGAGACAGC	ATAGCCTAA.TGAGACAGC
ATAGCTTGC.CTCGACTGC	ATAGCTTGC.CTCGACTGC
ATAGCTTGC.GTCAGTTGT	ATAGCTTGC.GTCAGTTGT
ATAGTCAGT.ACACGTTGC	ATAGTCAGT.ACACGTTGC
ATAGTCAGT.CCTTAACAT	ATAGTCAGT.CCTTAACAT
ATAGTCAGT.CGCATCTAC	ATAGTCAGT.CGCATCTAC
ATAGTCAGT.TGCGATACT	ATAGTCAGT.TGCGATACT
ATAGTCTCC.ACCATGTCT	ATAGTCTCC.ACCATGTCT
ATAGTCTCC.CACAGCGAA	ATAGTCTCC.CACAGCGAA
ATAGTCTCC.TACAACACC	ATAGTCTCC.TACAACACC
ATAGTGGTT.AGGTACCAA	ATAGTGGTT.AGGTACCAA
ATAGTGGTT.CCGCAGAAT	ATAGTGGTT.CCGCAGAAT
ATAGTGGTT.CCTTGCTTG	ATAGTGGTT.CCTTGCTTG
ATAGTGGTT.TGCTCCTCC	ATAGTGGTT.TGCTCCTCC
ATATAGCGT.ACCTCCTAG	ATATAGCGT.ACCTCCTAG
ATATAGCGT.CCTAAGTCT	ATATAGCGT.CCTAAGTCT
ATATAGCGT.TCAACACTC	ATATAGCGT.TCAACACTC
ATATCAGCC.AGACATATC	ATATCAGCC.AGACATATC
ATATCCGAT.AATACCTTG	ATATCCGAT.AATACCTTG
ATATCCGAT.ATCGCCTCT	ATATCCGAT.ATCGCCTCT
ATATCCGAT.CATTGTTCA	ATATCCGAT.CATTGTTCA
ATATCCGAT.GTATTACTG	ATATCCGAT.GTATTACTG
ATATCCGAT.TTCTGCCGA	ATATCCGAT.TTCTGCCGA
ATATGCAGC.ACACTAACG	ATATGCAGC.ACACTAACG
ATATGCAGC.CAACACTCC	ATATGCAGC.CAACACTCC
ATATGCAGC.CAACCGGTC	ATATGCAGC.CAACCGGTC
ATATGCAGC.CCGGATTGC	ATATGCAGC.CCGGATTGC
ATATGCAGC.CCGTTCCAA	ATATGCAGC.CCGTTCCAA
ATATGCAGC.GTGCACGAG	ATATGCAGC.GTGCACGAG
ATATGCAGC.TAGCCAGTG	ATATGCAGC.TAGCCAGTG
ATATGCAGC.TCGACGTTG	ATATGCAGC.TCGACGTTG
ATATGTCCA.AGGTACCAA	ATATGTCCA.AGGTACCAA
ATATGTCCA.CCACGTTCT	ATATGTCCA.CCACGTTCT
ATATGTCCA.CTCTAAGAG	ATATGTCCA.CTCTAAGAG
ATATGTCCA.GTGGTTACC	ATATGTCCA.GTGGTTACC
ATATTCGCA.CAGTTGAGT	ATATTCGCA.CAGTTGAGT
ATATTCGCA.GAATCAACC	ATATTCGCA.GAATCAACC
ATCAAGAGA.AATCAGGAG	ATCAAGAGA.AATCAGGAG
ATCAAGAGA.ACTCACGAA	ATCAAGAGA.ACTCACGAA
ATCAAGAGA.CTGCTGCTT	ATCAAGAGA.CTGCTGCTT
ATCAAGAGA.GATGCGACG	ATCAAGAGA.GATGCGACG
ATCAAGAGA.TCGCATTCG	ATCAAGAGA.TCGCATTCG
ATCAAGCAT.AATTCGGAA	ATCAAGCAT.AATTCGGAA
ATCAAGCAT.ATGAGGTAT	ATCAAGCAT.ATGAGGTAT
ATCAAGCAT.TGATGACAG	ATCAAGCAT.TGATGACAG
ATCACCGCA.ATAAGACAG	ATCACCGCA.ATAAGACAG
ATCACCGCA.CTCGACGAT	ATCACCGCA.CTCGACGAT
ATCACCGCA.CTCTAGTAA	ATCACCGCA.CTCTAGTAA
ATCACCGCA.GCAATGAGA	ATCACCGCA.GCAATGAGA
ATCACCGCA.TCCTTAGGT	ATCACCGCA.TCCTTAGGT
ATCACCGCA.TCGGAACGA	ATCACCGCA.TCGGAACGA
ATCACCGCA.TTCCTAAGG	ATCACCGCA.TTCCTAAGG
ATCACTTCC.AACGCATTG	ATCACTTCC.AACGCATTG
ATCACTTCC.ACCACGCTA	ATCACTTCC.ACCACGCTA
ATCACTTCC.AGCACACCT	ATCACTTCC.AGCACACCT
ATCACTTCC.ATGCAGTTC	ATCACTTCC.ATGCAGTTC
ATCACTTCC.CCACTGAAG	ATCACTTCC.CCACTGAAG
ATCAGAAGC.ACCTCCTAG	ATCAGAAGC.ACCTCCTAG
ATCAGAAGC.ATCCACAGT	ATCAGAAGC.ATCCACAGT
ATCAGAAGC.CACACCTGT	ATCAGAAGC.CACACCTGT
ATCAGAAGC.GATGTTACA	ATCAGAAGC.GATGTTACA
ATCAGGATG.AACGATGAC	ATCAGGATG.AACGATGAC
ATCAGGATG.AACGCATTG	ATCAGGATG.AACGCATTG
ATCAGGATG.ATTGATCAC	ATCAGGATG.ATTGATCAC
ATCAGGATG.CAAGCGCAT	ATCAGGATG.CAAGCGCAT
ATCAGGATG.CCTTCCTCA	ATCAGGATG.CCTTCCTCA
ATCAGGATG.GCGTATAGG	ATCAGGATG.GCGTATAGG
ATCAGGATG.TCGCTGTAA	ATCAGGATG.TCGCTGTAA
ATCAGGATG.TGCGCTGCA	ATCAGGATG.TGCGCTGCA
ATCAGTCGA.ATTAGCACA	ATCAGTCGA.ATTAGCACA
ATCAGTCGA.GACTATTGA	ATCAGTCGA.GACTATTGA
ATCAGTCGA.GGATACAAT	ATCAGTCGA.GGATACAAT
ATCAGTCGA.GGATACCTA	ATCAGTCGA.GGATACCTA
ATCAGTCGA.TATGATGTG	ATCAGTCGA.TATGATGTG
ATCAGTCGA.TCCTTCAAC	ATCAGTCGA.TCCTTCAAC
ATCATAGAC.AACTTAGCT	ATCATAGAC.AACTTAGCT
ATCATAGAC.AATAGACGC	ATCATAGAC.AATAGACGC
ATCATAGAC.ACAGTATTG	ATCATAGAC.ACAGTATTG
ATCATAGAC.AGACTAGTA	ATCATAGAC.AGACTAGTA
ATCATAGAC.AGCAACATT	ATCATAGAC.AGCAACATT
ATCATAGAC.AGCACCAGC	ATCATAGAC.AGCACCAGC
ATCATAGAC.AGGAAGGTG	ATCATAGAC.AGGAAGGTG
ATCATAGAC.AGTCCAGTG	ATCATAGAC.AGTCCAGTG
ATCATAGAC.GATTGAGTA	ATCATAGAC.GATTGAGTA
ATCATAGAC.GCCTGGAAT	ATCATAGAC.GCCTGGAAT
ATCATAGAC.GCGAACTCG	ATCATAGAC.GCGAACTCG
ATCATAGAC.GTCAACTGA	ATCATAGAC.GTCAACTGA
ATCATAGAC.TATCATGCT	ATCATAGAC.TATCATGCT
ATCATAGAC.TCATGCAGG	ATCATAGAC.TCATGCAGG
ATCATGTTC.AAGTTCTCT	ATCATGTTC.AAGTTCTCT
ATCATGTTC.CATGGTTAC	ATCATGTTC.CATGGTTAC
ATCATGTTC.CGCACTGAA	ATCATGTTC.CGCACTGAA
ATCATGTTC.GACGCCGTA	ATCATGTTC.GACGCCGTA
ATCATGTTC.GCGTAACAA	ATCATGTTC.GCGTAACAA
ATCATGTTC.GCTTAGAAC	ATCATGTTC.GCTTAGAAC
ATCATTACG.CGCGTGAGA	ATCATTACG.CGCGTGAGA
ATCATTACG.GAAGAGCAC	ATCATTACG.GAAGAGCAC
ATCATTACG.GCCGAACCA	ATCATTACG.GCCGAACCA
ATCCAATGA.ACTCTCACA	ATCCAATGA.ACTCTCACA
ATCCAATGA.CGCCATTAC	ATCCAATGA.CGCCATTAC
ATCCAATGA.CTAGACATG	ATCCAATGA.CTAGACATG
ATCCACAGT.TGGAGTGGA	ATCCACAGT.TGGAGTGGA
ATCCACAGT.TGGTCTACG	ATCCACAGT.TGGTCTACG
ATCCACAGT.TTCGCTGAG	ATCCACAGT.TTCGCTGAG
ATCCAGCTG.ACCGGTTAC	ATCCAGCTG.ACCGGTTAC
ATCCAGCTG.CCTAAGAAG	ATCCAGCTG.CCTAAGAAG
ATCCAGCTG.CTGCAGAGC	ATCCAGCTG.CTGCAGAGC
ATCCAGCTG.GCGACAACC	ATCCAGCTG.GCGACAACC
ATCCAGCTG.GCGTGATAC	ATCCAGCTG.GCGTGATAC
ATCCAGCTG.TCGCTGTAA	ATCCAGCTG.TCGCTGTAA
ATCCATTAG.CCGGTTCTA	ATCCATTAG.CCGGTTCTA
ATCCATTAG.TGGAGTGGA	ATCCATTAG.TGGAGTGGA
ATCCGACCA.ATGATAGCT	ATCCGACCA.ATGATAGCT
ATCCGACCA.GAGACTCGA	ATCCGACCA.GAGACTCGA
ATCCGACCA.GGATAGTCA	ATCCGACCA.GGATAGTCA
ATCCGACCA.TTCCTGCTA	ATCCGACCA.TTCCTGCTA
ATCCGGTCC.ACGCAAGAT	ATCCGGTCC.ACGCAAGAT
ATCCGGTCC.CTTCGTGCA	ATCCGGTCC.CTTCGTGCA
ATCCGGTCC.TGATTCACC	ATCCGGTCC.TGATTCACC
ATCCGTCTC.ACTTCTAAC	ATCCGTCTC.ACTTCTAAC
ATCCGTCTC.AGACTAGTA	ATCCGTCTC.AGACTAGTA
ATCCGTCTC.CCATGCGTC	ATCCGTCTC.CCATGCGTC
ATCCGTCTC.GATTAGTGT	ATCCGTCTC.GATTAGTGT
ATCCGTCTC.GTATACAGA	ATCCGTCTC.GTATACAGA
ATCCGTCTC.TTAACGGAG	ATCCGTCTC.TTAACGGAG
ATCCTCCGA.CCATTCTGC	ATCCTCCGA.CCATTCTGC
ATCCTCCGA.CCGCTATCC	ATCCTCCGA.CCGCTATCC
ATCCTCCGA.CTAGTCGTC	ATCCTCCGA.CTAGTCGTC
ATCCTCCGA.CTGAGGTTA	ATCCTCCGA.CTGAGGTTA
ATCCTCCGA.TCTATTAGG	ATCCTCCGA.TCTATTAGG
ATCCTCCGA.TTAGTCGGA	ATCCTCCGA.TTAGTCGGA
ATCCTCCGA.TTCTGGTGC	ATCCTCCGA.TTCTGGTGC
ATCCTGCCT.ACACAGAAC	ATCCTGCCT.ACACAGAAC
ATCCTGCCT.CTTCCTGAT	ATCCTGCCT.CTTCCTGAT
ATCCTGCCT.GACGGTGCT	ATCCTGCCT.GACGGTGCT
ATCCTGCCT.TTACTAGTC	ATCCTGCCT.TTACTAGTC
ATCGAATCG.CCGACGTCA	ATCGAATCG.CCGACGTCA
ATCGAATCG.CTCATGCCA	ATCGAATCG.CTCATGCCA
ATCGAATCG.GGAGCATCT	ATCGAATCG.GGAGCATCT
ATCGATCCT.TCGTTCTCC	ATCGATCCT.TCGTTCTCC
ATCGCCTCT.AAGCTTGCA	ATCGCCTCT.AAGCTTGCA
ATCGCCTCT.AGTGATGCG	ATCGCCTCT.AGTGATGCG
ATCGCCTCT.AGTTATCGC	ATCGCCTCT.AGTTATCGC
ATCGCCTCT.CGCGCACAT	ATCGCCTCT.CGCGCACAT
ATCGCCTCT.GGAGCTCAA	ATCGCCTCT.GGAGCTCAA
ATCGGTGGT.AGCGACACC	ATCGGTGGT.AGCGACACC
ATCGGTGGT.CCTCGCGTT	ATCGGTGGT.CCTCGCGTT
ATCGGTGGT.TGAACTTGC	ATCGGTGGT.TGAACTTGC
ATCGTAGTG.CACGACTCA	ATCGTAGTG.CACGACTCA
ATCTACATC.ACCATGTCT	ATCTACATC.ACCATGTCT
ATCTACATC.ATAGCACGG	ATCTACATC.ATAGCACGG
ATCTACATC.ATGCGGATT	ATCTACATC.ATGCGGATT
ATCTACATC.CTCCTATCT	ATCTACATC.CTCCTATCT
ATCTACATC.GTGCACGAG	ATCTACATC.GTGCACGAG
ATCTACATC.TGAACTTGC	ATCTACATC.TGAACTTGC
ATCTACATC.TTGCAGTCA	ATCTACATC.TTGCAGTCA
ATCTAGGTT.AGATACGTT	ATCTAGGTT.AGATACGTT
ATCTAGGTT.CATACGCAG	ATCTAGGTT.CATACGCAG
ATCTCGAAC.CAACTCCAG	ATCTCGAAC.CAACTCCAG
ATCTCGAAC.CAAGTCACT	ATCTCGAAC.CAAGTCACT
ATCTCGAAC.GACTTGATT	ATCTCGAAC.GACTTGATT
ATCTCGAAC.GATACTGTG	ATCTCGAAC.GATACTGTG
ATCTCGAAC.TCTAGCTGG	ATCTCGAAC.TCTAGCTGG
ATCTCGTGA.ATTCGAAGA	ATCTCGTGA.ATTCGAAGA
ATCTCGTGA.CACAATAAC	ATCTCGTGA.CACAATAAC
ATCTCGTGA.CTATTAAGG	ATCTCGTGA.CTATTAAGG
ATCTCGTGA.CTTAGAAGG	ATCTCGTGA.CTTAGAAGG
ATCTCGTGA.GTAAGTGAG	ATCTCGTGA.GTAAGTGAG
ATCTCTGCT.ATCAGAAGC	ATCTCTGCT.ATCAGAAGC
ATCTCTGCT.CACTCACTA	ATCTCTGCT.CACTCACTA
ATCTCTGCT.CCTCAGGTG	ATCTCTGCT.CCTCAGGTG
ATCTCTGCT.CTGATCAAG	ATCTCTGCT.CTGATCAAG
ATCTCTGCT.GCACAACTC	ATCTCTGCT.GCACAACTC
ATCTCTGCT.TACAAGAGG	ATCTCTGCT.TACAAGAGG
ATCTCTGCT.TAGAGCCAG	ATCTCTGCT.TAGAGCCAG
ATCTCTGCT.TCTGATGAA	ATCTCTGCT.TCTGATGAA
ATCTGCGTA.ACGCTATGT	ATCTGCGTA.ACGCTATGT
ATCTGGTAG.ACCTCCTAG	ATCTGGTAG.ACCTCCTAG
ATCTGGTAG.ACTTCAGTA	ATCTGGTAG.ACTTCAGTA
ATCTGGTAG.CTGCTTAGG	ATCTGGTAG.CTGCTTAGG
ATGAACTAG.AAGTACAGA	ATGAACTAG.AAGTACAGA
ATGAACTAG.GATTAGTGT	ATGAACTAG.GATTAGTGT
ATGAACTAG.TTGAGACGG	ATGAACTAG.TTGAGACGG
ATGACACAA.ATAGTGGTT	ATGACACAA.ATAGTGGTT
ATGAGATCC.ACCGGAAGG	ATGAGATCC.ACCGGAAGG
ATGAGATCC.AGGTCACGT	ATGAGATCC.AGGTCACGT
ATGAGATCC.GAGCGACTC	ATGAGATCC.GAGCGACTC
ATGAGATCC.TGGTGCCTG	ATGAGATCC.TGGTGCCTG
ATGAGCAGG.ACACACCGT	ATGAGCAGG.ACACACCGT
ATGAGCAGG.CAGCTAGTT	ATGAGCAGG.CAGCTAGTT
ATGAGCAGG.CTAACCGGT	ATGAGCAGG.CTAACCGGT
ATGAGCAGG.GCCGTGAAC	ATGAGCAGG.GCCGTGAAC
ATGAGCAGG.GTAGGACGC	ATGAGCAGG.GTAGGACGC
ATGAGCAGG.GTGCGTTCC	ATGAGCAGG.GTGCGTTCC
ATGAGCAGG.TAGGATGCC	ATGAGCAGG.TAGGATGCC
ATGAGGTAT.GGAGTTAGC	ATGAGGTAT.GGAGTTAGC
ATGAGGTAT.TGCAGATGC	ATGAGGTAT.TGCAGATGC
ATGAGTGTG.GCATGTGGT	ATGAGTGTG.GCATGTGGT
ATGAGTGTG.TGACCTATG	ATGAGTGTG.TGACCTATG
ATGAGTGTG.TTCACCTTG	ATGAGTGTG.TTCACCTTG
ATGATAGCT.CCTCGAGAG	ATGATAGCT.CCTCGAGAG
ATGATAGCT.CTCAGTGAT	ATGATAGCT.CTCAGTGAT
ATGATAGCT.TAGATAGCC	ATGATAGCT.TAGATAGCC
ATGATAGCT.TGGAAGATT	ATGATAGCT.TGGAAGATT
ATGCAGTTC.AATCCTCGT	ATGCAGTTC.AATCCTCGT
ATGCAGTTC.TCATATCGC	ATGCAGTTC.TCATATCGC
ATGCAGTTC.TCATCATCT	ATGCAGTTC.TCATCATCT
ATGCCTGTC.ACTCTAGGA	ATGCCTGTC.ACTCTAGGA
ATGCCTGTC.GTTATCGAT	ATGCCTGTC.GTTATCGAT
ATGCCTTCA.ATCAAGAGA	ATGCCTTCA.ATCAAGAGA
ATGCCTTCA.GAGTCTTCG	ATGCCTTCA.GAGTCTTCG
ATGCGCCGT.AGCATTGTT	ATGCGCCGT.AGCATTGTT
ATGCGCCGT.CACTGCTTA	ATGCGCCGT.CACTGCTTA
ATGCGCCGT.CTCCTATCT	ATGCGCCGT.CTCCTATCT
ATGCGCTAC.CACCAGAAG	ATGCGCTAC.CACCAGAAG
ATGCGCTAC.GCTGATGTC	ATGCGCTAC.GCTGATGTC
ATGCGCTAC.GTACCACAA	ATGCGCTAC.GTACCACAA
ATGCGGATT.AGTCCGTGT	ATGCGGATT.AGTCCGTGT
ATGCGGATT.CAACTAATC	ATGCGGATT.CAACTAATC
ATGCGGATT.CACGTAGAC	ATGCGGATT.CACGTAGAC
ATGCGGATT.TGAGCAGAT	ATGCGGATT.TGAGCAGAT
ATGCGGATT.TTCGTGATG	ATGCGGATT.TTCGTGATG
ATGCGTGGA.GGATCAATG	ATGCGTGGA.GGATCAATG
ATGCGTGGA.TGACCTATG	ATGCGTGGA.TGACCTATG
ATGCTCACC.ACTACCATC	ATGCTCACC.ACTACCATC
ATGCTCACC.CCACGAAGG	ATGCTCACC.CCACGAAGG
ATGCTCACC.CCGGTGGTT	ATGCTCACC.CCGGTGGTT
ATGCTCACC.GTCGTGTTA	ATGCTCACC.GTCGTGTTA
ATGCTCACC.TCGTGCCAC	ATGCTCACC.TCGTGCCAC
ATGCTGTCG.AGTGTGCAC	ATGCTGTCG.AGTGTGCAC
ATGCTGTCG.ATTAAGACC	ATGCTGTCG.ATTAAGACC
ATGCTGTCG.CACATTCTG	ATGCTGTCG.CACATTCTG
ATGCTGTCG.GCTATGTAA	ATGCTGTCG.GCTATGTAA
ATGCTGTCG.GTGGAGGTC	ATGCTGTCG.GTGGAGGTC
ATGCTTCAG.AGTGTCTCT	ATGCTTCAG.AGTGTCTCT
