AACAACCTA.ACGCTAGTG	AACAACCTA.ACGCTAGTG
AACAACCTA.ACGTTCAAT	AACAACCTA.ACGTTCAAT
AACAACCTA.GCACCATCG	AACAACCTA.GCACCATCG
AACAACTGG.AACCATGGT	AACAACTGG.AACCATGGT
AACAACTGG.AACGCATTG	AACAACTGG.AACGCATTG
AACAACTGG.AACGTTCTT	AACAACTGG.AACGTTCTT
AACAACTGG.ATGCCTGTC	AACAACTGG.ATGCCTGTC
AACAACTGG.CACGGATAG	AACAACTGG.CACGGATAG
AACAACTGG.CGCTTCACG	AACAACTGG.CGCTTCACG
AACAACTGG.GAGTCAAGG	AACAACTGG.GAGTCAAGG
AACAACTGG.GCAATGAGA	AACAACTGG.GCAATGAGA
AACAATGCA.ACTAACCGA	AACAATGCA.ACTAACCGA
AACAATGCA.AGAGGACGT	AACAATGCA.AGAGGACGT
AACAATGCA.ATCCAATGA	AACAATGCA.ATCCAATGA
AACAATGCA.TATCTGTCA	AACAATGCA.TATCTGTCA
AACACACTC.ATGAGATCC	AACACACTC.ATGAGATCC
AACACACTC.TAGCTAAGA	AACACACTC.TAGCTAAGA
AACAGATCG.AACACACTC	AACAGATCG.AACACACTC
AACAGATCG.AGCTCTCCG	AACAGATCG.AGCTCTCCG
AACAGATCG.ATTATGCAG	AACAGATCG.ATTATGCAG
AACAGATCG.CCGCACTCA	AACAGATCG.CCGCACTCA
AACAGATCG.CTTCGACTG	AACAGATCG.CTTCGACTG
AACAGATCG.GTATGCCTT	AACAGATCG.GTATGCCTT
AACAGCAGT.CGTTAATGG	AACAGCAGT.CGTTAATGG
AACCATGGT.ACGTTCAAT	AACCATGGT.ACGTTCAAT
AACCATGGT.ATCCAGCTG	AACCATGGT.ATCCAGCTG
AACCATGGT.GCCTTCCAT	AACCATGGT.GCCTTCCAT
AACCATGGT.GGTAAGTGA	AACCATGGT.GGTAAGTGA
AACCATGGT.TCAGAGCGT	AACCATGGT.TCAGAGCGT
AACCATGGT.TCCTGTGGA	AACCATGGT.TCCTGTGGA
AACCATGGT.TTCCTTGAC	AACCATGGT.TTCCTTGAC
AACCGCTGA.AACGGAGAT	AACCGCTGA.AACGGAGAT
AACCGCTGA.ACGTCGCTC	AACCGCTGA.ACGTCGCTC
AACCGCTGA.ACTAAGTTC	AACCGCTGA.ACTAAGTTC
AACCGCTGA.ATGGAGAGT	AACCGCTGA.ATGGAGAGT
AACCGCTGA.TCTACAGTT	AACCGCTGA.TCTACAGTT
AACCGTGAG.AGTGTTCTG	AACCGTGAG.AGTGTTCTG
AACCGTGAG.CCGATCTCT	AACCGTGAG.CCGATCTCT
AACCGTGAG.CGTTAATGG	AACCGTGAG.CGTTAATGG
AACCGTGAG.TATGACCGA	AACCGTGAG.TATGACCGA
AACGAGAAT.CACAATAAC	AACGAGAAT.CACAATAAC
AACGAGAAT.CTCCAGCGT	AACGAGAAT.CTCCAGCGT
AACGAGAAT.GTTAGTCAA	AACGAGAAT.GTTAGTCAA
AACGAGGTG.ATATCCGAT	AACGAGGTG.ATATCCGAT
AACGAGGTG.CGCTTGTAG	AACGAGGTG.CGCTTGTAG
AACGAGGTG.CTCGCAAGA	AACGAGGTG.CTCGCAAGA
AACGATGAC.AGTGATGCG	AACGATGAC.AGTGATGCG
AACGATGAC.CAAGTCACT	AACGATGAC.CAAGTCACT
AACGATGAC.CAGTTACTG	AACGATGAC.CAGTTACTG
AACGCATTG.AATCCGCTG	AACGCATTG.AATCCGCTG
AACGCATTG.ACCGGAAGG	AACGCATTG.ACCGGAAGG
AACGCATTG.AGTCTGGAA	AACGCATTG.AGTCTGGAA
AACGCATTG.ATTAGCGGT	AACGCATTG.ATTAGCGGT
AACGCATTG.GATCGATAC	AACGCATTG.GATCGATAC
AACGCATTG.GTGACGTAA	AACGCATTG.GTGACGTAA
AACGCCTAC.GACCAACAG	AACGCCTAC.GACCAACAG
AACGCCTAC.GGTCCTGGT	AACGCCTAC.GGTCCTGGT
AACGCCTAC.GGTTGCTAT	AACGCCTAC.GGTTGCTAT
AACGCCTAC.TGGAACTAA	AACGCCTAC.TGGAACTAA
AACGCTCAA.AACTGATTC	AACGCTCAA.AACTGATTC
AACGCTCAA.ACCGATCGA	AACGCTCAA.ACCGATCGA
AACGCTCAA.ATAGAGCAG	AACGCTCAA.ATAGAGCAG
AACGCTCAA.GCAGCTCTT	AACGCTCAA.GCAGCTCTT
AACGCTCAA.TCTACATCC	AACGCTCAA.TCTACATCC
AACGCTCAA.TGCCATCTC	AACGCTCAA.TGCCATCTC
AACGGAGAT.AACTGATTC	AACGGAGAT.AACTGATTC
AACGGAGAT.CACTGCTTA	AACGGAGAT.CACTGCTTA
AACGGAGAT.CTATACTAG	AACGGAGAT.CTATACTAG
AACGGAGAT.GCAGCAGTG	AACGGAGAT.GCAGCAGTG
AACGGAGAT.GCCATACAA	AACGGAGAT.GCCATACAA
AACGGAGAT.GCCGTTGTT	AACGGAGAT.GCCGTTGTT
AACGGAGAT.TAGGATTAG	AACGGAGAT.TAGGATTAG
AACGGAGAT.TTCTGGTGC	AACGGAGAT.TTCTGGTGC
AACGGTAGC.CAGCAGTAC	AACGGTAGC.CAGCAGTAC
AACGGTAGC.CATGTCCTG	AACGGTAGC.CATGTCCTG
AACGGTAGC.CTTGCACAA	AACGGTAGC.CTTGCACAA
AACGGTAGC.GCACTGGAT	AACGGTAGC.GCACTGGAT
AACGGTAGC.GGTGTGACC	AACGGTAGC.GGTGTGACC
AACGGTAGC.TAACATTGG	AACGGTAGC.TAACATTGG
AACGTCGAG.ACCTAGTTA	AACGTCGAG.ACCTAGTTA
AACGTCGAG.ATTCCGTAC	AACGTCGAG.ATTCCGTAC
AACGTCGAG.CGAGCCGTT	AACGTCGAG.CGAGCCGTT
AACGTCGAG.CGCCTGCAA	AACGTCGAG.CGCCTGCAA
AACGTCGAG.GAACATGAC	AACGTCGAG.GAACATGAC
AACGTCGAG.GATGTAAGG	AACGTCGAG.GATGTAAGG
AACGTCGAG.TAGTGCACT	AACGTCGAG.TAGTGCACT
AACGTTCTT.ACAGCGTAT	AACGTTCTT.ACAGCGTAT
AACGTTCTT.ACTCATTCA	AACGTTCTT.ACTCATTCA
AACGTTCTT.ATTGACACG	AACGTTCTT.ATTGACACG
AACGTTCTT.GCAGCGATA	AACGTTCTT.GCAGCGATA
AACGTTCTT.GCGCATTAC	AACGTTCTT.GCGCATTAC
AACTAACTG.ATGGAGGAA	AACTAACTG.ATGGAGGAA
AACTAACTG.CAAGCGCAT	AACTAACTG.CAAGCGCAT
AACTAACTG.CGGAGACTT	AACTAACTG.CGGAGACTT
AACTAACTG.TTACGGACC	AACTAACTG.TTACGGACC
AACTGATTC.TGCGATACT	AACTGATTC.TGCGATACT
AACTGCGAC.ACGTCGCTC	AACTGCGAC.ACGTCGCTC
AACTGCGAC.CGAGCCGTT	AACTGCGAC.CGAGCCGTT
AACTGCGAC.GTATACAGA	AACTGCGAC.GTATACAGA
AACTGCGAC.GTCAGCGTC	AACTGCGAC.GTCAGCGTC
AACTTAGCT.CATCTCACG	AACTTAGCT.CATCTCACG
AACTTAGCT.GCTACCTTA	AACTTAGCT.GCTACCTTA
AACTTAGCT.GTCGTTAGA	AACTTAGCT.GTCGTTAGA
AACTTCTGC.ACCTAGCAC	AACTTCTGC.ACCTAGCAC
AACTTCTGC.CCGCATCCT	AACTTCTGC.CCGCATCCT
AACTTCTGC.GCAACACCT	AACTTCTGC.GCAACACCT
AACTTCTGC.GCCAATGAA	AACTTCTGC.GCCAATGAA
AACTTCTGC.GTGGTTACC	AACTTCTGC.GTGGTTACC
AACTTGTCG.ATATGTCCA	AACTTGTCG.ATATGTCCA
AACTTGTCG.GCTACCGAG	AACTTGTCG.GCTACCGAG
AACTTGTCG.TGAGATCAT	AACTTGTCG.TGAGATCAT
AAGACGAAG.CGCATCTAC	AAGACGAAG.CGCATCTAC
AAGACGAAG.GGTTCGCAA	AAGACGAAG.GGTTCGCAA
AAGACGAAG.TCGTGCCAC	AAGACGAAG.TCGTGCCAC
AAGACTACC.ATTGACACG	AAGACTACC.ATTGACACG
AAGACTACC.TAGTCGCAT	AAGACTACC.TAGTCGCAT
AAGACTACC.TCAGTAAGC	AAGACTACC.TCAGTAAGC
AAGACTGGT.TAAGTACAC	AAGACTGGT.TAAGTACAC
AAGACTGGT.TTGCCGTAG	AAGACTGGT.TTGCCGTAG
AAGAGAACT.AATGCCTCA	AAGAGAACT.AATGCCTCA
AAGAGAACT.ATCCACAGT	AAGAGAACT.ATCCACAGT
AAGAGAACT.TCACATACT	AAGAGAACT.TCACATACT
AAGAGAGAG.CCTTGCTTG	AAGAGAGAG.CCTTGCTTG
AAGAGAGAG.TGACAAGTT	AAGAGAGAG.TGACAAGTT
AAGCAACTA.CGGAATGCA	AAGCAACTA.CGGAATGCA
AAGCAACTA.TCCTTCAAC	AAGCAACTA.TCCTTCAAC
AAGCAATCG.AGTGACGAT	AAGCAATCG.AGTGACGAT
AAGCAATCG.TTATCCAAG	AAGCAATCG.TTATCCAAG
AAGCACAAC.ATAGCCTAA	AAGCACAAC.ATAGCCTAA
AAGCACAAC.CATTCGAAT	AAGCACAAC.CATTCGAAT
AAGCACAAC.CTGTACGAC	AAGCACAAC.CTGTACGAC
AAGCACAAC.GTGCCATGA	AAGCACAAC.GTGCCATGA
AAGCACAAC.TGAACCAAT	AAGCACAAC.TGAACCAAT
AAGCACAAC.TTAACGGAG	AAGCACAAC.TTAACGGAG
AAGCAGCAT.ATGCCTTCA	AAGCAGCAT.ATGCCTTCA
AAGCAGCAT.CGTGTCCGA	AAGCAGCAT.CGTGTCCGA
AAGCAGCAT.TCGGATGTT	AAGCAGCAT.TCGGATGTT
AAGCAGCAT.TGCCAGACG	AAGCAGCAT.TGCCAGACG
AAGCATTGC.ATATTCGCA	AAGCATTGC.ATATTCGCA
AAGCATTGC.CCTAGTCTC	AAGCATTGC.CCTAGTCTC
AAGCATTGC.CGGTGTTAC	AAGCATTGC.CGGTGTTAC
AAGCATTGC.CTCAGCTGG	AAGCATTGC.CTCAGCTGG
AAGCATTGC.TGCGCTGCA	AAGCATTGC.TGCGCTGCA
AAGCCAAGT.ACCATGTCT	AAGCCAAGT.ACCATGTCT
AAGCCAAGT.CAGTCGGTA	AAGCCAAGT.CAGTCGGTA
AAGCCAAGT.CGAATCCTG	AAGCCAAGT.CGAATCCTG
AAGCCAAGT.GCGACACAG	AAGCCAAGT.GCGACACAG
AAGCCACAC.AATCCTCGT	AAGCCACAC.AATCCTCGT
AAGCCACAC.CCTTAACAT	AAGCCACAC.CCTTAACAT
AAGCCACAC.CTAGTTCCA	AAGCCACAC.CTAGTTCCA
AAGCCACAC.GCTGGTTCG	AAGCCACAC.GCTGGTTCG
AAGCCACAC.GTAAGGTCC	AAGCCACAC.GTAAGGTCC
AAGCCACAC.GTGCTGACT	AAGCCACAC.GTGCTGACT
AAGCCACAC.TCTACAGTT	AAGCCACAC.TCTACAGTT
AAGCCACAC.TGGAATCGT	AAGCCACAC.TGGAATCGT
AAGCCACAC.TTATCCAAG	AAGCCACAC.TTATCCAAG
AAGCCACAC.TTCCAGATT	AAGCCACAC.TTCCAGATT
AAGCCACAC.TTCTGAATG	AAGCCACAC.TTCTGAATG
AAGCTGAGG.ACAGAAGAG	AAGCTGAGG.ACAGAAGAG
AAGCTGAGG.CAGTCGGTA	AAGCTGAGG.CAGTCGGTA
AAGCTGAGG.CTTGATCTA	AAGCTGAGG.CTTGATCTA
AAGCTGAGG.TCTTAAGTG	AAGCTGAGG.TCTTAAGTG
AAGCTGGTC.CGACAGACC	AAGCTGGTC.CGACAGACC
AAGCTGGTC.GGTCCTAAG	AAGCTGGTC.GGTCCTAAG
AAGCTTGCA.CTGATCCGA	AAGCTTGCA.CTGATCCGA
AAGCTTGCA.GCCTGGAAT	AAGCTTGCA.GCCTGGAAT
AAGCTTGCA.TTGACCTGA	AAGCTTGCA.TTGACCTGA
AAGGAACAG.GGTACGAGC	AAGGAACAG.GGTACGAGC
AAGGAAGTC.CCAGATCAC	AAGGAAGTC.CCAGATCAC
AAGGAAGTC.GCAGCTCTT	AAGGAAGTC.GCAGCTCTT
AAGGAAGTC.TGCGTAATC	AAGGAAGTC.TGCGTAATC
AAGGATACG.AACAATGCA	AAGGATACG.AACAATGCA
AAGGATACG.AAGCCACAC	AAGGATACG.AAGCCACAC
AAGGATACG.GAGTTAACT	AAGGATACG.GAGTTAACT
AAGGATCGT.AGTAACGTA	AAGGATCGT.AGTAACGTA
AAGGTCTGA.CATCCACCG	AAGGTCTGA.CATCCACCG
AAGGTCTGA.GTCAAGATC	AAGGTCTGA.GTCAAGATC
AAGGTCTGA.TTCACTCCT	AAGGTCTGA.TTCACTCCT
AAGGTGCTG.AAGGAAGTC	AAGGTGCTG.AAGGAAGTC
AAGGTGCTG.AGAAGAGTC	AAGGTGCTG.AGAAGAGTC
AAGGTGCTG.CCATAAGTA	AAGGTGCTG.CCATAAGTA
AAGGTGCTG.GTGCTGACT	AAGGTGCTG.GTGCTGACT
AAGGTGCTG.TCCTTCGTA	AAGGTGCTG.TCCTTCGTA
AAGTACAGA.AGTAACGTA	AAGTACAGA.AGTAACGTA
AAGTACAGA.GCGGTAGTC	AAGTACAGA.GCGGTAGTC
AAGTAGGAC.ACTTCGCAG	AAGTAGGAC.ACTTCGCAG
AAGTAGGAC.GTGCGTTCC	AAGTAGGAC.GTGCGTTCC
AAGTAGGAC.TCAGCGACC	AAGTAGGAC.TCAGCGACC
AAGTAGGAC.TCGCCAAGC	AAGTAGGAC.TCGCCAAGC
AAGTCATGA.AATTGGATC	AAGTCATGA.AATTGGATC
AAGTCATGA.AGAGCCGCA	AAGTCATGA.AGAGCCGCA
AAGTCATGA.ATAATCGAG	AAGTCATGA.ATAATCGAG
AAGTCATGA.TGCCGCTAC	AAGTCATGA.TGCCGCTAC
AAGTTCTCT.AGTGTGCAC	AAGTTCTCT.AGTGTGCAC
AAGTTCTCT.TACAACACC	AAGTTCTCT.TACAACACC
AAGTTCTCT.TGGTAGCAG	AAGTTCTCT.TGGTAGCAG
AAGTTGCCA.CGTTAATGG	AAGTTGCCA.CGTTAATGG
AAGTTGCCA.CTCCAGCGT	AAGTTGCCA.CTCCAGCGT
AAGTTGCCA.GACGTAGCA	AAGTTGCCA.GACGTAGCA
AAGTTGCCA.GCTCTCCAA	AAGTTGCCA.GCTCTCCAA
AAGTTGCCA.TAGTACGTA	AAGTTGCCA.TAGTACGTA
AAGTTGCCA.TGGAGTGGA	AAGTTGCCA.TGGAGTGGA
AAGTTGCCA.TTCAACTAC	AAGTTGCCA.TTCAACTAC
AAGTTGCCA.TTCCGAGCG	AAGTTGCCA.TTCCGAGCG
AATAACTCC.GCCATCGCT	AATAACTCC.GCCATCGCT
AATAACTCC.TCCTTAGGT	AATAACTCC.TCCTTAGGT
AATAACTCC.TCTCCGCGT	AATAACTCC.TCTCCGCGT
AATACCTTG.CACACCACA	AATACCTTG.CACACCACA
AATACCTTG.CACTTGGAT	AATACCTTG.CACTTGGAT
AATACCTTG.CCGGTGGTT	AATACCTTG.CCGGTGGTT
AATACCTTG.GAATAAGAG	AATACCTTG.GAATAAGAG
AATACCTTG.GGAGATGAG	AATACCTTG.GGAGATGAG
AATACCTTG.TGATTCACC	AATACCTTG.TGATTCACC
AATACCTTG.TTCCTCGGT	AATACCTTG.TTCCTCGGT
AATACGTCT.ACGCACACT	AATACGTCT.ACGCACACT
AATACGTCT.ATGATAGCT	AATACGTCT.ATGATAGCT
AATACTCCG.ACATGGATT	AATACTCCG.ACATGGATT
AATACTCCG.ACCATTCAC	AATACTCCG.ACCATTCAC
AATACTCCG.ACTTCTTGG	AATACTCCG.ACTTCTTGG
AATACTCCG.AGTTACAAG	AATACTCCG.AGTTACAAG
AATACTCCG.CACAACGCT	AATACTCCG.CACAACGCT
AATACTCCG.GAGATTCCT	AATACTCCG.GAGATTCCT
AATACTCCG.GGAACTGCT	AATACTCCG.GGAACTGCT
AATACTCCG.GGTTGCTAT	AATACTCCG.GGTTGCTAT
AATACTCCG.TGTAGATCG	AATACTCCG.TGTAGATCG
AATAGACGC.ACAGAGATG	AATAGACGC.ACAGAGATG
AATAGACGC.CCACGTTCT	AATAGACGC.CCACGTTCT
AATAGACGC.GTGAGGACG	AATAGACGC.GTGAGGACG
AATAGACGC.TACTCGCTG	AATAGACGC.TACTCGCTG
AATATCAGC.AGTCGCCGA	AATATCAGC.AGTCGCCGA
AATATCAGC.ATTCCGTAC	AATATCAGC.ATTCCGTAC
AATATCAGC.CAACGTCTT	AATATCAGC.CAACGTCTT
AATATCGCT.ATCCATTAG	AATATCGCT.ATCCATTAG
AATATCGCT.CCTTATCCG	AATATCGCT.CCTTATCCG
AATATCGCT.GAAGGATCA	AATATCGCT.GAAGGATCA
AATATCGCT.GACCGGTAG	AATATCGCT.GACCGGTAG
AATATCGCT.TGACCTCCT	AATATCGCT.TGACCTCCT
AATATCGCT.TTCCTTGAC	AATATCGCT.TTCCTTGAC
AATATCGCT.TTGATGAGT	AATATCGCT.TTGATGAGT
AATCAGGAG.AGCCTCGCA	AATCAGGAG.AGCCTCGCA
AATCAGGAG.CTAGGTACT	AATCAGGAG.CTAGGTACT
AATCAGGAG.TCACGACAA	AATCAGGAG.TCACGACAA
AATCAGGAG.TGAAGACCA	AATCAGGAG.TGAAGACCA
AATCAGGAG.TGCGCACTG	AATCAGGAG.TGCGCACTG
AATCCGCTG.CTCTAAGAG	AATCCGCTG.CTCTAAGAG
AATCCTCGT.AGCTTCGAT	AATCCTCGT.AGCTTCGAT
AATCCTCGT.GCTTAGAAC	AATCCTCGT.GCTTAGAAC
AATCGCCAT.AGTCATACT	AATCGCCAT.AGTCATACT
AATCGCCAT.CACTTGGAT	AATCGCCAT.CACTTGGAT
AATCGCCAT.GATCTTCGC	AATCGCCAT.GATCTTCGC
AATCGCCAT.GCTGACAGA	AATCGCCAT.GCTGACAGA
AATCGCCAT.TACCTCACT	AATCGCCAT.TACCTCACT
AATCGTGTT.AGCTGCACT	AATCGTGTT.AGCTGCACT
AATCGTGTT.CATGTGAAC	AATCGTGTT.CATGTGAAC
AATCGTGTT.CTGTCTAGT	AATCGTGTT.CTGTCTAGT
AATCGTGTT.GCGATGGTG	AATCGTGTT.GCGATGGTG
AATCGTGTT.TAACACGAG	AATCGTGTT.TAACACGAG
AATCGTGTT.TTCACTGGA	AATCGTGTT.TTCACTGGA
AATCTCCTA.ATTCCGTAC	AATCTCCTA.ATTCCGTAC
AATCTCCTA.CCTAGCAAT	AATCTCCTA.CCTAGCAAT
AATCTCCTA.CTATACTAG	AATCTCCTA.CTATACTAG
AATCTCCTA.GTGCTGACT	AATCTCCTA.GTGCTGACT
AATCTGACC.CCGAATATG	AATCTGACC.CCGAATATG
AATCTGACC.GGATCAATG	AATCTGACC.GGATCAATG
AATGAGTCG.ATATGCAGC	AATGAGTCG.ATATGCAGC
AATGAGTCG.CAGGATCAA	AATGAGTCG.CAGGATCAA
AATGAGTCG.CAGTGCCAT	AATGAGTCG.CAGTGCCAT
AATGCACTT.ATCTCTGCT	AATGCACTT.ATCTCTGCT
AATGCACTT.CACCTCGGA	AATGCACTT.CACCTCGGA
AATGCACTT.CAGTGCTGC	AATGCACTT.CAGTGCTGC
AATGCACTT.GTGACTCTC	AATGCACTT.GTGACTCTC
AATGCACTT.TACGACCAT	AATGCACTT.TACGACCAT
AATGCCTCA.AACGCATTG	AATGCCTCA.AACGCATTG
AATGCCTCA.CGCTGTAGT	AATGCCTCA.CGCTGTAGT
AATGCCTCA.CTAACCGGT	AATGCCTCA.CTAACCGGT
AATGCCTCA.TAGTTGACG	AATGCCTCA.TAGTTGACG
AATGCGTGC.AAGCCAAGT	AATGCGTGC.AAGCCAAGT
AATGCGTGC.GGTTAGATG	AATGCGTGC.GGTTAGATG
AATGCGTGC.GTCCTAGTT	AATGCGTGC.GTCCTAGTT
AATGCGTGC.TTACGGACC	AATGCGTGC.TTACGGACC
AATGCTATC.ACCATGTCT	AATGCTATC.ACCATGTCT
AATGCTATC.AGCGGTCTA	AATGCTATC.AGCGGTCTA
AATGCTATC.ATCACCGCA	AATGCTATC.ATCACCGCA
AATGCTATC.CAAGTACGA	AATGCTATC.CAAGTACGA
AATGCTATC.CCGGTTCTA	AATGCTATC.CCGGTTCTA
AATGCTATC.GACAGGTTA	AATGCTATC.GACAGGTTA
AATGCTATC.GATAAGCTG	AATGCTATC.GATAAGCTG
AATGCTGAT.AGACTAGTA	AATGCTGAT.AGACTAGTA
AATGCTGAT.GCACGCATT	AATGCTGAT.GCACGCATT
AATGCTGAT.TAGACACGT	AATGCTGAT.TAGACACGT
AATGCTGAT.TGTGGACAA	AATGCTGAT.TGTGGACAA
AATGTGCGT.ATTGGTTCC	AATGTGCGT.ATTGGTTCC
AATGTGCGT.CACCTTCCT	AATGTGCGT.CACCTTCCT
AATGTGCGT.CTTGTAACG	AATGTGCGT.CTTGTAACG
AATGTGCGT.GGAATTGGA	AATGTGCGT.GGAATTGGA
AATTAGAGG.CACTACAGG	AATTAGAGG.CACTACAGG
AATTAGAGG.CCGATCAGC	AATTAGAGG.CCGATCAGC
AATTAGAGG.GCATACATG	AATTAGAGG.GCATACATG
AATTAGAGG.TCGCTGTAA	AATTAGAGG.TCGCTGTAA
AATTCGGAA.GGAGATGAG	AATTCGGAA.GGAGATGAG
AATTCGGAA.GTGAGGACG	AATTCGGAA.GTGAGGACG
AATTCGGAA.TGATTGCTG	AATTCGGAA.TGATTGCTG
AATTGGATC.AGTACGAAT	AATTGGATC.AGTACGAAT
AATTGGATC.ATCATGTTC	AATTGGATC.ATCATGTTC
AATTGGATC.ATCTCGAAC	AATTGGATC.ATCTCGAAC
AATTGGATC.GTTGCATGG	AATTGGATC.GTTGCATGG
AATTGGATC.TCTACGCAA	AATTGGATC.TCTACGCAA
AATTGGTGA.ACAAGTACA	AATTGGTGA.ACAAGTACA
AATTGGTGA.ACCGGAGTA	AATTGGTGA.ACCGGAGTA
AATTGGTGA.AGTTATCGC	AATTGGTGA.AGTTATCGC
AATTGGTGA.ATTAGCGGT	AATTGGTGA.ATTAGCGGT
AATTGGTGA.CTCATTAGT	AATTGGTGA.CTCATTAGT
AATTGGTGA.CTGCATGTT	AATTGGTGA.CTGCATGTT
AATTGGTGA.CTGCTGCTT	AATTGGTGA.CTGCTGCTT
AATTGGTGA.TGATTGTGC	AATTGGTGA.TGATTGTGC
ACAACCGGA.CAGCGTAAG	ACAACCGGA.CAGCGTAAG
ACAACCGGA.CCGATACCG	ACAACCGGA.CCGATACCG
ACAACCGGA.CCTCTGCAT	ACAACCGGA.CCTCTGCAT
ACAACCGGA.TCACAGGTA	ACAACCGGA.TCACAGGTA
ACAACGAGC.AACCGTGAG	ACAACGAGC.AACCGTGAG
ACAACGAGC.AGGAGGTGA	ACAACGAGC.AGGAGGTGA
ACAACGAGC.GCACAGTAA	ACAACGAGC.GCACAGTAA
ACAAGAATG.AACGCCTAC	ACAAGAATG.AACGCCTAC
ACAAGAATG.ACCGTACGC	ACAAGAATG.ACCGTACGC
ACAAGAATG.ACTAAGTTC	ACAAGAATG.ACTAAGTTC
ACAAGAATG.GACCTTGTG	ACAAGAATG.GACCTTGTG
ACAAGGTAC.ACACTGTGA	ACAAGGTAC.ACACTGTGA
ACAAGGTAC.CACGCGTAA	ACAAGGTAC.CACGCGTAA
ACAAGGTAC.CCATTACAG	ACAAGGTAC.CCATTACAG
ACAAGGTAC.GTATGCCTT	ACAAGGTAC.GTATGCCTT
ACAAGGTAC.GTCCGCTCA	ACAAGGTAC.GTCCGCTCA
ACAAGGTAC.TCAGACAAG	ACAAGGTAC.TCAGACAAG
ACAAGGTAC.TGCCTTCAG	ACAAGGTAC.TGCCTTCAG
ACAAGGTAC.TGTGCTAAC	ACAAGGTAC.TGTGCTAAC
ACAAGTACA.ACGACAGTC	ACAAGTACA.ACGACAGTC
ACAAGTACA.ACTCTCACA	ACAAGTACA.ACTCTCACA
ACAAGTACA.CGGTGAGTC	ACAAGTACA.CGGTGAGTC
ACAAGTACA.TAGCACACG	ACAAGTACA.TAGCACACG
ACAAGTACA.TCCGGAGCT	ACAAGTACA.TCCGGAGCT
ACAATAGGT.AAGAGAACT	ACAATAGGT.AAGAGAACT
ACAATAGGT.GATCTGTTC	ACAATAGGT.GATCTGTTC
ACAATAGGT.TGGTGCCTG	ACAATAGGT.TGGTGCCTG
ACAATAGGT.TTGACCTGA	ACAATAGGT.TTGACCTGA
ACAATTCGG.AACAGCAGT	ACAATTCGG.AACAGCAGT
ACAATTCGG.CTTAGAAGG	ACAATTCGG.CTTAGAAGG
ACAATTCGG.GACTGCGCA	ACAATTCGG.GACTGCGCA
ACAATTCGG.GAGTATCGC	ACAATTCGG.GAGTATCGC
ACAATTCGG.GCTGAGCAG	ACAATTCGG.GCTGAGCAG
ACAATTCGG.GGATTCGTC	ACAATTCGG.GGATTCGTC
ACAATTCGG.GTGTATCTG	ACAATTCGG.GTGTATCTG
ACACACCGT.AGTCATACT	ACACACCGT.AGTCATACT
ACACACCGT.CTAGAGGTA	ACACACCGT.CTAGAGGTA
ACACACCGT.GACAGGTTA	ACACACCGT.GACAGGTTA
ACACACCGT.GACTCTCAC	ACACACCGT.GACTCTCAC
ACACACCGT.GGATAGTCA	ACACACCGT.GGATAGTCA
ACACACCGT.TTCAGTGCC	ACACACCGT.TTCAGTGCC
ACACACGTC.ACCTGTACC	ACACACGTC.ACCTGTACC
ACACACGTC.TCCTCTAGT	ACACACGTC.TCCTCTAGT
ACACAGAAC.ATTCTCTGG	ACACAGAAC.ATTCTCTGG
ACACAGAAC.CAGATCATT	ACACAGAAC.CAGATCATT
ACACAGAAC.CTTACCTAG	ACACAGAAC.CTTACCTAG
ACACAGAAC.GAACCAGTT	ACACAGAAC.GAACCAGTT
ACACATCTG.CAGCCGCAA	ACACATCTG.CAGCCGCAA
ACACATCTG.CCGCTCATG	ACACATCTG.CCGCTCATG
ACACATCTG.GGTACTTCC	ACACATCTG.GGTACTTCC
ACACATCTG.TGCGATACT	ACACATCTG.TGCGATACT
ACACCACAT.AACGAGAAT	ACACCACAT.AACGAGAAT
ACACCACAT.AATTAGAGG	ACACCACAT.AATTAGAGG
ACACCACAT.ACGCAAGAT	ACACCACAT.ACGCAAGAT
ACACCACAT.ATGGTTCGA	ACACCACAT.ATGGTTCGA
ACACCACAT.CCGATCTCT	ACACCACAT.CCGATCTCT
ACACCACAT.CTCATTAGT	ACACCACAT.CTCATTAGT
ACACCACAT.GGAGCATCT	ACACCACAT.GGAGCATCT
ACACCACAT.GTCGACATT	ACACCACAT.GTCGACATT
ACACCGCCA.CAGCTTACC	ACACCGCCA.CAGCTTACC
ACACCGCCA.CAGTCGGTA	ACACCGCCA.CAGTCGGTA
ACACCGCCA.CGACAGACC	ACACCGCCA.CGACAGACC
ACACCGCCA.TCGTCATTC	ACACCGCCA.TCGTCATTC
ACACGTTGC.CATCGCTGG	ACACGTTGC.CATCGCTGG
ACACGTTGC.CCGAGCTGA	ACACGTTGC.CCGAGCTGA
ACACGTTGC.CCTTCGAGC	ACACGTTGC.CCTTCGAGC
ACACGTTGC.CTGACGGAT	ACACGTTGC.CTGACGGAT
ACACGTTGC.CTTGGTCAT	ACACGTTGC.CTTGGTCAT
ACACGTTGC.GATCGATAC	ACACGTTGC.GATCGATAC
ACACGTTGC.GATCGCACT	ACACGTTGC.GATCGCACT
ACACGTTGC.TAACTCCGA	ACACGTTGC.TAACTCCGA
ACACGTTGC.TCCTTCAAC	ACACGTTGC.TCCTTCAAC
ACACGTTGC.TTCATTCGC	ACACGTTGC.TTCATTCGC
ACACTAACG.AGTGTTCTG	ACACTAACG.AGTGTTCTG
ACACTAACG.CCTGCTCCA	ACACTAACG.CCTGCTCCA
ACACTAACG.CTTCCTGAT	ACACTAACG.CTTCCTGAT
ACACTAACG.TCTATGACA	ACACTAACG.TCTATGACA
ACACTAACG.TTCAACTAC	ACACTAACG.TTCAACTAC
ACACTGTGA.CACCAAGAT	ACACTGTGA.CACCAAGAT
ACACTGTGA.GCGCTCTAT	ACACTGTGA.GCGCTCTAT
ACACTGTGA.TAACCGTGA	ACACTGTGA.TAACCGTGA
ACACTGTGA.TAACGTGTC	ACACTGTGA.TAACGTGTC
ACAGAAGAG.ATCCAATGA	ACAGAAGAG.ATCCAATGA
ACAGAAGAG.CGCTGTAGT	ACAGAAGAG.CGCTGTAGT
ACAGAAGAG.CTCATTAGT	ACAGAAGAG.CTCATTAGT
ACAGAAGAG.TCGGACAGT	ACAGAAGAG.TCGGACAGT
ACAGAGATG.ACTGTGTCA	ACAGAGATG.ACTGTGTCA
ACAGAGATG.CAGCTCTTC	ACAGAGATG.CAGCTCTTC
ACAGAGATG.CAGTCCTAA	ACAGAGATG.CAGTCCTAA
ACAGAGATG.CGTCATGGA	ACAGAGATG.CGTCATGGA
ACAGAGATG.TCAGGACTG	ACAGAGATG.TCAGGACTG
ACAGAGATG.TGTGAGTAT	ACAGAGATG.TGTGAGTAT
ACAGCATCA.CCGCAGAAT	ACAGCATCA.CCGCAGAAT
ACAGCATCA.TGGTGGTAA	ACAGCATCA.TGGTGGTAA
ACAGCGGTC.CAATCAAGT	ACAGCGGTC.CAATCAAGT
ACAGCGGTC.CTTCTGAGT	ACAGCGGTC.CTTCTGAGT
ACAGCGGTC.GTCGTGTTA	ACAGCGGTC.GTCGTGTTA
ACAGCGGTC.TCCTATTCC	ACAGCGGTC.TCCTATTCC
ACAGCGTAT.ACGTCTATG	ACAGCGTAT.ACGTCTATG
ACAGCGTAT.AGCGGTCTA	ACAGCGTAT.AGCGGTCTA
ACAGGAACT.CCTGCAGAT	ACAGGAACT.CCTGCAGAT
ACAGGAACT.GCCTGCATC	ACAGGAACT.GCCTGCATC
ACAGGAACT.GCTACCTTA	ACAGGAACT.GCTACCTTA
ACAGGAACT.TAGCACTAT	ACAGGAACT.TAGCACTAT
ACAGGTATC.AAGTCATGA	ACAGGTATC.AAGTCATGA
ACAGGTATC.CGACCATCA	ACAGGTATC.CGACCATCA
ACAGGTATC.GATTAGTGT	ACAGGTATC.GATTAGTGT
ACAGTATTG.ACGATGACC	ACAGTATTG.ACGATGACC
ACAGTATTG.ATCGATCCT	ACAGTATTG.ATCGATCCT
ACAGTATTG.TGTGCTAAC	ACAGTATTG.TGTGCTAAC
ACAGTATTG.TTCACTGGA	ACAGTATTG.TTCACTGGA
ACATCGTCC.CAGCCGCAA	ACATCGTCC.CAGCCGCAA
ACATGACTA.ACTTCGCAG	ACATGACTA.ACTTCGCAG
ACATGACTA.AGTATGACG	ACATGACTA.AGTATGACG
ACATGACTA.CACTAGACT	ACATGACTA.CACTAGACT
ACATGACTA.CCACGTTCT	ACATGACTA.CCACGTTCT
ACATGACTA.TAAGGTGAT	ACATGACTA.TAAGGTGAT
ACATGACTA.TAGTACGTA	ACATGACTA.TAGTACGTA
ACATGACTA.TTAACGGAG	ACATGACTA.TTAACGGAG
ACATGGATT.CAACGCACA	ACATGGATT.CAACGCACA
ACATGGATT.CCGCAATGG	ACATGGATT.CCGCAATGG
ACATGGATT.CCGTTAGAC	ACATGGATT.CCGTTAGAC
ACATGGATT.CGATTCGAG	ACATGGATT.CGATTCGAG
ACATGGATT.CTATCTTGA	ACATGGATT.CTATCTTGA
ACATGGATT.CTCAGTGAT	ACATGGATT.CTCAGTGAT
ACATGGATT.GAGTCCAAT	ACATGGATT.GAGTCCAAT
ACATGGATT.GGTACTTCC	ACATGGATT.GGTACTTCC
ACATGGATT.TGAGCAGAT	ACATGGATT.TGAGCAGAT
ACATTCCAC.ACCACGCTA	ACATTCCAC.ACCACGCTA
ACATTCCAC.ACCAGCGTT	ACATTCCAC.ACCAGCGTT
ACATTCCAC.CTAGTCGTC	ACATTCCAC.CTAGTCGTC
ACATTCCAC.CTGGTAATC	ACATTCCAC.CTGGTAATC
ACATTCCAC.TGGATTAGC	ACATTCCAC.TGGATTAGC
ACATTGACA.ATCTGGTAG	ACATTGACA.ATCTGGTAG
ACATTGACA.CCGTTCCAA	ACATTGACA.CCGTTCCAA
ACCACGCTA.AAGGATCGT	ACCACGCTA.AAGGATCGT
ACCACGCTA.GATTGAGTA	ACCACGCTA.GATTGAGTA
ACCACGCTA.GTGCACGAG	ACCACGCTA.GTGCACGAG
ACCACGCTA.TAGTTGACG	ACCACGCTA.TAGTTGACG
ACCACGCTA.TCTACATCC	ACCACGCTA.TCTACATCC
ACCACGCTA.TCTGATGAA	ACCACGCTA.TCTGATGAA
ACCACGGAT.CACCTAGCG	ACCACGGAT.CACCTAGCG
ACCACGGAT.GACGGTGCT	ACCACGGAT.GACGGTGCT
ACCACGGAT.TGGTCGCTA	ACCACGGAT.TGGTCGCTA
ACCACTAGG.CGTGGTACC	ACCACTAGG.CGTGGTACC
ACCACTAGG.CTATACTAG	ACCACTAGG.CTATACTAG
ACCACTAGG.CTATGGATG	ACCACTAGG.CTATGGATG
ACCACTAGG.GCACGCATT	ACCACTAGG.GCACGCATT
ACCAGCGTT.ACACACCGT	ACCAGCGTT.ACACACCGT
ACCAGCGTT.ACCATGTCT	ACCAGCGTT.ACCATGTCT
ACCAGCGTT.CAGCACGTG	ACCAGCGTT.CAGCACGTG
ACCAGCGTT.CCATTCTGC	ACCAGCGTT.CCATTCTGC
ACCAGCGTT.GAAGAGCAC	ACCAGCGTT.GAAGAGCAC
ACCATACTT.AGTTGTGTA	ACCATACTT.AGTTGTGTA
ACCATACTT.ATATGCAGC	ACCATACTT.ATATGCAGC
ACCATACTT.ATGAACTAG	ACCATACTT.ATGAACTAG
ACCATACTT.CCGCTATCC	ACCATACTT.CCGCTATCC
ACCATACTT.CTTGATCTA	ACCATACTT.CTTGATCTA
ACCATCTAA.AGTGACGAT	ACCATCTAA.AGTGACGAT
ACCATCTAA.CCATAGCCA	ACCATCTAA.CCATAGCCA
ACCATCTAA.CGACAGGAA	ACCATCTAA.CGACAGGAA
ACCATCTAA.CTGATGCAC	ACCATCTAA.CTGATGCAC
ACCATCTAA.CTTAGGACT	ACCATCTAA.CTTAGGACT
ACCATGTCT.CGGTGTTAC	ACCATGTCT.CGGTGTTAC
ACCATGTCT.TCGCCAAGC	ACCATGTCT.TCGCCAAGC
ACCATTCAC.AGTTGTGTA	ACCATTCAC.AGTTGTGTA
ACCATTCAC.CTTACCTAG	ACCATTCAC.CTTACCTAG
ACCATTCAC.TCTACATCC	ACCATTCAC.TCTACATCC
ACCATTCAC.TGATGGACA	ACCATTCAC.TGATGGACA
ACCGACGGT.AACACACTC	ACCGACGGT.AACACACTC
ACCGACGGT.AAGTCATGA	ACCGACGGT.AAGTCATGA
ACCGACGGT.CACACCTGT	ACCGACGGT.CACACCTGT
ACCGACGGT.CGACCTGTA	ACCGACGGT.CGACCTGTA
ACCGACGGT.GGAGCTCAA	ACCGACGGT.GGAGCTCAA
ACCGACGGT.TCACTCGCT	ACCGACGGT.TCACTCGCT
ACCGAGACA.AGTAAGCCA	ACCGAGACA.AGTAAGCCA
ACCGAGACA.CCTCCAATC	ACCGAGACA.CCTCCAATC
ACCGAGACA.GCCTGGAAT	ACCGAGACA.GCCTGGAAT
ACCGAGACA.TCCGATAAC	ACCGAGACA.TCCGATAAC
ACCGAGTAG.AGCAACATT	ACCGAGTAG.AGCAACATT
ACCGAGTAG.ATTCCTACG	ACCGAGTAG.ATTCCTACG
ACCGAGTAG.CAGCTTCGA	ACCGAGTAG.CAGCTTCGA
ACCGAGTAG.CCACGTTCT	ACCGAGTAG.CCACGTTCT
ACCGAGTAG.CCAGTTACG	ACCGAGTAG.CCAGTTACG
ACCGAGTAG.CTCATGCCA	ACCGAGTAG.CTCATGCCA
