GTTGCATGG.CTTCACTGT	GTTGCATGG.CTTCACTGT
GTTGCATGG.GAGGTGAGC	GTTGCATGG.GAGGTGAGC
GTTGCATGG.TCGTGCCAC	GTTGCATGG.TCGTGCCAC
GTTGCATGG.TTACCTCTC	GTTGCATGG.TTACCTCTC
GTTGCTCAG.AGGAATTGG	GTTGCTCAG.AGGAATTGG
GTTGCTCAG.AGTCGATCA	GTTGCTCAG.AGTCGATCA
GTTGCTCAG.AGTGATGCG	GTTGCTCAG.AGTGATGCG
GTTGCTCAG.CCAAGTCGA	GTTGCTCAG.CCAAGTCGA
GTTGCTCAG.TGAGCAGAT	GTTGCTCAG.TGAGCAGAT
GTTGCTCAG.TTCCGAGCG	GTTGCTCAG.TTCCGAGCG
TAACACATC.GCGAGCAAG	TAACACATC.GCGAGCAAG
TAACACGAG.AGCTATATG	TAACACGAG.AGCTATATG
TAACACGAG.CCTCGACCT	TAACACGAG.CCTCGACCT
TAACACGAG.GTCACAGAG	TAACACGAG.GTCACAGAG
TAACACGAG.TCCTCGTCG	TAACACGAG.TCCTCGTCG
TAACACGAG.TCGTAGGAA	TAACACGAG.TCGTAGGAA
TAACATTGG.AGAAGTAAC	TAACATTGG.AGAAGTAAC
TAACATTGG.ATAGTGGTT	TAACATTGG.ATAGTGGTT
TAACATTGG.CGAGCTTAC	TAACATTGG.CGAGCTTAC
TAACATTGG.GACCTTGTG	TAACATTGG.GACCTTGTG
TAACATTGG.GACGTCAAT	TAACATTGG.GACGTCAAT
TAACATTGG.GCTTGTCCT	TAACATTGG.GCTTGTCCT
TAACCGTGA.CTGATGCAC	TAACCGTGA.CTGATGCAC
TAACCGTGA.GACTTGATT	TAACCGTGA.GACTTGATT
TAACCGTGA.GTGTACCGT	TAACCGTGA.GTGTACCGT
TAACGGATA.GAACTGCAA	TAACGGATA.GAACTGCAA
TAACGGATA.TGCTATGAA	TAACGGATA.TGCTATGAA
TAACGGATA.TGCTTACGG	TAACGGATA.TGCTTACGG
TAACGTGTC.AAGCAGCAT	TAACGTGTC.AAGCAGCAT
TAACGTGTC.GACTTCACC	TAACGTGTC.GACTTCACC
TAACGTGTC.GTCAATACA	TAACGTGTC.GTCAATACA
TAACGTGTC.TAATCTGGA	TAACGTGTC.TAATCTGGA
TAACGTGTC.TACCGCGTT	TAACGTGTC.TACCGCGTT
TAACGTGTC.TAGGATGCC	TAACGTGTC.TAGGATGCC
TAACTCCGA.GCGCTCTAT	TAACTCCGA.GCGCTCTAT
TAACTCCGA.GCTTGGTTC	TAACTCCGA.GCTTGGTTC
TAACTCCGA.TAGACCGCA	TAACTCCGA.TAGACCGCA
TAACTCCGA.TCCTGTGGA	TAACTCCGA.TCCTGTGGA
TAACTCCGA.TGAACGGTT	TAACTCCGA.TGAACGGTT
TAAGCACTA.CTCTTCAGC	TAAGCACTA.CTCTTCAGC
TAAGCCATT.AACAACCTA	TAAGCCATT.AACAACCTA
TAAGCCATT.ATAGTCAGT	TAAGCCATT.ATAGTCAGT
TAAGCCATT.CTCATGCCA	TAAGCCATT.CTCATGCCA
TAAGCCATT.GCGTAACAA	TAAGCCATT.GCGTAACAA
TAAGGTCCG.ACTGGTCAG	TAAGGTCCG.ACTGGTCAG
TAAGGTCCG.CACTGCTTA	TAAGGTCCG.CACTGCTTA
TAAGGTCCG.CAGCAGTAC	TAAGGTCCG.CAGCAGTAC
TAAGGTCCG.CATCAATAG	TAAGGTCCG.CATCAATAG
TAAGGTCCG.CCGCATCCT	TAAGGTCCG.CCGCATCCT
TAAGGTCCG.GACACGCAA	TAAGGTCCG.GACACGCAA
TAAGGTCCG.GTACCTAAC	TAAGGTCCG.GTACCTAAC
TAAGGTCCG.TTACGGACC	TAAGGTCCG.TTACGGACC
TAAGGTGAT.ACAGAAGAG	TAAGGTGAT.ACAGAAGAG
TAAGGTGAT.ATAGCCTAA	TAAGGTGAT.ATAGCCTAA
TAAGGTGAT.GATTCCTCT	TAAGGTGAT.GATTCCTCT
TAAGGTGAT.TTACTTACG	TAAGGTGAT.TTACTTACG
TAAGTACAC.ATTCATGTG	TAAGTACAC.ATTCATGTG
TAAGTACAC.CATTCAGTT	TAAGTACAC.CATTCAGTT
TAAGTACAC.CTCTAGTAA	TAAGTACAC.CTCTAGTAA
TAAGTGTAG.AATGCCTCA	TAAGTGTAG.AATGCCTCA
TAAGTGTAG.ACTCCGGTT	TAAGTGTAG.ACTCCGGTT
TAAGTGTAG.CTTCCGTGG	TAAGTGTAG.CTTCCGTGG
TAAGTGTAG.GAGAATCAG	TAAGTGTAG.GAGAATCAG
TAAGTGTAG.GCGTCGTCT	TAAGTGTAG.GCGTCGTCT
TAAGTGTAG.GTCTGACGT	TAAGTGTAG.GTCTGACGT
TAAGTGTAG.GTGCTCGGA	TAAGTGTAG.GTGCTCGGA
TAAGTGTAG.GTGTATCTG	TAAGTGTAG.GTGTATCTG
TAAGTGTAG.TATACCACT	TAAGTGTAG.TATACCACT
TAAGTGTAG.TATTACTCG	TAAGTGTAG.TATTACTCG
TAAGTGTAG.TGCCATCTC	TAAGTGTAG.TGCCATCTC
TAATCACGC.CCAATGCCT	TAATCACGC.CCAATGCCT
TAATCACGC.TACCATGTA	TAATCACGC.TACCATGTA
TAATCACGC.TGTCAACCT	TAATCACGC.TGTCAACCT
TAATCTGGA.CACACCACA	TAATCTGGA.CACACCACA
TAATCTGGA.TGCAGTTCA	TAATCTGGA.TGCAGTTCA
TAATGTAGC.AACAATGCA	TAATGTAGC.AACAATGCA
TAATGTAGC.AAGGATCGT	TAATGTAGC.AAGGATCGT
TAATGTAGC.CGTGCAAGG	TAATGTAGC.CGTGCAAGG
TAATGTAGC.GCGAGTCTA	TAATGTAGC.GCGAGTCTA
TAATGTAGC.GTACGAACG	TAATGTAGC.GTACGAACG
TAATGTAGC.TAGCACACG	TAATGTAGC.TAGCACACG
TAATTCGTG.CGGTCGACA	TAATTCGTG.CGGTCGACA
TAATTCGTG.GTAACCATA	TAATTCGTG.GTAACCATA
TAATTCGTG.TAGGTTAGT	TAATTCGTG.TAGGTTAGT
TACAACACC.AGTGATGCG	TACAACACC.AGTGATGCG
TACAACACC.TGATGGACA	TACAACACC.TGATGGACA
TACAACACC.TTACCTCTC	TACAACACC.TTACCTCTC
TACAACACC.TTCGCTGAG	TACAACACC.TTCGCTGAG
TACAAGAGG.CAAGAGAGT	TACAAGAGG.CAAGAGAGT
TACAAGAGG.GAGATACAC	TACAAGAGG.GAGATACAC
TACAAGAGG.GCTAGCTCC	TACAAGAGG.GCTAGCTCC
TACACGGTC.AACTTGTCG	TACACGGTC.AACTTGTCG
TACACGGTC.ACGCGACAG	TACACGGTC.ACGCGACAG
TACACGGTC.AGCGTCGTC	TACACGGTC.AGCGTCGTC
TACACGGTC.AGTTCAACC	TACACGGTC.AGTTCAACC
TACACGGTC.CCGCAATGG	TACACGGTC.CCGCAATGG
TACACGGTC.TCTAGGATG	TACACGGTC.TCTAGGATG
TACAGGACT.CCTCGAGAG	TACAGGACT.CCTCGAGAG
TACAGGACT.CGTTGATCC	TACAGGACT.CGTTGATCC
TACAGGACT.GCGACAACC	TACAGGACT.GCGACAACC
TACAGGACT.TATGTACCT	TACAGGACT.TATGTACCT
TACAGGACT.TGAGAGGAC	TACAGGACT.TGAGAGGAC
TACAGTTAG.AGAGCCGCA	TACAGTTAG.AGAGCCGCA
TACAGTTAG.CCTCGGTCA	TACAGTTAG.CCTCGGTCA
TACAGTTAG.CGACGTGAT	TACAGTTAG.CGACGTGAT
TACAGTTAG.CTGGTGACA	TACAGTTAG.CTGGTGACA
TACAGTTAG.GGTCCTGGT	TACAGTTAG.GGTCCTGGT
TACATGCAC.ACGGTGCCT	TACATGCAC.ACGGTGCCT
TACATGCAC.ATGCGGATT	TACATGCAC.ATGCGGATT
TACATGCAC.TTCCAGATT	TACATGCAC.TTCCAGATT
TACCAGCCA.ACAGAAGAG	TACCAGCCA.ACAGAAGAG
TACCAGCCA.AGAGGTGAA	TACCAGCCA.AGAGGTGAA
TACCAGCCA.CATAAGATC	TACCAGCCA.CATAAGATC
TACCAGCCA.CCGAATATG	TACCAGCCA.CCGAATATG
TACCAGCCA.GCCTTATCT	TACCAGCCA.GCCTTATCT
TACCAGCCA.TCAACACTC	TACCAGCCA.TCAACACTC
TACCATGTA.AGTACTCTC	TACCATGTA.AGTACTCTC
TACCATGTA.ATTGACACG	TACCATGTA.ATTGACACG
TACCGATTG.AGATACGTT	TACCGATTG.AGATACGTT
TACCGATTG.ATCCATTAG	TACCGATTG.ATCCATTAG
TACCGATTG.ATCGAATCG	TACCGATTG.ATCGAATCG
TACCGATTG.CAATGCATT	TACCGATTG.CAATGCATT
TACCGATTG.CTCAGCTGG	TACCGATTG.CTCAGCTGG
TACCGATTG.GGACGAGCA	TACCGATTG.GGACGAGCA
TACCGCGTT.ATTAGCGGT	TACCGCGTT.ATTAGCGGT
TACCGCGTT.CTTAATCGT	TACCGCGTT.CTTAATCGT
TACCGCGTT.GCCTGCATC	TACCGCGTT.GCCTGCATC
TACCGCGTT.TCGTACCTT	TACCGCGTT.TCGTACCTT
TACCTATCC.ATGTCGCCT	TACCTATCC.ATGTCGCCT
TACCTATCC.CGATTCGAG	TACCTATCC.CGATTCGAG
TACCTATCC.GCCACATGG	TACCTATCC.GCCACATGG
TACCTATCC.GTCGTGTTA	TACCTATCC.GTCGTGTTA
TACCTCACT.ATTCGCTTA	TACCTCACT.ATTCGCTTA
TACCTCACT.GAACGCTGT	TACCTCACT.GAACGCTGT
TACCTCACT.GCTTCTACG	TACCTCACT.GCTTCTACG
TACCTCACT.GTATGATCT	TACCTCACT.GTATGATCT
TACCTCACT.GTCTCCAGG	TACCTCACT.GTCTCCAGG
TACCTCACT.GTGCACGAG	TACCTCACT.GTGCACGAG
TACCTCACT.TAAGGTCCG	TACCTCACT.TAAGGTCCG
TACCTCACT.TAGCACTAT	TACCTCACT.TAGCACTAT
TACCTCACT.TATCAGTGC	TACCTCACT.TATCAGTGC
TACCTCACT.TATGGTTGG	TACCTCACT.TATGGTTGG
TACCTCCTC.ATTCGAAGA	TACCTCCTC.ATTCGAAGA
TACCTCCTC.CCGGTGGTT	TACCTCCTC.CCGGTGGTT
TACCTCCTC.GGTCCTGGT	TACCTCCTC.GGTCCTGGT
TACGAACTC.AAGGATACG	TACGAACTC.AAGGATACG
TACGAACTC.CAACGCACA	TACGAACTC.CAACGCACA
TACGAACTC.GTGTCACAC	TACGAACTC.GTGTCACAC
TACGACCAT.ACTTCGCAG	TACGACCAT.ACTTCGCAG
TACGACCAT.AGATATGGA	TACGACCAT.AGATATGGA
TACGACCAT.AGCCGTTCT	TACGACCAT.AGCCGTTCT
TACGACCAT.AGGATTGAG	TACGACCAT.AGGATTGAG
TACGACCAT.AGTCGATCA	TACGACCAT.AGTCGATCA
TACGACCAT.CGATTGAAC	TACGACCAT.CGATTGAAC
TACGACCAT.CGCAGTGTC	TACGACCAT.CGCAGTGTC
TACGACCAT.GTCAAGATC	TACGACCAT.GTCAAGATC
TACGACCAT.TGCGTGCCA	TACGACCAT.TGCGTGCCA
TACGACTTG.AGATACGTT	TACGACTTG.AGATACGTT
TACGACTTG.CATAGGTGT	TACGACTTG.CATAGGTGT
TACGACTTG.GATAAGCTG	TACGACTTG.GATAAGCTG
TACGAGTGA.AGGAGCAAT	TACGAGTGA.AGGAGCAAT
TACGAGTGA.ATCACTTCC	TACGAGTGA.ATCACTTCC
TACGAGTGA.CATAGAGAT	TACGAGTGA.CATAGAGAT
TACGAGTGA.CCACGCCAT	TACGAGTGA.CCACGCCAT
TACGAGTGA.CTCATTAGT	TACGAGTGA.CTCATTAGT
TACGAGTGA.GATAGTTCT	TACGAGTGA.GATAGTTCT
TACGAGTGA.GGATGCGAA	TACGAGTGA.GGATGCGAA
TACGGTCGT.AAGCTGGTC	TACGGTCGT.AAGCTGGTC
TACGGTCGT.ACCACGCTA	TACGGTCGT.ACCACGCTA
TACGGTCGT.CCTATTGGT	TACGGTCGT.CCTATTGGT
TACGGTCGT.CCTCAGGTG	TACGGTCGT.CCTCAGGTG
TACGGTCGT.CTTACATGC	TACGGTCGT.CTTACATGC
TACGGTCGT.GAAGTGTGA	TACGGTCGT.GAAGTGTGA
TACGGTCGT.TAATTCGTG	TACGGTCGT.TAATTCGTG
TACGGTCGT.TAGGATTAG	TACGGTCGT.TAGGATTAG
TACGGTCGT.TGATTCACC	TACGGTCGT.TGATTCACC
TACGTTACC.GACATATGT	TACGTTACC.GACATATGT
TACGTTACC.GGTAATCTA	TACGTTACC.GGTAATCTA
TACGTTGGA.ACACACCGT	TACGTTGGA.ACACACCGT
TACGTTGGA.AGAAGTCCT	TACGTTGGA.AGAAGTCCT
TACGTTGGA.AGGAATTGG	TACGTTGGA.AGGAATTGG
TACGTTGGA.CAGGATCAA	TACGTTGGA.CAGGATCAA
TACGTTGGA.CGTGTCCGA	TACGTTGGA.CGTGTCCGA
TACGTTGGA.GCCACATGG	TACGTTGGA.GCCACATGG
TACGTTGGA.TGTGAGTAT	TACGTTGGA.TGTGAGTAT
TACTACTGT.AGAGGACGT	TACTACTGT.AGAGGACGT
TACTAGTAG.TCGCTGATT	TACTAGTAG.TCGCTGATT
TACTAGTAG.TGCGTAATC	TACTAGTAG.TGCGTAATC
TACTAGTAG.TGTGGTCCT	TACTAGTAG.TGTGGTCCT
TACTCGACC.CTTGTAACG	TACTCGACC.CTTGTAACG
TACTCGACC.GCGCTAGAA	TACTCGACC.GCGCTAGAA
TACTCGACC.GCTTCTACG	TACTCGACC.GCTTCTACG
TACTCGACC.TTCCATACC	TACTCGACC.TTCCATACC
TACTCGCTG.CTAGTTCCA	TACTCGCTG.CTAGTTCCA
TACTCGCTG.GAATCACAT	TACTCGCTG.GAATCACAT
TACTGATGA.AAGCCAAGT	TACTGATGA.AAGCCAAGT
TACTGATGA.CGACCACTT	TACTGATGA.CGACCACTT
TACTGATGA.GTCTCTTCA	TACTGATGA.GTCTCTTCA
TACTGATGA.GTTCAGAAG	TACTGATGA.GTTCAGAAG
TACTGATGA.TGATTGCTG	TACTGATGA.TGATTGCTG
TACTTACCA.CTTGCACAA	TACTTACCA.CTTGCACAA
TACTTCCAG.ATAGACCGA	TACTTCCAG.ATAGACCGA
TACTTCCAG.GAGAATCAG	TACTTCCAG.GAGAATCAG
TAGACACGT.AGACCAGCT	TAGACACGT.AGACCAGCT
TAGACACGT.GGAACCTAG	TAGACACGT.GGAACCTAG
TAGACCATG.CCAGTTACG	TAGACCATG.CCAGTTACG
TAGACCATG.GCGCTCTAT	TAGACCATG.GCGCTCTAT
TAGACCATG.GTCAAGATC	TAGACCATG.GTCAAGATC
TAGACCATG.TCCTCGTCG	TAGACCATG.TCCTCGTCG
TAGACCATG.TGTCAACCT	TAGACCATG.TGTCAACCT
TAGACCGCA.ACCTAGTTA	TAGACCGCA.ACCTAGTTA
TAGACCGCA.ACTCTAGGA	TAGACCGCA.ACTCTAGGA
TAGACCGCA.ATTCACCTC	TAGACCGCA.ATTCACCTC
TAGACCGCA.CCACCATGC	TAGACCGCA.CCACCATGC
TAGACCGCA.CCTTATCCG	TAGACCGCA.CCTTATCCG
TAGACCGCA.CGACCTGTA	TAGACCGCA.CGACCTGTA
TAGACCGCA.GCACAACTC	TAGACCGCA.GCACAACTC
TAGACCGCA.TATGAAGAC	TAGACCGCA.TATGAAGAC
TAGACCTAC.AATCGTGTT	TAGACCTAC.AATCGTGTT
TAGACCTAC.AGAAGTAAC	TAGACCTAC.AGAAGTAAC
TAGAGACTA.ACTTCTTGG	TAGAGACTA.ACTTCTTGG
TAGAGACTA.CGCAACCTC	TAGAGACTA.CGCAACCTC
TAGAGACTA.GCCGTGAAC	TAGAGACTA.GCCGTGAAC
TAGAGACTA.GTGAATGCC	TAGAGACTA.GTGAATGCC
TAGAGACTA.GTGTTCCAG	TAGAGACTA.GTGTTCCAG
TAGAGACTA.TGTGTAGAG	TAGAGACTA.TGTGTAGAG
TAGAGACTA.TTACTAGTC	TAGAGACTA.TTACTAGTC
TAGAGCCAG.CAAGGTGTG	TAGAGCCAG.CAAGGTGTG
TAGAGCCAG.CCAATATAC	TAGAGCCAG.CCAATATAC
TAGAGCCAG.GTTAGTCAA	TAGAGCCAG.GTTAGTCAA
TAGAGCCAG.TAGACACGT	TAGAGCCAG.TAGACACGT
TAGAGCGTC.AAGCTTGCA	TAGAGCGTC.AAGCTTGCA
TAGAGCGTC.TAGGATTAG	TAGAGCGTC.TAGGATTAG
TAGAGCGTC.TTCCAGGAG	TAGAGCGTC.TTCCAGGAG
TAGATAGCC.AGAGGTGAA	TAGATAGCC.AGAGGTGAA
TAGATAGCC.AGCACCGTG	TAGATAGCC.AGCACCGTG
TAGATAGCC.CCAATATAC	TAGATAGCC.CCAATATAC
TAGATAGCC.CCTGCGTTA	TAGATAGCC.CCTGCGTTA
TAGATAGCC.CTGCGTCAC	TAGATAGCC.CTGCGTCAC
TAGATAGCC.GAGTATCGC	TAGATAGCC.GAGTATCGC
TAGATAGCC.TACGTTGGA	TAGATAGCC.TACGTTGGA
TAGATAGCC.TAGTACGTA	TAGATAGCC.TAGTACGTA
TAGATAGCC.TCCAATCAT	TAGATAGCC.TCCAATCAT
TAGATAGCC.TCTAGCTGG	TAGATAGCC.TCTAGCTGG
TAGATAGCC.TGTGGTCCT	TAGATAGCC.TGTGGTCCT
TAGATCTGT.CCGGTTGAG	TAGATCTGT.CCGGTTGAG
TAGATCTGT.GGTTCTATC	TAGATCTGT.GGTTCTATC
TAGATCTGT.GTATCCTGC	TAGATCTGT.GTATCCTGC
TAGCACACG.ATCAGGATG	TAGCACACG.ATCAGGATG
TAGCACACG.CACTCACTA	TAGCACACG.CACTCACTA
TAGCACACG.CCTGCGTTA	TAGCACACG.CCTGCGTTA
TAGCACTAT.AATCTCCTA	TAGCACTAT.AATCTCCTA
TAGCACTAT.CAACCGGTC	TAGCACTAT.CAACCGGTC
TAGCACTAT.CACCTCAAC	TAGCACTAT.CACCTCAAC
TAGCACTAT.TATACGGAT	TAGCACTAT.TATACGGAT
TAGCAGAGT.CAACACTCC	TAGCAGAGT.CAACACTCC
TAGCAGAGT.TTACGCTCG	TAGCAGAGT.TTACGCTCG
TAGCCAGTG.ATTGCCGAC	TAGCCAGTG.ATTGCCGAC
TAGCCAGTG.CACTACAGG	TAGCCAGTG.CACTACAGG
TAGCCAGTG.GCTAGCTCC	TAGCCAGTG.GCTAGCTCC
TAGCCAGTG.TACGTTACC	TAGCCAGTG.TACGTTACC
TAGCCTTGT.CATACAACC	TAGCCTTGT.CATACAACC
TAGCCTTGT.GACCGGTAG	TAGCCTTGT.GACCGGTAG
TAGCGAGAA.AGTCAGTTG	TAGCGAGAA.AGTCAGTTG
TAGCGAGAA.ATTAGCCAC	TAGCGAGAA.ATTAGCCAC
TAGCGAGAA.CCTCGACCT	TAGCGAGAA.CCTCGACCT
TAGCGAGAA.CGTTACACC	TAGCGAGAA.CGTTACACC
TAGCGAGAA.GACTGCGCA	TAGCGAGAA.GACTGCGCA
TAGCGAGAA.TACCGATTG	TAGCGAGAA.TACCGATTG
TAGCGCAGC.AGACATCCA	TAGCGCAGC.AGACATCCA
TAGCGCAGC.CAATGCATT	TAGCGCAGC.CAATGCATT
TAGCGCAGC.CAGATCGAC	TAGCGCAGC.CAGATCGAC
TAGCGCAGC.TGGTCGCTA	TAGCGCAGC.TGGTCGCTA
TAGCTAAGA.ACTCGAGTC	TAGCTAAGA.ACTCGAGTC
TAGCTAAGA.CATTGCAGA	TAGCTAAGA.CATTGCAGA
TAGCTAAGA.TAAGTGTAG	TAGCTAAGA.TAAGTGTAG
TAGCTGTTG.ACTCCTGAG	TAGCTGTTG.ACTCCTGAG
TAGCTGTTG.ACTGGTGCT	TAGCTGTTG.ACTGGTGCT
TAGCTGTTG.CGCACTGAA	TAGCTGTTG.CGCACTGAA
TAGCTGTTG.GGTCCTAAG	TAGCTGTTG.GGTCCTAAG
TAGCTGTTG.TAACACGAG	TAGCTGTTG.TAACACGAG
TAGCTGTTG.TAAGTGTAG	TAGCTGTTG.TAAGTGTAG
TAGCTGTTG.TTAGGAAGG	TAGCTGTTG.TTAGGAAGG
TAGCTGTTG.TTCCAATTC	TAGCTGTTG.TTCCAATTC
TAGGAGCTA.AGCAGACAA	TAGGAGCTA.AGCAGACAA
TAGGAGCTA.CAGTTACTG	TAGGAGCTA.CAGTTACTG
TAGGAGCTA.CGACAGACC	TAGGAGCTA.CGACAGACC
TAGGAGCTA.GTGGATAAG	TAGGAGCTA.GTGGATAAG
TAGGAGGAT.ACCTTGAAG	TAGGAGGAT.ACCTTGAAG
TAGGAGGAT.CCACACAGA	TAGGAGGAT.CCACACAGA
TAGGAGGAT.CTTCCTGAT	TAGGAGGAT.CTTCCTGAT
TAGGATGCC.AGAGGACGT	TAGGATGCC.AGAGGACGT
TAGGATGCC.AGTTACAAG	TAGGATGCC.AGTTACAAG
TAGGATGCC.CAGATCATT	TAGGATGCC.CAGATCATT
TAGGATGCC.TAGATCTGT	TAGGATGCC.TAGATCTGT
TAGGATGCC.TGCCACCGA	TAGGATGCC.TGCCACCGA
TAGGATTAG.AGGTGTACA	TAGGATTAG.AGGTGTACA
TAGGATTAG.CATAGGTGT	TAGGATTAG.CATAGGTGT
TAGGATTAG.GCGACCTGT	TAGGATTAG.GCGACCTGT
TAGGTCAAC.ACCGAGTAG	TAGGTCAAC.ACCGAGTAG
TAGGTTAGT.AACGCCTAC	TAGGTTAGT.AACGCCTAC
TAGGTTAGT.AAGCTGGTC	TAGGTTAGT.AAGCTGGTC
TAGGTTAGT.CCACTACCA	TAGGTTAGT.CCACTACCA
TAGGTTAGT.CCATAGCCA	TAGGTTAGT.CCATAGCCA
TAGGTTAGT.TACCGCGTT	TAGGTTAGT.TACCGCGTT
TAGGTTAGT.TATTACTCG	TAGGTTAGT.TATTACTCG
TAGTAACGG.AACAACCTA	TAGTAACGG.AACAACCTA
TAGTAACGG.CAGGTTGTC	TAGTAACGG.CAGGTTGTC
TAGTAACGG.GATGTTACA	TAGTAACGG.GATGTTACA
TAGTAACGG.GGTACTTCC	TAGTAACGG.GGTACTTCC
TAGTAACGG.TTAGCGTCT	TAGTAACGG.TTAGCGTCT
TAGTAACGG.TTGCGAACA	TAGTAACGG.TTGCGAACA
TAGTAACGG.TTGGTAACT	TAGTAACGG.TTGGTAACT
TAGTACGTA.AAGCTGAGG	TAGTACGTA.AAGCTGAGG
TAGTACGTA.TAGTCAGAC	TAGTACGTA.TAGTCAGAC
TAGTAGTCT.ACTCGCTGT	TAGTAGTCT.ACTCGCTGT
TAGTAGTCT.CTGGTCGGT	TAGTAGTCT.CTGGTCGGT
TAGTAGTCT.CTTGATCTA	TAGTAGTCT.CTTGATCTA
TAGTAGTCT.GCGTATAGG	TAGTAGTCT.GCGTATAGG
TAGTAGTCT.GGTAAGGAT	TAGTAGTCT.GGTAAGGAT
TAGTAGTCT.TTCCTTGAC	TAGTAGTCT.TTCCTTGAC
TAGTCAGAC.ACGCTAGTG	TAGTCAGAC.ACGCTAGTG
TAGTCAGAC.AGATGAAGA	TAGTCAGAC.AGATGAAGA
TAGTCAGAC.CAGCGTAAG	TAGTCAGAC.CAGCGTAAG
TAGTCAGAC.CAGCTTCGA	TAGTCAGAC.CAGCTTCGA
TAGTCAGAC.GTGTACCGT	TAGTCAGAC.GTGTACCGT
TAGTCAGAC.TCAAGCGTA	TAGTCAGAC.TCAAGCGTA
TAGTCGCAT.AGACGCTAT	TAGTCGCAT.AGACGCTAT
TAGTCGCAT.CAAGTACGA	TAGTCGCAT.CAAGTACGA
TAGTCGCAT.GGATGCTCG	TAGTCGCAT.GGATGCTCG
TAGTCGCAT.TGACGATGA	TAGTCGCAT.TGACGATGA
TAGTGATCC.ACTCGCTGT	TAGTGATCC.ACTCGCTGT
TAGTGATCC.CGGAAGACG	TAGTGATCC.CGGAAGACG
TAGTGATCC.GCGTAACAA	TAGTGATCC.GCGTAACAA
TAGTGCACT.CATCCTCTC	TAGTGCACT.CATCCTCTC
TAGTGCACT.TGCGTAATC	TAGTGCACT.TGCGTAATC
TAGTTGACG.ACGACTGCG	TAGTTGACG.ACGACTGCG
TAGTTGACG.ATTAAGACC	TAGTTGACG.ATTAAGACC
TAGTTGACG.TGTCGTGAG	TAGTTGACG.TGTCGTGAG
TATAATCGC.AAGCAATCG	TATAATCGC.AAGCAATCG
TATAATCGC.AATGCTATC	TATAATCGC.AATGCTATC
TATAATCGC.CGTCATGGA	TATAATCGC.CGTCATGGA
TATAATCGC.TGTTACTGA	TATAATCGC.TGTTACTGA
TATAATCGC.TTGGACTTC	TATAATCGC.TTGGACTTC
TATACCACT.AGTGAGAGA	TATACCACT.AGTGAGAGA
TATACCACT.ATAAGTTCG	TATACCACT.ATAAGTTCG
TATACCACT.ATCGCCTCT	TATACCACT.ATCGCCTCT
TATACCACT.CGAGTAGCA	TATACCACT.CGAGTAGCA
TATACCACT.TCTCAGGAT	TATACCACT.TCTCAGGAT
TATACCACT.TTCATTCGC	TATACCACT.TTCATTCGC
TATACGGAT.CCTCCTTGT	TATACGGAT.CCTCCTTGT
TATACGGAT.GATACACTA	TATACGGAT.GATACACTA
TATACGGAT.GCACGCATT	TATACGGAT.GCACGCATT
TATACGTGG.ACGTCGCTC	TATACGTGG.ACGTCGCTC
TATACGTGG.ACTCCAACT	TATACGTGG.ACTCCAACT
TATACGTGG.ATACTTGCT	TATACGTGG.ATACTTGCT
TATACGTGG.GGTCGGATA	TATACGTGG.GGTCGGATA
TATAGTGCG.ATCCAATGA	TATAGTGCG.ATCCAATGA
TATAGTGCG.ATGGAGGAA	TATAGTGCG.ATGGAGGAA
TATAGTGCG.CGTCGTCAA	TATAGTGCG.CGTCGTCAA
TATAGTGCG.GGAAGTATG	TATAGTGCG.GGAAGTATG
TATCACCTG.CGACGTGAT	TATCACCTG.CGACGTGAT
TATCACCTG.GATCGATAC	TATCACCTG.GATCGATAC
TATCACCTG.TATGTATGC	TATCACCTG.TATGTATGC
TATCACCTG.TCCGTATAC	TATCACCTG.TCCGTATAC
TATCAGTGC.AGCGTAGAA	TATCAGTGC.AGCGTAGAA
TATCAGTGC.CCGCAACAC	TATCAGTGC.CCGCAACAC
TATCATGCT.ATGAGCAGG	TATCATGCT.ATGAGCAGG
TATCATGCT.GCGATGGTG	TATCATGCT.GCGATGGTG
TATCCTCAG.CCTCGGTCA	TATCCTCAG.CCTCGGTCA
TATCGAGCC.ATACCGCTT	TATCGAGCC.ATACCGCTT
TATCGAGCC.ATGATAGCT	TATCGAGCC.ATGATAGCT
TATCGAGCC.GTTAGATTG	TATCGAGCC.GTTAGATTG
TATCGAGCC.TCGTAATAG	TATCGAGCC.TCGTAATAG
TATCGAGCC.TTACTTACG	TATCGAGCC.TTACTTACG
TATCGGAAC.AAGCTGGTC	TATCGGAAC.AAGCTGGTC
TATCGGAAC.ATCTGGTAG	TATCGGAAC.ATCTGGTAG
TATCGGAAC.CCGAAGCGT	TATCGGAAC.CCGAAGCGT
TATCGGAAC.GTGTTGGAA	TATCGGAAC.GTGTTGGAA
TATCGGAAC.TCCAAGTAA	TATCGGAAC.TCCAAGTAA
TATCTAGGT.CCAGATCAC	TATCTAGGT.CCAGATCAC
TATCTAGGT.CCGGTGGTT	TATCTAGGT.CCGGTGGTT
TATCTAGGT.GAACGCTGT	TATCTAGGT.GAACGCTGT
TATCTAGGT.GCTCTCCAA	TATCTAGGT.GCTCTCCAA
TATCTAGGT.GTAGGACGC	TATCTAGGT.GTAGGACGC
TATCTAGGT.TAGCGAGAA	TATCTAGGT.TAGCGAGAA
TATCTAGGT.TTCCTCGGT	TATCTAGGT.TTCCTCGGT
TATCTGTCA.AAGCCACAC	TATCTGTCA.AAGCCACAC
TATCTGTCA.ACTCTAGGA	TATCTGTCA.ACTCTAGGA
TATCTGTCA.CCACGTTCT	TATCTGTCA.CCACGTTCT
TATCTGTCA.GATCGATAC	TATCTGTCA.GATCGATAC
TATCTGTCA.GCAGATCCG	TATCTGTCA.GCAGATCCG
TATCTGTCA.GCGTCGTCT	TATCTGTCA.GCGTCGTCT
TATCTGTCA.TACATGCAC	TATCTGTCA.TACATGCAC
TATGAAGAC.AGAAGTAAC	TATGAAGAC.AGAAGTAAC
TATGAAGAC.CACAACGCT	TATGAAGAC.CACAACGCT
TATGACCGA.ATAGTCAGT	TATGACCGA.ATAGTCAGT
TATGACCGA.CATCTCACG	TATGACCGA.CATCTCACG
TATGACCGA.CTGGAGCGA	TATGACCGA.CTGGAGCGA
TATGACCGA.GTAACTCAT	TATGACCGA.GTAACTCAT
TATGAGACC.CCTGCAGAT	TATGAGACC.CCTGCAGAT
TATGAGACC.CGTACACAC	TATGAGACC.CGTACACAC
TATGATGTG.CGACAGACC	TATGATGTG.CGACAGACC
TATGATGTG.TGGAATCGT	TATGATGTG.TGGAATCGT
TATGATGTG.TGGAGAGTG	TATGATGTG.TGGAGAGTG
TATGCCTTC.TCGCCAAGC	TATGCCTTC.TCGCCAAGC
TATGCCTTC.TCTCGTATC	TATGCCTTC.TCTCGTATC
TATGGTTGG.ACTAAGTTC	TATGGTTGG.ACTAAGTTC
TATGGTTGG.AGCATTCCA	TATGGTTGG.AGCATTCCA
TATGGTTGG.ATTGATCAC	TATGGTTGG.ATTGATCAC
TATGGTTGG.CGCTTCACG	TATGGTTGG.CGCTTCACG
TATGGTTGG.TCCGTATAC	TATGGTTGG.TCCGTATAC
TATGTACCT.AGTTGTGTA	TATGTACCT.AGTTGTGTA
TATGTACCT.CGAAGAGGT	TATGTACCT.CGAAGAGGT
TATGTACCT.CGCTTCACG	TATGTACCT.CGCTTCACG
TATGTACCT.GACGCCGTA	TATGTACCT.GACGCCGTA
TATGTACCT.TCCGTATAC	TATGTACCT.TCCGTATAC
TATGTATGC.TCAGCGACC	TATGTATGC.TCAGCGACC
TATGTATGC.TCCAAGTAA	TATGTATGC.TCCAAGTAA
TATGTATGC.TGGTAGCAG	TATGTATGC.TGGTAGCAG
TATTACAGC.AAGCACAAC	TATTACAGC.AAGCACAAC
TATTACAGC.AATATCGCT	TATTACAGC.AATATCGCT
TATTACAGC.ATACAACCG	TATTACAGC.ATACAACCG
TATTACAGC.ATCGAATCG	TATTACAGC.ATCGAATCG
TATTACAGC.ATGAGTGTG	TATTACAGC.ATGAGTGTG
TATTACAGC.CAAGTCGAA	TATTACAGC.CAAGTCGAA
TATTACAGC.CACAGCGAA	TATTACAGC.CACAGCGAA
TATTACAGC.CGCCATTAC	TATTACAGC.CGCCATTAC
TATTACAGC.CTAGAGTCG	TATTACAGC.CTAGAGTCG
TATTACAGC.CTTCCTGAT	TATTACAGC.CTTCCTGAT
TATTACAGC.GATGCTCCT	TATTACAGC.GATGCTCCT
TATTACAGC.GCTTCTGAA	TATTACAGC.GCTTCTGAA
TATTACAGC.GTCGTTAGA	TATTACAGC.GTCGTTAGA
TATTACAGC.GTTGACGTG	TATTACAGC.GTTGACGTG
TATTACAGC.TATACGTGG	TATTACAGC.TATACGTGG
TATTACAGC.TCACATACT	TATTACAGC.TCACATACT
TATTCAACG.ACGTACTGC	TATTCAACG.ACGTACTGC
TATTCAACG.AGCGTAGAA	TATTCAACG.AGCGTAGAA
TATTCAACG.AGGAGGTGA	TATTCAACG.AGGAGGTGA
TATTCAACG.CATAAGATC	TATTCAACG.CATAAGATC
TATTCAACG.CCAGATCAC	TATTCAACG.CCAGATCAC
TATTCAACG.CGTGCCTAT	TATTCAACG.CGTGCCTAT
TATTCAACG.GACAATGTT	TATTCAACG.GACAATGTT
TATTCAACG.GACCGCTTC	TATTCAACG.GACCGCTTC
TATTCAACG.GGTAAGGAT	TATTCAACG.GGTAAGGAT
TATTCAACG.GTAAGGTCC	TATTCAACG.GTAAGGTCC
TATTCAACG.GTCAACTGA	TATTCAACG.GTCAACTGA
TATTGACTG.TTGCTCTGC	TATTGACTG.TTGCTCTGC
TATTGCTAC.CCATCACGA	TATTGCTAC.CCATCACGA
TATTGCTAC.TCGCCAAGC	TATTGCTAC.TCGCCAAGC
TCAACACTC.ACGTCGCTC	TCAACACTC.ACGTCGCTC
TCAACACTC.ATGAACTAG	TCAACACTC.ATGAACTAG
TCAACACTC.ATGCCTTCA	TCAACACTC.ATGCCTTCA
TCAACACTC.CCTCCAATC	TCAACACTC.CCTCCAATC
TCAAGCGTA.ACTCCGGTT	TCAAGCGTA.ACTCCGGTT
TCAAGCGTA.ACTTCAGTA	TCAAGCGTA.ACTTCAGTA
TCAAGCGTA.AGCCTCTAG	TCAAGCGTA.AGCCTCTAG
TCAAGCGTA.AGGATGCGT	TCAAGCGTA.AGGATGCGT
TCAAGCGTA.CGCAGTGTC	TCAAGCGTA.CGCAGTGTC
TCAAGCGTA.GCAATCACG	TCAAGCGTA.GCAATCACG
TCAAGCGTA.TCCACGTGC	TCAAGCGTA.TCCACGTGC
TCAAGCGTA.TTCCGAGCG	TCAAGCGTA.TTCCGAGCG
TCAAGGAGT.CAATGTGCT	TCAAGGAGT.CAATGTGCT
TCAAGGAGT.CCATAATCG	TCAAGGAGT.CCATAATCG
TCAAGGAGT.GAACATGAC	TCAAGGAGT.GAACATGAC
TCAAGGAGT.GAGATGTAT	TCAAGGAGT.GAGATGTAT
TCAAGGAGT.GCCACGAGT	TCAAGGAGT.GCCACGAGT
TCAAGGAGT.TACCATGTA	TCAAGGAGT.TACCATGTA
TCAAGGTCG.ATCTACATC	TCAAGGTCG.ATCTACATC
TCAAGGTCG.ATGCTTCAG	TCAAGGTCG.ATGCTTCAG
TCAATCTAG.ACACACGTC	TCAATCTAG.ACACACGTC
TCAATCTAG.CAAGTCGAA	TCAATCTAG.CAAGTCGAA
TCAATCTAG.CATCAATAG	TCAATCTAG.CATCAATAG
TCAATCTAG.CCGGTTGAG	TCAATCTAG.CCGGTTGAG
TCAATCTAG.GTAGGACGC	TCAATCTAG.GTAGGACGC
TCAATCTAG.TGCGACGTT	TCAATCTAG.TGCGACGTT
TCAATGGAC.ATGTGACGA	TCAATGGAC.ATGTGACGA
TCAATGGAC.CTAGTTCCA	TCAATGGAC.CTAGTTCCA
TCAATGGAC.CTGATCAAG	TCAATGGAC.CTGATCAAG
TCAATGGAC.CTGGTACAT	TCAATGGAC.CTGGTACAT
TCAATGGAC.GGATCAGGT	TCAATGGAC.GGATCAGGT
TCAATGGAC.GGTAGACAT	TCAATGGAC.GGTAGACAT
TCAATGGAC.TGTCTACAC	TCAATGGAC.TGTCTACAC
TCACACTGC.ATGGAGAGT	TCACACTGC.ATGGAGAGT
TCACACTGC.CTTGGATCA	TCACACTGC.CTTGGATCA
TCACACTGC.GAATCGAGA	TCACACTGC.GAATCGAGA
TCACAGGTA.ACGCAAGAT	TCACAGGTA.ACGCAAGAT
TCACAGGTA.CCGATCTCT	TCACAGGTA.CCGATCTCT
TCACAGGTA.CTCGACGAT	TCACAGGTA.CTCGACGAT
TCACAGGTA.TTCTCCACA	TCACAGGTA.TTCTCCACA
TCACATACT.AATACTCCG	TCACATACT.AATACTCCG
TCACATACT.AGCCGGATC	TCACATACT.AGCCGGATC
TCACATACT.GACGCTTGC	TCACATACT.GACGCTTGC
TCACATACT.GTGTTCCAG	TCACATACT.GTGTTCCAG
TCACATACT.TAGGATGCC	TCACATACT.TAGGATGCC
TCACATACT.TCGGTATCA	TCACATACT.TCGGTATCA
TCACATACT.TCGTCATTC	TCACATACT.TCGTCATTC
TCACATACT.TTGATGCTG	TCACATACT.TTGATGCTG
TCACCGAGG.CCATAATCG	TCACCGAGG.CCATAATCG
TCACCGAGG.TCTAGGATG	TCACCGAGG.TCTAGGATG
