ATGCTTCAG.ATTAGCGGT	ATGCTTCAG.ATTAGCGGT
ATGCTTCAG.CTGCTGCTT	ATGCTTCAG.CTGCTGCTT
ATGCTTCAG.GAATCACAT	ATGCTTCAG.GAATCACAT
ATGCTTCAG.GCGCTTCTC	ATGCTTCAG.GCGCTTCTC
ATGCTTCAG.GTGCGAGTA	ATGCTTCAG.GTGCGAGTA
ATGCTTCAG.TACATGCAC	ATGCTTCAG.TACATGCAC
ATGCTTCAG.TCTCATCGG	ATGCTTCAG.TCTCATCGG
ATGGACGTT.AGCATTCCA	ATGGACGTT.AGCATTCCA
ATGGACGTT.CTTGGATCA	ATGGACGTT.CTTGGATCA
ATGGACGTT.GATATATCC	ATGGACGTT.GATATATCC
ATGGACGTT.TATTGACTG	ATGGACGTT.TATTGACTG
ATGGACGTT.TCCAACGTG	ATGGACGTT.TCCAACGTG
ATGGACGTT.TTCATTCGC	ATGGACGTT.TTCATTCGC
ATGGAGAGT.CACACCACA	ATGGAGAGT.CACACCACA
ATGGAGAGT.CGATTCGAG	ATGGAGAGT.CGATTCGAG
ATGGAGAGT.GCTAGTGGA	ATGGAGAGT.GCTAGTGGA
ATGGAGGAA.ATGCTTCAG	ATGGAGGAA.ATGCTTCAG
ATGGAGGAA.GATTGAGTA	ATGGAGGAA.GATTGAGTA
ATGGAGGAA.TGACAAGTT	ATGGAGGAA.TGACAAGTT
ATGGATATC.AGCTTGGTG	ATGGATATC.AGCTTGGTG
ATGGATATC.ATTAGCACA	ATGGATATC.ATTAGCACA
ATGGATATC.TAAGCACTA	ATGGATATC.TAAGCACTA
ATGGATATC.TCTCCGCGT	ATGGATATC.TCTCCGCGT
ATGGATATC.TTCACCTTG	ATGGATATC.TTCACCTTG
ATGGTTCGA.GATCGATAC	ATGGTTCGA.GATCGATAC
ATGGTTCGA.GTAGAAGTT	ATGGTTCGA.GTAGAAGTT
ATGGTTCGA.GTGCACGAG	ATGGTTCGA.GTGCACGAG
ATGGTTCGA.TGCAGATGC	ATGGTTCGA.TGCAGATGC
ATGTCCTCC.ACCGAGTAG	ATGTCCTCC.ACCGAGTAG
ATGTCCTCC.ACGACGATT	ATGTCCTCC.ACGACGATT
ATGTCCTCC.CGGAATGCA	ATGTCCTCC.CGGAATGCA
ATGTCCTCC.GGTACTTCC	ATGTCCTCC.GGTACTTCC
ATGTCCTCC.GTATTACTG	ATGTCCTCC.GTATTACTG
ATGTCGCCT.ACTTCTTGG	ATGTCGCCT.ACTTCTTGG
ATGTCGCCT.ATGCGCTAC	ATGTCGCCT.ATGCGCTAC
ATGTCGCCT.CCACTACCA	ATGTCGCCT.CCACTACCA
ATGTCGCCT.CGGTCGACA	ATGTCGCCT.CGGTCGACA
ATGTCGCCT.CTCCGCATT	ATGTCGCCT.CTCCGCATT
ATGTCGCCT.GAGCCGTTA	ATGTCGCCT.GAGCCGTTA
ATGTCGCCT.GCTCTCCAA	ATGTCGCCT.GCTCTCCAA
ATGTCGCCT.GTATCGTCG	ATGTCGCCT.GTATCGTCG
ATGTCGCCT.GTTAGTCAA	ATGTCGCCT.GTTAGTCAA
ATGTCGCCT.TACCTCCTC	ATGTCGCCT.TACCTCCTC
ATGTCGCCT.TATCTAGGT	ATGTCGCCT.TATCTAGGT
ATGTCGCCT.TCACTACGT	ATGTCGCCT.TCACTACGT
ATGTGACGA.CAGTAATGT	ATGTGACGA.CAGTAATGT
ATGTGACGA.GCTAGTGGA	ATGTGACGA.GCTAGTGGA
ATGTGACGA.GGTAGTGTT	ATGTGACGA.GGTAGTGTT
ATGTGACGA.TAACGTGTC	ATGTGACGA.TAACGTGTC
ATGTGACGA.TATGGTTGG	ATGTGACGA.TATGGTTGG
ATGTGAGAC.CCTAGTCTC	ATGTGAGAC.CCTAGTCTC
ATGTGAGAC.CGTGTGTGG	ATGTGAGAC.CGTGTGTGG
ATGTGAGAC.CTTAAGTTG	ATGTGAGAC.CTTAAGTTG
ATGTGAGAC.TTAGGAAGG	ATGTGAGAC.TTAGGAAGG
ATTAAGACC.GATCGATAC	ATTAAGACC.GATCGATAC
ATTAAGACC.GGAACTGCT	ATTAAGACC.GGAACTGCT
ATTAAGACC.TAGCGAGAA	ATTAAGACC.TAGCGAGAA
ATTAAGACC.TGAACCAAT	ATTAAGACC.TGAACCAAT
ATTAGCACA.ATCACTTCC	ATTAGCACA.ATCACTTCC
ATTAGCACA.TACGAGTGA	ATTAGCACA.TACGAGTGA
ATTAGCCAC.CCAAGTCGA	ATTAGCCAC.CCAAGTCGA
ATTAGCCAC.GTCTTCTCG	ATTAGCCAC.GTCTTCTCG
ATTAGCCAC.TCCTTCGTA	ATTAGCCAC.TCCTTCGTA
ATTAGCCAC.TCTGCGCTG	ATTAGCCAC.TCTGCGCTG
ATTAGCCAC.TTATTCGAC	ATTAGCCAC.TTATTCGAC
ATTAGCGGT.CCGCACTCA	ATTAGCGGT.CCGCACTCA
ATTAGCGGT.CGATCCAGA	ATTAGCGGT.CGATCCAGA
ATTAGCGGT.GGTCGGTCT	ATTAGCGGT.GGTCGGTCT
ATTATGCAG.ACTAAGTTC	ATTATGCAG.ACTAAGTTC
ATTATGCAG.GAGAATCAG	ATTATGCAG.GAGAATCAG
ATTATGCAG.TAACATTGG	ATTATGCAG.TAACATTGG
ATTATGCAG.TCGCATTCG	ATTATGCAG.TCGCATTCG
ATTCACCTC.AGCTTCGAT	ATTCACCTC.AGCTTCGAT
ATTCACCTC.GGATGCGAA	ATTCACCTC.GGATGCGAA
ATTCACCTC.GGATTCGTC	ATTCACCTC.GGATTCGTC
ATTCACCTC.TATAATCGC	ATTCACCTC.TATAATCGC
ATTCATGTG.CTGAGTCCA	ATTCATGTG.CTGAGTCCA
ATTCATGTG.GAGTATCGC	ATTCATGTG.GAGTATCGC
ATTCATGTG.GCATTGATC	ATTCATGTG.GCATTGATC
ATTCATGTG.GTGAGGACG	ATTCATGTG.GTGAGGACG
ATTCATGTG.TCGCTGATT	ATTCATGTG.TCGCTGATT
ATTCATGTG.TGTTACTGA	ATTCATGTG.TGTTACTGA
ATTCCGTAC.CAACTAATC	ATTCCGTAC.CAACTAATC
ATTCCGTAC.CCACACAGA	ATTCCGTAC.CCACACAGA
ATTCCTACG.AATCTCCTA	ATTCCTACG.AATCTCCTA
ATTCCTACG.CATCTCACG	ATTCCTACG.CATCTCACG
ATTCCTACG.CTTCCGGTA	ATTCCTACG.CTTCCGGTA
ATTCCTACG.GACGTCAAT	ATTCCTACG.GACGTCAAT
ATTCCTACG.GGATAATAC	ATTCCTACG.GGATAATAC
ATTCCTACG.TAATCTGGA	ATTCCTACG.TAATCTGGA
ATTCCTACG.TATAATCGC	ATTCCTACG.TATAATCGC
ATTCCTACG.TCGTAATAG	ATTCCTACG.TCGTAATAG
ATTCCTACG.TGGATAGGT	ATTCCTACG.TGGATAGGT
ATTCCTACG.TTCTCCACA	ATTCCTACG.TTCTCCACA
ATTCCTACG.TTCTGAATG	ATTCCTACG.TTCTGAATG
ATTCGAAGA.AACTCCATG	ATTCGAAGA.AACTCCATG
ATTCGAAGA.TCAAGCGTA	ATTCGAAGA.TCAAGCGTA
ATTCGCTTA.AATCTCCTA	ATTCGCTTA.AATCTCCTA
ATTCGCTTA.GAGCATACA	ATTCGCTTA.GAGCATACA
ATTCGCTTA.GAGCTCTCA	ATTCGCTTA.GAGCTCTCA
ATTCGCTTA.GGATACCTA	ATTCGCTTA.GGATACCTA
ATTCGCTTA.TGTAGATCG	ATTCGCTTA.TGTAGATCG
ATTCTCTGG.CATCTCGAT	ATTCTCTGG.CATCTCGAT
ATTCTCTGG.CCATAGCCA	ATTCTCTGG.CCATAGCCA
ATTCTCTGG.TAGGATTAG	ATTCTCTGG.TAGGATTAG
ATTGACACG.AGTTAGGTC	ATTGACACG.AGTTAGGTC
ATTGACACG.CCTTCGAGC	ATTGACACG.CCTTCGAGC
ATTGACACG.GCAGCGATA	ATTGACACG.GCAGCGATA
ATTGACACG.TACGAGTGA	ATTGACACG.TACGAGTGA
ATTGACACG.TGTCATAGC	ATTGACACG.TGTCATAGC
ATTGATCAC.AATACTCCG	ATTGATCAC.AATACTCCG
ATTGATCAC.AATGCACTT	ATTGATCAC.AATGCACTT
ATTGATCAC.ATGCTCACC	ATTGATCAC.ATGCTCACC
ATTGATCAC.TGATCTCGG	ATTGATCAC.TGATCTCGG
ATTGATCAC.TGTGCCATG	ATTGATCAC.TGTGCCATG
ATTGATTGG.CTAACTAAG	ATTGATTGG.CTAACTAAG
ATTGATTGG.GGTCTCATG	ATTGATTGG.GGTCTCATG
ATTGCCGAC.AAGGATACG	ATTGCCGAC.AAGGATACG
ATTGCCGAC.ACAGCGGTC	ATTGCCGAC.ACAGCGGTC
ATTGCCGAC.ACCTTGAAG	ATTGCCGAC.ACCTTGAAG
ATTGCCGAC.CACGTCATA	ATTGCCGAC.CACGTCATA
ATTGCCGAC.CCTGTATCT	ATTGCCGAC.CCTGTATCT
ATTGCCGAC.GGACTATTC	ATTGCCGAC.GGACTATTC
ATTGCCGAC.TCACCGAGG	ATTGCCGAC.TCACCGAGG
ATTGCGCTA.ACCGGAAGG	ATTGCGCTA.ACCGGAAGG
ATTGCGCTA.ATCACCGCA	ATTGCGCTA.ATCACCGCA
ATTGCGCTA.CAGAGCACC	ATTGCGCTA.CAGAGCACC
ATTGCGCTA.CAGATCATT	ATTGCGCTA.CAGATCATT
ATTGCGCTA.CGGAACGAG	ATTGCGCTA.CGGAACGAG
ATTGCGCTA.CGGTTGCGA	ATTGCGCTA.CGGTTGCGA
ATTGCGCTA.GGTACGAGC	ATTGCGCTA.GGTACGAGC
ATTGGTTCC.ACTCTAGGA	ATTGGTTCC.ACTCTAGGA
ATTGGTTCC.AGGTGCGAG	ATTGGTTCC.AGGTGCGAG
ATTGGTTCC.GGTTAGATG	ATTGGTTCC.GGTTAGATG
CAACACCTA.ACTGACTAC	CAACACCTA.ACTGACTAC
CAACACCTA.CCTTAATTC	CAACACCTA.CCTTAATTC
CAACACCTA.GTCAATACA	CAACACCTA.GTCAATACA
CAACACCTA.GTCTCTTCA	CAACACCTA.GTCTCTTCA
CAACACCTA.TACCAGCCA	CAACACCTA.TACCAGCCA
CAACACCTA.TGTGCAGTA	CAACACCTA.TGTGCAGTA
CAACACTCC.GGTAGACAT	CAACACTCC.GGTAGACAT
CAACACTCC.GGTGGAGCT	CAACACTCC.GGTGGAGCT
CAACCGGTC.GACGGTGCT	CAACCGGTC.GACGGTGCT
CAACCGGTC.GGTCTCATG	CAACCGGTC.GGTCTCATG
CAACCGGTC.TGAGCAGAT	CAACCGGTC.TGAGCAGAT
CAACCTGGT.GACCAACAG	CAACCTGGT.GACCAACAG
CAACCTGGT.GATAAGCTG	CAACCTGGT.GATAAGCTG
CAACCTGGT.GATGCGACG	CAACCTGGT.GATGCGACG
CAACCTGGT.GTATCGTCG	CAACCTGGT.GTATCGTCG
CAACCTGGT.GTGTTGGAA	CAACCTGGT.GTGTTGGAA
CAACCTGGT.TATTGCTAC	CAACCTGGT.TATTGCTAC
CAACGATCG.CAAGCTGCA	CAACGATCG.CAAGCTGCA
CAACGATCG.CCGGTTCTA	CAACGATCG.CCGGTTCTA
CAACGATCG.CCGGTTGAG	CAACGATCG.CCGGTTGAG
CAACGCACA.AGCTACTCA	CAACGCACA.AGCTACTCA
CAACGCACA.TGCCTGGTT	CAACGCACA.TGCCTGGTT
CAACGCACA.TTAAGTGGT	CAACGCACA.TTAAGTGGT
CAACGTCTT.AGCACCAGC	CAACGTCTT.AGCACCAGC
CAACGTCTT.GAGTCCAAT	CAACGTCTT.GAGTCCAAT
CAACGTCTT.TAGGTTAGT	CAACGTCTT.TAGGTTAGT
CAACGTCTT.TTAGGAAGG	CAACGTCTT.TTAGGAAGG
CAACTAATC.CGTCTGTCC	CAACTAATC.CGTCTGTCC
CAACTAATC.TTACTTACG	CAACTAATC.TTACTTACG
CAACTCCAG.ACTCTGCTC	CAACTCCAG.ACTCTGCTC
CAACTCCAG.ACTGGTGCT	CAACTCCAG.ACTGGTGCT
CAACTCCAG.CAAGAACCG	CAACTCCAG.CAAGAACCG
CAACTCCAG.CGCATCTAC	CAACTCCAG.CGCATCTAC
CAACTCCAG.CTGAGTAGC	CAACTCCAG.CTGAGTAGC
CAACTCCAG.TATCATGCT	CAACTCCAG.TATCATGCT
CAAGAACCG.AGTACGAAT	CAAGAACCG.AGTACGAAT
CAAGAACCG.CAACACCTA	CAAGAACCG.CAACACCTA
CAAGAACCG.CGGATTCTC	CAAGAACCG.CGGATTCTC
CAAGAACCG.CGGTTCGTA	CAAGAACCG.CGGTTCGTA
CAAGAACCG.GAACGCTGT	CAAGAACCG.GAACGCTGT
CAAGAACCG.GAGAACAGG	CAAGAACCG.GAGAACAGG
CAAGAGAGT.CAACACCTA	CAAGAGAGT.CAACACCTA
CAAGAGAGT.CAACGATCG	CAAGAGAGT.CAACGATCG
CAAGAGAGT.CATACAACC	CAAGAGAGT.CATACAACC
CAAGAGAGT.CATCCTCTC	CAAGAGAGT.CATCCTCTC
CAAGAGAGT.TATACGTGG	CAAGAGAGT.TATACGTGG
CAAGAGGAG.AACGCATTG	CAAGAGGAG.AACGCATTG
CAAGAGGAG.CATCTCACG	CAAGAGGAG.CATCTCACG
CAAGAGGAG.CCACGGATC	CAAGAGGAG.CCACGGATC
CAAGAGGAG.GAACCTTCA	CAAGAGGAG.GAACCTTCA
CAAGAGGAG.GGAAGTATG	CAAGAGGAG.GGAAGTATG
CAAGAGGAG.TCATATCGC	CAAGAGGAG.TCATATCGC
CAAGCCTCG.AGTCTAAGC	CAAGCCTCG.AGTCTAAGC
CAAGCCTCG.GTCGTCGAC	CAAGCCTCG.GTCGTCGAC
CAAGCCTCG.TGATACCGT	CAAGCCTCG.TGATACCGT
CAAGCGCAT.ACTGTAATC	CAAGCGCAT.ACTGTAATC
CAAGCGCAT.CATAAGATC	CAAGCGCAT.CATAAGATC
CAAGCGCAT.CTAATACGC	CAAGCGCAT.CTAATACGC
CAAGCTGCA.AATATCGCT	CAAGCTGCA.AATATCGCT
CAAGCTGCA.ATCAGTCGA	CAAGCTGCA.ATCAGTCGA
CAAGCTGCA.CTTAATCGT	CAAGCTGCA.CTTAATCGT
CAAGCTGCA.GAGAATCAG	CAAGCTGCA.GAGAATCAG
CAAGCTGCA.GATACCGGA	CAAGCTGCA.GATACCGGA
CAAGCTGCA.TAACGTGTC	CAAGCTGCA.TAACGTGTC
CAAGCTGCA.TCAATCTAG	CAAGCTGCA.TCAATCTAG
CAAGCTGCA.TCCTGTCCG	CAAGCTGCA.TCCTGTCCG
CAAGGTGTG.AATGTGCGT	CAAGGTGTG.AATGTGCGT
CAAGGTGTG.AGAGCGGAG	CAAGGTGTG.AGAGCGGAG
CAAGGTGTG.CAATACCAC	CAAGGTGTG.CAATACCAC
CAAGGTGTG.TAACACATC	CAAGGTGTG.TAACACATC
CAAGGTGTG.TAGTGATCC	CAAGGTGTG.TAGTGATCC
CAAGGTGTG.TCCAACGTG	CAAGGTGTG.TCCAACGTG
CAAGGTGTG.TTACGCTCG	CAAGGTGTG.TTACGCTCG
CAAGTACGA.CATTCGAAT	CAAGTACGA.CATTCGAAT
CAAGTACGA.CGGAACGAG	CAAGTACGA.CGGAACGAG
CAAGTACGA.TTGCCAGAT	CAAGTACGA.TTGCCAGAT
CAAGTCACT.AGGTCACGT	CAAGTCACT.AGGTCACGT
CAAGTCACT.AGTACTCTC	CAAGTCACT.AGTACTCTC
CAAGTCACT.GATGCAGAA	CAAGTCACT.GATGCAGAA
CAAGTCACT.GCAATGAGA	CAAGTCACT.GCAATGAGA
CAAGTCACT.TATCACCTG	CAAGTCACT.TATCACCTG
CAAGTCACT.TCACGCGAC	CAAGTCACT.TCACGCGAC
CAAGTCGAA.ACCTCCTAG	CAAGTCGAA.ACCTCCTAG
CAATACCAC.ACCTAGTTA	CAATACCAC.ACCTAGTTA
CAATACCAC.ACGCTATGT	CAATACCAC.ACGCTATGT
CAATACCAC.ACTCCTGAG	CAATACCAC.ACTCCTGAG
CAATACCAC.GCCTTAGAG	CAATACCAC.GCCTTAGAG
CAATACCAC.GTGTATCTG	CAATACCAC.GTGTATCTG
CAATACCAC.TGTCATAGC	CAATACCAC.TGTCATAGC
CAATCAAGT.ATGAACTAG	CAATCAAGT.ATGAACTAG
CAATCAAGT.CCGAGTACT	CAATCAAGT.CCGAGTACT
CAATCAAGT.CGTGCCTAT	CAATCAAGT.CGTGCCTAT
CAATCAAGT.CGTTAATGG	CAATCAAGT.CGTTAATGG
CAATCAAGT.TACTCGACC	CAATCAAGT.TACTCGACC
CAATCAAGT.TCAAGGAGT	CAATCAAGT.TCAAGGAGT
CAATCATAC.ATCCGGTCC	CAATCATAC.ATCCGGTCC
CAATCATAC.CCTAGTTAG	CAATCATAC.CCTAGTTAG
CAATCATAC.TGGAATCGT	CAATCATAC.TGGAATCGT
CAATCTCCG.CCAAGTCGA	CAATCTCCG.CCAAGTCGA
CAATCTCCG.CCATCTAGG	CAATCTCCG.CCATCTAGG
CAATCTCCG.GCGTGATAC	CAATCTCCG.GCGTGATAC
CAATGCATT.GTGACTCTC	CAATGCATT.GTGACTCTC
CAATGTGCT.AATGCTATC	CAATGTGCT.AATGCTATC
CAATGTGCT.ACCGTCACG	CAATGTGCT.ACCGTCACG
CAATGTGCT.CTTAATCGT	CAATGTGCT.CTTAATCGT
CAATGTGCT.GAATCGAGA	CAATGTGCT.GAATCGAGA
CAATGTGCT.TACAGTTAG	CAATGTGCT.TACAGTTAG
CAATTGTCT.ACGAGAGCA	CAATTGTCT.ACGAGAGCA
CAATTGTCT.ACGGTGCCT	CAATTGTCT.ACGGTGCCT
CAATTGTCT.CTATCTTGA	CAATTGTCT.CTATCTTGA
CAATTGTCT.GTCTACCAA	CAATTGTCT.GTCTACCAA
CACAACCAG.ACTATCCTG	CACAACCAG.ACTATCCTG
CACAACCAG.AGCGGAACA	CACAACCAG.AGCGGAACA
CACAACCAG.CATCTCACG	CACAACCAG.CATCTCACG
CACAACCAG.TAGCGAGAA	CACAACCAG.TAGCGAGAA
CACAACGCT.AAGGATACG	CACAACGCT.AAGGATACG
CACAACGCT.CTAACACTG	CACAACGCT.CTAACACTG
CACAACGCT.TCATATCGC	CACAACGCT.TCATATCGC
CACAACGCT.TGGATTAGC	CACAACGCT.TGGATTAGC
CACAATAAC.ACCATGTCT	CACAATAAC.ACCATGTCT
CACAATAAC.CACCTACGC	CACAATAAC.CACCTACGC
CACAATAAC.CTATAGCTC	CACAATAAC.CTATAGCTC
CACAATAAC.TACGGTCGT	CACAATAAC.TACGGTCGT
CACAATAAC.TAGTCAGAC	CACAATAAC.TAGTCAGAC
CACACCACA.ACAGTATTG	CACACCACA.ACAGTATTG
CACACCACA.CCGCAGAAT	CACACCACA.CCGCAGAAT
CACACCACA.GCCGCCTAA	CACACCACA.GCCGCCTAA
CACACCACA.GCGGACGAA	CACACCACA.GCGGACGAA
CACACCACA.GCTTCACTC	CACACCACA.GCTTCACTC
CACACCACA.TCCTGTGGA	CACACCACA.TCCTGTGGA
CACACCACA.TCTTAGCGA	CACACCACA.TCTTAGCGA
CACACCTGT.ATGCTGTCG	CACACCTGT.ATGCTGTCG
CACACCTGT.CACTGGTCC	CACACCTGT.CACTGGTCC
CACACCTGT.CCTGTATCT	CACACCTGT.CCTGTATCT
CACAGCGAA.AATACGTCT	CACAGCGAA.AATACGTCT
CACAGCGAA.ACGGTGCCT	CACAGCGAA.ACGGTGCCT
CACAGCGAA.AGACCACGC	CACAGCGAA.AGACCACGC
CACAGCGAA.CGATTGAAC	CACAGCGAA.CGATTGAAC
CACAGCGAA.GTGATGTGC	CACAGCGAA.GTGATGTGC
CACAGCGAA.TGCGATACT	CACAGCGAA.TGCGATACT
CACAGCGAA.TGGAGAACC	CACAGCGAA.TGGAGAACC
CACATATCA.AACGTTCTT	CACATATCA.AACGTTCTT
CACATATCA.AAGACGAAG	CACATATCA.AAGACGAAG
CACATATCA.ACCGGTTAC	CACATATCA.ACCGGTTAC
CACATATCA.AGCTCTCCG	CACATATCA.AGCTCTCCG
CACATATCA.AGGTCACGT	CACATATCA.AGGTCACGT
CACATATCA.CTTATCTCA	CACATATCA.CTTATCTCA
CACATATCA.TAGGAGGAT	CACATATCA.TAGGAGGAT
CACATATCA.TGCCGCTAC	CACATATCA.TGCCGCTAC
CACATGTGC.AAGCAGCAT	CACATGTGC.AAGCAGCAT
CACATGTGC.AGCATTCCA	CACATGTGC.AGCATTCCA
CACATGTGC.CACAGCGAA	CACATGTGC.CACAGCGAA
CACATGTGC.CCTTCCTCA	CACATGTGC.CCTTCCTCA
CACATGTGC.GCGAGCAAG	CACATGTGC.GCGAGCAAG
CACATGTGC.TAGGATTAG	CACATGTGC.TAGGATTAG
CACATTCTG.AACTTAGCT	CACATTCTG.AACTTAGCT
CACCAAGAT.ACACTGTGA	CACCAAGAT.ACACTGTGA
CACCAAGAT.CAATCATAC	CACCAAGAT.CAATCATAC
CACCAAGAT.CGCCTGCAA	CACCAAGAT.CGCCTGCAA
CACCAAGAT.CTTCGACTG	CACCAAGAT.CTTCGACTG
CACCAAGAT.TCAATCTAG	CACCAAGAT.TCAATCTAG
CACCAAGAT.TTGATGAGT	CACCAAGAT.TTGATGAGT
CACCAGAAG.ACGGTGCCT	CACCAGAAG.ACGGTGCCT
CACCAGAAG.CCAAGCGAG	CACCAGAAG.CCAAGCGAG
CACCAGAAG.CCGTACGGA	CACCAGAAG.CCGTACGGA
CACCAGAAG.CTCAGTGAT	CACCAGAAG.CTCAGTGAT
CACCAGAAG.CTTACATGC	CACCAGAAG.CTTACATGC
CACCAGAAG.TAGTGATCC	CACCAGAAG.TAGTGATCC
CACCAGAAG.TTCCTTGAC	CACCAGAAG.TTCCTTGAC
CACCTACGC.ATCCATTAG	CACCTACGC.ATCCATTAG
CACCTACGC.TATCATGCT	CACCTACGC.TATCATGCT
CACCTACGC.TGAGTTAAG	CACCTACGC.TGAGTTAAG
CACCTAGCG.ACTATTGTC	CACCTAGCG.ACTATTGTC
CACCTAGCG.GCCGTCTTC	CACCTAGCG.GCCGTCTTC
CACCTAGCG.GCGGTAAGT	CACCTAGCG.GCGGTAAGT
CACCTCAAC.AACTTAGCT	CACCTCAAC.AACTTAGCT
CACCTCAAC.GGTCGGATA	CACCTCAAC.GGTCGGATA
CACCTCAAC.GTTAATTCG	CACCTCAAC.GTTAATTCG
CACCTCAAC.TCAACACTC	CACCTCAAC.TCAACACTC
CACCTCGGA.AGTTGCCTT	CACCTCGGA.AGTTGCCTT
CACCTCGGA.ATAGACCGA	CACCTCGGA.ATAGACCGA
CACCTCGGA.CATCCTCTC	CACCTCGGA.CATCCTCTC
CACCTCGGA.CCTGTCATT	CACCTCGGA.CCTGTCATT
CACCTCGGA.TGTGTCTAC	CACCTCGGA.TGTGTCTAC
CACCTTCCT.ACAGCATCA	CACCTTCCT.ACAGCATCA
CACCTTCCT.ATGCGGATT	CACCTTCCT.ATGCGGATT
CACCTTCCT.ATGGTTCGA	CACCTTCCT.ATGGTTCGA
CACCTTCCT.CAATCAAGT	CACCTTCCT.CAATCAAGT
CACCTTCCT.GATCTTCGC	CACCTTCCT.GATCTTCGC
CACCTTCCT.TTATCCAAG	CACCTTCCT.TTATCCAAG
CACGACTCA.AGCAGACAA	CACGACTCA.AGCAGACAA
CACGACTCA.GATTCCTCT	CACGACTCA.GATTCCTCT
CACGACTCA.GTCGTCGAC	CACGACTCA.GTCGTCGAC
CACGACTCA.TGCGCACTG	CACGACTCA.TGCGCACTG
CACGATAGA.ACTCCGTCG	CACGATAGA.ACTCCGTCG
CACGATAGA.CAATGCATT	CACGATAGA.CAATGCATT
CACGATAGA.TCTGTGAAG	CACGATAGA.TCTGTGAAG
CACGCGTAA.CATTGCAGA	CACGCGTAA.CATTGCAGA
CACGCGTAA.TGCCAATGG	CACGCGTAA.TGCCAATGG
CACGGAAGT.AGACATCCA	CACGGAAGT.AGACATCCA
CACGGAAGT.CTAGAGTCG	CACGGAAGT.CTAGAGTCG
CACGGAAGT.GTATTACTG	CACGGAAGT.GTATTACTG
CACGGAAGT.GTCTCCAGG	CACGGAAGT.GTCTCCAGG
CACGGAAGT.TCGCTGATT	CACGGAAGT.TCGCTGATT
CACGGAAGT.TCTCAGGAT	CACGGAAGT.TCTCAGGAT
CACGGATAG.ACGCTCTTA	CACGGATAG.ACGCTCTTA
CACGGATAG.AGACGCTAT	CACGGATAG.AGACGCTAT
CACGGATAG.CCATAATCG	CACGGATAG.CCATAATCG
CACGGATAG.GATCTACTT	CACGGATAG.GATCTACTT
CACGGATAG.GCCTTCCAT	CACGGATAG.GCCTTCCAT
CACGGATAG.GTGGTACGG	CACGGATAG.GTGGTACGG
CACGGATAG.TATCGGAAC	CACGGATAG.TATCGGAAC
CACGGATAG.TGTTAAGCC	CACGGATAG.TGTTAAGCC
CACGTAGAC.ACCATGTCT	CACGTAGAC.ACCATGTCT
CACGTAGAC.ACTGTGTCA	CACGTAGAC.ACTGTGTCA
CACGTAGAC.CTGAGTCCA	CACGTAGAC.CTGAGTCCA
CACGTAGAC.GACGCTTGC	CACGTAGAC.GACGCTTGC
CACGTCATA.ACACACGTC	CACGTCATA.ACACACGTC
CACGTCATA.ACGTGAATC	CACGTCATA.ACGTGAATC
CACGTCATA.ATTGACACG	CACGTCATA.ATTGACACG
CACGTCATA.CGTATTCCT	CACGTCATA.CGTATTCCT
CACTACAGG.AGACCACGC	CACTACAGG.AGACCACGC
CACTACAGG.CGTATAGCG	CACTACAGG.CGTATAGCG
CACTACAGG.GACTTGATT	CACTACAGG.GACTTGATT
CACTAGACT.AATGCTGAT	CACTAGACT.AATGCTGAT
CACTCACTA.AAGCTGAGG	CACTCACTA.AAGCTGAGG
CACTCACTA.CAAGGTGTG	CACTCACTA.CAAGGTGTG
CACTCACTA.CCACGTTCT	CACTCACTA.CCACGTTCT
CACTCACTA.GATCGATAC	CACTCACTA.GATCGATAC
CACTGCTTA.AAGTTCTCT	CACTGCTTA.AAGTTCTCT
CACTGCTTA.AGCAAGTCC	CACTGCTTA.AGCAAGTCC
CACTGCTTA.GCAACACCT	CACTGCTTA.GCAACACCT
CACTGCTTA.GTCTTCTCG	CACTGCTTA.GTCTTCTCG
CACTGCTTA.GTTGCATGG	CACTGCTTA.GTTGCATGG
CACTGCTTA.TAAGCACTA	CACTGCTTA.TAAGCACTA
CACTGGTCC.CCAACGGAA	CACTGGTCC.CCAACGGAA
CACTGGTCC.CGTGCCTAT	CACTGGTCC.CGTGCCTAT
CACTGGTCC.CTGAGATAG	CACTGGTCC.CTGAGATAG
CACTGGTCC.TAAGCCATT	CACTGGTCC.TAAGCCATT
CACTGGTCC.TGCAGTCGG	CACTGGTCC.TGCAGTCGG
CACTGTATC.ACACAGAAC	CACTGTATC.ACACAGAAC
CACTGTATC.GCTACAATG	CACTGTATC.GCTACAATG
CACTGTATC.TCGCTGATT	CACTGTATC.TCGCTGATT
CACTTCCTT.CCTGTCATT	CACTTCCTT.CCTGTCATT
CACTTCCTT.CGCGATGTA	CACTTCCTT.CGCGATGTA
CACTTGGAT.AGTCGTCCG	CACTTGGAT.AGTCGTCCG
CACTTGGAT.GCACGTAGA	CACTTGGAT.GCACGTAGA
CAGAAGTGA.ACAGAGATG	CAGAAGTGA.ACAGAGATG
CAGAAGTGA.ACAGCGGTC	CAGAAGTGA.ACAGCGGTC
CAGAAGTGA.AGACGCTAT	CAGAAGTGA.AGACGCTAT
CAGAAGTGA.AGGTACCAA	CAGAAGTGA.AGGTACCAA
CAGAAGTGA.TCAACACTC	CAGAAGTGA.TCAACACTC
CAGAAGTGA.TCGCTTAAC	CAGAAGTGA.TCGCTTAAC
CAGATCATT.ACCGTCACG	CAGATCATT.ACCGTCACG
CAGATCATT.GACGCCGTA	CAGATCATT.GACGCCGTA
CAGATCATT.GCTCTGTGT	CAGATCATT.GCTCTGTGT
CAGATCATT.TCACGCGAC	CAGATCATT.TCACGCGAC
CAGATCGAC.CAGCGACGT	CAGATCGAC.CAGCGACGT
CAGATCGAC.CCTAGTTAG	CAGATCGAC.CCTAGTTAG
CAGATCGAC.CCTGACCTC	CAGATCGAC.CCTGACCTC
CAGATCGAC.TTGCGAACA	CAGATCGAC.TTGCGAACA
CAGCACGTG.CATAAGATC	CAGCACGTG.CATAAGATC
CAGCACGTG.CATAGGTGT	CAGCACGTG.CATAGGTGT
CAGCACGTG.CTGTGCTCA	CAGCACGTG.CTGTGCTCA
CAGCACGTG.TAGCACACG	CAGCACGTG.TAGCACACG
CAGCAGTAC.ATCACCGCA	CAGCAGTAC.ATCACCGCA
CAGCAGTAC.CTCATTAGT	CAGCAGTAC.CTCATTAGT
CAGCAGTAC.GGAACCTAG	CAGCAGTAC.GGAACCTAG
CAGCAGTAC.GGAGAATGA	CAGCAGTAC.GGAGAATGA
CAGCAGTAC.TAGAGACTA	CAGCAGTAC.TAGAGACTA
CAGCAGTAC.TCGCTGATT	CAGCAGTAC.TCGCTGATT
CAGCCGCAA.CACACCACA	CAGCCGCAA.CACACCACA
CAGCCGCAA.CATGGTCGA	CAGCCGCAA.CATGGTCGA
CAGCCGCAA.CCACGCCAT	CAGCCGCAA.CCACGCCAT
CAGCCGCAA.CCGACTGTT	CAGCCGCAA.CCGACTGTT
CAGCCGCAA.CGTATTCCT	CAGCCGCAA.CGTATTCCT
CAGCCGCAA.CTATGGATG	CAGCCGCAA.CTATGGATG
CAGCCGCAA.GCTACAATG	CAGCCGCAA.GCTACAATG
CAGCCGCAA.GTCAGACCG	CAGCCGCAA.GTCAGACCG
CAGCCGCAA.TGCCTGGTT	CAGCCGCAA.TGCCTGGTT
CAGCGACGT.AAGCACAAC	CAGCGACGT.AAGCACAAC
CAGCGACGT.AATAGACGC	CAGCGACGT.AATAGACGC
CAGCGACGT.ATCCAATGA	CAGCGACGT.ATCCAATGA
CAGCGACGT.CCGATCTCT	CAGCGACGT.CCGATCTCT
CAGCGACGT.CCTAAGTCT	CAGCGACGT.CCTAAGTCT
CAGCGACGT.CCTCGGTCA	CAGCGACGT.CCTCGGTCA
CAGCGACGT.CCTTAATTC	CAGCGACGT.CCTTAATTC
CAGCGACGT.CGAACAGAG	CAGCGACGT.CGAACAGAG
CAGCGACGT.TAGCTGTTG	CAGCGACGT.TAGCTGTTG
CAGCGACGT.TCTGGAGGA	CAGCGACGT.TCTGGAGGA
CAGCGACGT.TGCCGAACT	CAGCGACGT.TGCCGAACT
CAGCGACGT.TGGAGAGTG	CAGCGACGT.TGGAGAGTG
CAGCGACGT.TTGTATCAC	CAGCGACGT.TTGTATCAC
CAGCGTAAG.ACATGGATT	CAGCGTAAG.ACATGGATT
CAGCGTAAG.CATCCGACA	CAGCGTAAG.CATCCGACA
CAGCGTAAG.TACGACCAT	CAGCGTAAG.TACGACCAT
CAGCGTAAG.TCAGTGCAA	CAGCGTAAG.TCAGTGCAA
CAGCGTAAG.TGGTAACCA	CAGCGTAAG.TGGTAACCA
CAGCGTAAG.TTCCATACC	CAGCGTAAG.TTCCATACC
CAGCTAGTT.ACAACGAGC	CAGCTAGTT.ACAACGAGC
CAGCTAGTT.AGTTCAACC	CAGCTAGTT.AGTTCAACC
CAGCTAGTT.CATCAATAG	CAGCTAGTT.CATCAATAG
CAGCTAGTT.TGTCACATA	CAGCTAGTT.TGTCACATA
CAGCTCTTC.CTATAGCTC	CAGCTCTTC.CTATAGCTC
CAGCTCTTC.GACGGTGCT	CAGCTCTTC.GACGGTGCT
CAGCTGGAG.ATCGGTGGT	CAGCTGGAG.ATCGGTGGT
CAGCTGGAG.CTCCGCATT	CAGCTGGAG.CTCCGCATT
CAGCTGGAG.CTTACATGC	CAGCTGGAG.CTTACATGC
CAGCTGGAG.TCCGATAAC	CAGCTGGAG.TCCGATAAC
CAGCTGGAG.TTAACGGAG	CAGCTGGAG.TTAACGGAG
CAGCTTACC.AGTTGCCTT	CAGCTTACC.AGTTGCCTT
CAGCTTACC.GAGCCATCC	CAGCTTACC.GAGCCATCC
CAGCTTCGA.AATCCTCGT	CAGCTTCGA.AATCCTCGT
CAGCTTCGA.CCATGCGTC	CAGCTTCGA.CCATGCGTC
CAGCTTCGA.CGAAGAGGT	CAGCTTCGA.CGAAGAGGT
CAGCTTCGA.CGCATCTAC	CAGCTTCGA.CGCATCTAC
CAGCTTCGA.CTGACAGCA	CAGCTTCGA.CTGACAGCA
CAGCTTCGA.CTGCTGCTT	CAGCTTCGA.CTGCTGCTT
CAGCTTCGA.GCGCTCTAT	CAGCTTCGA.GCGCTCTAT
CAGCTTCGA.GGTAAGGAT	CAGCTTCGA.GGTAAGGAT
CAGGAGCCT.ACCTCCTAG	CAGGAGCCT.ACCTCCTAG
CAGGAGCCT.CCACTTCGC	CAGGAGCCT.CCACTTCGC
CAGGAGCCT.CCTAGCAAT	CAGGAGCCT.CCTAGCAAT
CAGGATCAA.AATGAGTCG	CAGGATCAA.AATGAGTCG
CAGGATCAA.GCTGAGCAG	CAGGATCAA.GCTGAGCAG
CAGGATCAA.TAGAGCGTC	CAGGATCAA.TAGAGCGTC
CAGGTATCG.GAACTGCAA	CAGGTATCG.GAACTGCAA
CAGGTATCG.GTGAGGACG	CAGGTATCG.GTGAGGACG
CAGGTATCG.TGGAGTGGA	CAGGTATCG.TGGAGTGGA
CAGGTTGTC.AGGATCATG	CAGGTTGTC.AGGATCATG
CAGGTTGTC.CTTGATCTA	CAGGTTGTC.CTTGATCTA
CAGGTTGTC.GAATAAGAG	CAGGTTGTC.GAATAAGAG
CAGGTTGTC.TAACGTGTC	CAGGTTGTC.TAACGTGTC
CAGGTTGTC.TATGTACCT	CAGGTTGTC.TATGTACCT
CAGGTTGTC.TCGTGACGT	CAGGTTGTC.TCGTGACGT
CAGGTTGTC.TCTAGCTGG	CAGGTTGTC.TCTAGCTGG
CAGGTTGTC.TCTTAAGTG	CAGGTTGTC.TCTTAAGTG
CAGGTTGTC.TTGTTAGAG	CAGGTTGTC.TTGTTAGAG
CAGTAATGT.AGTTATCGC	CAGTAATGT.AGTTATCGC
CAGTAATGT.CATCCTCTC	CAGTAATGT.CATCCTCTC
CAGTAATGT.CCTCCTTGT	CAGTAATGT.CCTCCTTGT
CAGTAATGT.GGTAAGGAT	CAGTAATGT.GGTAAGGAT
CAGTACATC.AGCGGTCTA	CAGTACATC.AGCGGTCTA
CAGTACATC.GGATTACGC	CAGTACATC.GGATTACGC
CAGTACATC.TGGTAGCAG	CAGTACATC.TGGTAGCAG
CAGTACATC.TTAAGTGGT	CAGTACATC.TTAAGTGGT
CAGTATGAT.ACAGGAACT	CAGTATGAT.ACAGGAACT
CAGTATGAT.ACTATTGTC	CAGTATGAT.ACTATTGTC
CAGTATGAT.ACTTCTTGG	CAGTATGAT.ACTTCTTGG
CAGTATGAT.GAGACGATC	CAGTATGAT.GAGACGATC
CAGTATGAT.GTATTACTG	CAGTATGAT.GTATTACTG
CAGTATGAT.GTTACTACT	CAGTATGAT.GTTACTACT
CAGTCCTAA.AGGATGCGT	CAGTCCTAA.AGGATGCGT
CAGTCCTAA.CTTACCTAG	CAGTCCTAA.CTTACCTAG
CAGTCGGTA.ATTCACCTC	CAGTCGGTA.ATTCACCTC
CAGTCGGTA.CAGAAGTGA	CAGTCGGTA.CAGAAGTGA
CAGTCGGTA.CGGTCGACA	CAGTCGGTA.CGGTCGACA
CAGTCGGTA.GGTTGAAGG	CAGTCGGTA.GGTTGAAGG
CAGTCGGTA.TAGAGCGTC	CAGTCGGTA.TAGAGCGTC
CAGTCGGTA.TGGACTGCC	CAGTCGGTA.TGGACTGCC
CAGTCTAAC.ATGAGGTAT	CAGTCTAAC.ATGAGGTAT
CAGTCTAAC.ATTATGCAG	CAGTCTAAC.ATTATGCAG
CAGTGAGGA.ACGACAGTC	CAGTGAGGA.ACGACAGTC
CAGTGAGGA.GAATTCAGT	CAGTGAGGA.GAATTCAGT
CAGTGAGGA.GGATCAATG	CAGTGAGGA.GGATCAATG
CAGTGAGGA.TGCACGATG	CAGTGAGGA.TGCACGATG
