GACCGCTTC.TATGAGACC	GACCGCTTC.TATGAGACC
GACCGCTTC.TATTACAGC	GACCGCTTC.TATTACAGC
GACCGGTAG.ACACGTTGC	GACCGGTAG.ACACGTTGC
GACCGGTAG.TAGTTGACG	GACCGGTAG.TAGTTGACG
GACCGGTAG.TATCACCTG	GACCGGTAG.TATCACCTG
GACCGGTAG.TGATTATCG	GACCGGTAG.TGATTATCG
GACCGGTAG.TGCTGCGTC	GACCGGTAG.TGCTGCGTC
GACCGTAGT.ATAATCGAG	GACCGTAGT.ATAATCGAG
GACCGTAGT.ATTGACACG	GACCGTAGT.ATTGACACG
GACCGTAGT.CTGGACTAA	GACCGTAGT.CTGGACTAA
GACCTTGTG.ATGATAGCT	GACCTTGTG.ATGATAGCT
GACCTTGTG.CACATATCA	GACCTTGTG.CACATATCA
GACCTTGTG.GGAACCTAG	GACCTTGTG.GGAACCTAG
GACCTTGTG.GTCGTGTTA	GACCTTGTG.GTCGTGTTA
GACCTTGTG.TGAGAGGAC	GACCTTGTG.TGAGAGGAC
GACGCCGTA.ACTGCTAGT	GACGCCGTA.ACTGCTAGT
GACGCCGTA.GTTGCATGG	GACGCCGTA.GTTGCATGG
GACGCTTGC.CGTGGTACC	GACGCTTGC.CGTGGTACC
GACGCTTGC.CTCCAGCGT	GACGCTTGC.CTCCAGCGT
GACGGACTA.AGTGACGAT	GACGGACTA.AGTGACGAT
GACGGACTA.ATCGTAGTG	GACGGACTA.ATCGTAGTG
GACGGACTA.CTGTGGTGG	GACGGACTA.CTGTGGTGG
GACGGACTA.GGTGATAGG	GACGGACTA.GGTGATAGG
GACGGACTA.GGTTAGATG	GACGGACTA.GGTTAGATG
GACGGACTA.TACAACACC	GACGGACTA.TACAACACC
GACGGTGCT.AATCTCCTA	GACGGTGCT.AATCTCCTA
GACGGTGCT.ACACGTTGC	GACGGTGCT.ACACGTTGC
GACGGTGCT.CACCAAGAT	GACGGTGCT.CACCAAGAT
GACGGTGCT.CTTAGAAGG	GACGGTGCT.CTTAGAAGG
GACGGTGCT.CTTGCACAA	GACGGTGCT.CTTGCACAA
GACGGTGCT.TCCTTAGGT	GACGGTGCT.TCCTTAGGT
GACGTAGCA.ACTTCAGTA	GACGTAGCA.ACTTCAGTA
GACGTAGCA.AGACGCTAT	GACGTAGCA.AGACGCTAT
GACGTAGCA.GGATACCTA	GACGTAGCA.GGATACCTA
GACGTAGCA.GGATGCGAA	GACGTAGCA.GGATGCGAA
GACGTAGCA.GTAATCAGC	GACGTAGCA.GTAATCAGC
GACGTAGCA.GTAGAAGTT	GACGTAGCA.GTAGAAGTT
GACGTCAAT.ACGATGGAA	GACGTCAAT.ACGATGGAA
GACGTCAAT.CCAGTACTC	GACGTCAAT.CCAGTACTC
GACGTCAAT.CGTTCGTAC	GACGTCAAT.CGTTCGTAC
GACGTCAAT.GACCAACAG	GACGTCAAT.GACCAACAG
GACGTCAAT.GCTAGCTCC	GACGTCAAT.GCTAGCTCC
GACGTCAAT.GGTGATAGG	GACGTCAAT.GGTGATAGG
GACGTCAAT.GTAACCATA	GACGTCAAT.GTAACCATA
GACGTCAAT.TCAAGGTCG	GACGTCAAT.TCAAGGTCG
GACGTCAAT.TGAAGACCA	GACGTCAAT.TGAAGACCA
GACGTCAAT.TTCCTCGGT	GACGTCAAT.TTCCTCGGT
GACGTGGTC.AACGAGGTG	GACGTGGTC.AACGAGGTG
GACGTGGTC.AATGTGCGT	GACGTGGTC.AATGTGCGT
GACGTGGTC.CCTGTTAGC	GACGTGGTC.CCTGTTAGC
GACGTGGTC.GAAGGATCA	GACGTGGTC.GAAGGATCA
GACGTGGTC.TCGGACAGT	GACGTGGTC.TCGGACAGT
GACGTGGTC.TTATCGCAC	GACGTGGTC.TTATCGCAC
GACGTTCAG.ATGCTCACC	GACGTTCAG.ATGCTCACC
GACGTTCAG.CCTCGCGTT	GACGTTCAG.CCTCGCGTT
GACGTTCAG.GCCGTGAAC	GACGTTCAG.GCCGTGAAC
GACGTTCAG.GTAGAAGTT	GACGTTCAG.GTAGAAGTT
GACTAGCAT.GTATCGTCG	GACTAGCAT.GTATCGTCG
GACTATTGA.ACGCACACT	GACTATTGA.ACGCACACT
GACTATTGA.ATAGTCAGT	GACTATTGA.ATAGTCAGT
GACTATTGA.ATGAGGTAT	GACTATTGA.ATGAGGTAT
GACTATTGA.GTACGAACG	GACTATTGA.GTACGAACG
GACTCAGTG.AACGTCGAG	GACTCAGTG.AACGTCGAG
GACTCAGTG.CTTAAGTTG	GACTCAGTG.CTTAAGTTG
GACTCTCAC.AGTCATACT	GACTCTCAC.AGTCATACT
GACTCTCAC.CACATGTGC	GACTCTCAC.CACATGTGC
GACTCTCAC.CACCAGAAG	GACTCTCAC.CACCAGAAG
GACTCTCAC.CCAGTTACG	GACTCTCAC.CCAGTTACG
GACTCTCAC.GAGTTAACT	GACTCTCAC.GAGTTAACT
GACTCTCAC.TCAAGGAGT	GACTCTCAC.TCAAGGAGT
GACTCTCAC.TGGTGCCTG	GACTCTCAC.TGGTGCCTG
GACTCTGGT.GAGGTCCTT	GACTCTGGT.GAGGTCCTT
GACTCTGGT.GGTTGAAGG	GACTCTGGT.GGTTGAAGG
GACTCTGGT.TTCACTGGA	GACTCTGGT.TTCACTGGA
GACTGCCTG.AACAGCAGT	GACTGCCTG.AACAGCAGT
GACTGCCTG.ATTGGTTCC	GACTGCCTG.ATTGGTTCC
GACTGCCTG.CCGCAGCTA	GACTGCCTG.CCGCAGCTA
GACTGCCTG.CTCCACGTC	GACTGCCTG.CTCCACGTC
GACTGCCTG.CTGAGGTTA	GACTGCCTG.CTGAGGTTA
GACTGCGCA.AATAGACGC	GACTGCGCA.AATAGACGC
GACTGCGCA.CACTTGGAT	GACTGCGCA.CACTTGGAT
GACTGCGCA.CGCAGTGTC	GACTGCGCA.CGCAGTGTC
GACTGCGCA.CTCTAAGAG	GACTGCGCA.CTCTAAGAG
GACTGCGCA.GATTCTCGG	GACTGCGCA.GATTCTCGG
GACTGCGCA.GTTCAGAAG	GACTGCGCA.GTTCAGAAG
GACTTCACC.CAGGATCAA	GACTTCACC.CAGGATCAA
GACTTCACC.GTGTTCCAG	GACTTCACC.GTGTTCCAG
GACTTCACC.TCACGCGAC	GACTTCACC.TCACGCGAC
GACTTCACC.TGCCGACTA	GACTTCACC.TGCCGACTA
GACTTGATT.ATGAACTAG	GACTTGATT.ATGAACTAG
GACTTGATT.CAAGTACGA	GACTTGATT.CAAGTACGA
GACTTGATT.CCGGATTGC	GACTTGATT.CCGGATTGC
GACTTGATT.TCAATGGAC	GACTTGATT.TCAATGGAC
GAGAACAGG.AACGAGAAT	GAGAACAGG.AACGAGAAT
GAGAACAGG.GCTGGTAAC	GAGAACAGG.GCTGGTAAC
GAGAATCAG.GCGAGTCTA	GAGAATCAG.GCGAGTCTA
GAGAATCAG.GGTTCGCAA	GAGAATCAG.GGTTCGCAA
GAGAATCAG.TCGCATTCG	GAGAATCAG.TCGCATTCG
GAGACATTG.CACAACGCT	GAGACATTG.CACAACGCT
GAGACATTG.CCGCTCATG	GAGACATTG.CCGCTCATG
GAGACATTG.GGATCGTTC	GAGACATTG.GGATCGTTC
GAGACATTG.TTCCTTGAC	GAGACATTG.TTCCTTGAC
GAGACGATC.AGTCGCGAC	GAGACGATC.AGTCGCGAC
GAGACGATC.CTGGTCGGT	GAGACGATC.CTGGTCGGT
GAGACGATC.GCACGTAGA	GAGACGATC.GCACGTAGA
GAGACGATC.GTGGATAAG	GAGACGATC.GTGGATAAG
GAGACGATC.TATTACAGC	GAGACGATC.TATTACAGC
GAGACGATC.TGTATGTAG	GAGACGATC.TGTATGTAG
GAGACTCGA.AGCAAGTCC	GAGACTCGA.AGCAAGTCC
GAGACTCGA.AGTTGAGCG	GAGACTCGA.AGTTGAGCG
GAGACTCGA.ATACCGCTT	GAGACTCGA.ATACCGCTT
GAGACTCGA.GAATCACAT	GAGACTCGA.GAATCACAT
GAGACTCGA.GCAGCTCTT	GAGACTCGA.GCAGCTCTT
GAGATACAC.AACAACCTA	GAGATACAC.AACAACCTA
GAGATACAC.AATATCGCT	GAGATACAC.AATATCGCT
GAGATACAC.ACTCCGGTT	GAGATACAC.ACTCCGGTT
GAGATACAC.ATTGGTTCC	GAGATACAC.ATTGGTTCC
GAGATACAC.CCAACAACA	GAGATACAC.CCAACAACA
GAGATACAC.CTCCAGCGT	GAGATACAC.CTCCAGCGT
GAGATACAC.GCGCTCTAT	GAGATACAC.GCGCTCTAT
GAGATGTAT.CCTAGTCTC	GAGATGTAT.CCTAGTCTC
GAGATGTAT.CGGTTCGTA	GAGATGTAT.CGGTTCGTA
GAGATGTAT.GAAGAGCAC	GAGATGTAT.GAAGAGCAC
GAGATGTAT.GCCTTATCT	GAGATGTAT.GCCTTATCT
GAGATTCCT.AATGCGTGC	GAGATTCCT.AATGCGTGC
GAGATTCCT.ATAAGTTCG	GAGATTCCT.ATAAGTTCG
GAGATTCCT.CACCAAGAT	GAGATTCCT.CACCAAGAT
GAGATTCCT.CCACTGAAG	GAGATTCCT.CCACTGAAG
GAGATTCCT.CCTTATCCG	GAGATTCCT.CCTTATCCG
GAGATTCCT.GTGAACCAC	GAGATTCCT.GTGAACCAC
GAGCACATT.AACGAGGTG	GAGCACATT.AACGAGGTG
GAGCACATT.ATAAGTTCG	GAGCACATT.ATAAGTTCG
GAGCAGGAA.GATCTAGAG	GAGCAGGAA.GATCTAGAG
GAGCAGGAA.GTCTTCTCG	GAGCAGGAA.GTCTTCTCG
GAGCATACA.ATATGCAGC	GAGCATACA.ATATGCAGC
GAGCATACA.CAATCATAC	GAGCATACA.CAATCATAC
GAGCATACA.CACTTGGAT	GAGCATACA.CACTTGGAT
GAGCATACA.CGCCATTAC	GAGCATACA.CGCCATTAC
GAGCATACA.CTGCTGCTT	GAGCATACA.CTGCTGCTT
GAGCATACA.CTGTCTAGT	GAGCATACA.CTGTCTAGT
GAGCATACA.GCGAAGACA	GAGCATACA.GCGAAGACA
GAGCATACA.TCTCGATGC	GAGCATACA.TCTCGATGC
GAGCCATCC.ACCGGTTAC	GAGCCATCC.ACCGGTTAC
GAGCCATCC.GAGAACAGG	GAGCCATCC.GAGAACAGG
GAGCCATCC.GCGCTTCTC	GAGCCATCC.GCGCTTCTC
GAGCCATCC.GCTAGCTCC	GAGCCATCC.GCTAGCTCC
GAGCCATCC.TGGAGAGTG	GAGCCATCC.TGGAGAGTG
GAGCCGTTA.CATGACGTT	GAGCCGTTA.CATGACGTT
GAGCGACTC.AAGTCATGA	GAGCGACTC.AAGTCATGA
GAGCGACTC.AATGCAGCG	GAGCGACTC.AATGCAGCG
GAGCGACTC.GAGTGTGCC	GAGCGACTC.GAGTGTGCC
GAGCGACTC.GATCGCACT	GAGCGACTC.GATCGCACT
GAGCGACTC.GCGGTAGTC	GAGCGACTC.GCGGTAGTC
GAGCGACTC.GCTCAATGA	GAGCGACTC.GCTCAATGA
GAGCTCTCA.CCTCTCTAG	GAGCTCTCA.CCTCTCTAG
GAGCTCTCA.GGTTGCTAT	GAGCTCTCA.GGTTGCTAT
GAGCTCTCA.TCGCTTAAC	GAGCTCTCA.TCGCTTAAC
GAGCTCTCA.TGTCTACAC	GAGCTCTCA.TGTCTACAC
GAGCTCTCA.TTGTAATGC	GAGCTCTCA.TTGTAATGC
GAGGACTTA.AACTGATTC	GAGGACTTA.AACTGATTC
GAGGTCACG.TCCAGCTAT	GAGGTCACG.TCCAGCTAT
GAGGTCACG.TGGAGAACC	GAGGTCACG.TGGAGAACC
GAGGTCCTT.CCACGAAGG	GAGGTCCTT.CCACGAAGG
GAGGTCCTT.CGTTGATCC	GAGGTCCTT.CGTTGATCC
GAGGTCCTT.GGATGCGAA	GAGGTCCTT.GGATGCGAA
GAGGTCCTT.TCGCTTAAC	GAGGTCCTT.TCGCTTAAC
GAGGTGAGC.GCCGCTATC	GAGGTGAGC.GCCGCTATC
GAGGTGAGC.GCTAGTGGA	GAGGTGAGC.GCTAGTGGA
GAGGTGAGC.TTATTCGAC	GAGGTGAGC.TTATTCGAC
GAGTCAAGG.GATCGCACT	GAGTCAAGG.GATCGCACT
GAGTCAAGG.GTGCTCTTG	GAGTCAAGG.GTGCTCTTG
GAGTCAAGG.TGGTAGCAG	GAGTCAAGG.TGGTAGCAG
GAGTCAAGG.TTATCCAAG	GAGTCAAGG.TTATCCAAG
GAGTCACCA.ACTCGAGTC	GAGTCACCA.ACTCGAGTC
GAGTCACCA.TCAGGTGCA	GAGTCACCA.TCAGGTGCA
GAGTCCAAT.AGACCAGCT	GAGTCCAAT.AGACCAGCT
GAGTCCAAT.CGCTTATGA	GAGTCCAAT.CGCTTATGA
GAGTCCAAT.TCAAGGTCG	GAGTCCAAT.TCAAGGTCG
GAGTCGTAC.AAGAGAGAG	GAGTCGTAC.AAGAGAGAG
GAGTCGTAC.AGTTACAAG	GAGTCGTAC.AGTTACAAG
GAGTCGTAC.ATCATGTTC	GAGTCGTAC.ATCATGTTC
GAGTCGTAC.GCCTGGAAT	GAGTCGTAC.GCCTGGAAT
GAGTCTTCG.AAGCAATCG	GAGTCTTCG.AAGCAATCG
GAGTCTTCG.CCATATCTT	GAGTCTTCG.CCATATCTT
GAGTCTTCG.CGTCGTCAA	GAGTCTTCG.CGTCGTCAA
GAGTCTTCG.GTTGACCAT	GAGTCTTCG.GTTGACCAT
GAGTCTTCG.TCAATGGAC	GAGTCTTCG.TCAATGGAC
GAGTGCATA.ATCCGTCTC	GAGTGCATA.ATCCGTCTC
GAGTGCATA.CCGGTGGTT	GAGTGCATA.CCGGTGGTT
GAGTGCATA.TCAATGGAC	GAGTGCATA.TCAATGGAC
GAGTGTGCC.AAGAGAACT	GAGTGTGCC.AAGAGAACT
GAGTGTGCC.ATTGATTGG	GAGTGTGCC.ATTGATTGG
GAGTGTGCC.CACGTAGAC	GAGTGTGCC.CACGTAGAC
GAGTGTGCC.CATCCAGGA	GAGTGTGCC.CATCCAGGA
GAGTGTGCC.CGTCTGCTG	GAGTGTGCC.CGTCTGCTG
GAGTGTGCC.CGTGCAAGG	GAGTGTGCC.CGTGCAAGG
GAGTGTGCC.GAGTGCATA	GAGTGTGCC.GAGTGCATA
GAGTGTGCC.GTCTGACGT	GAGTGTGCC.GTCTGACGT
GAGTGTGCC.TAACCGTGA	GAGTGTGCC.TAACCGTGA
GAGTGTGCC.TCTGCAACA	GAGTGTGCC.TCTGCAACA
GAGTGTGCC.TGCCGCTAC	GAGTGTGCC.TGCCGCTAC
GAGTTAACT.CGTCGTCAA	GAGTTAACT.CGTCGTCAA
GAGTTAACT.TGCCGACTA	GAGTTAACT.TGCCGACTA
GAGTTATAG.CACACTGCC	GAGTTATAG.CACACTGCC
GAGTTATAG.GATATGGAC	GAGTTATAG.GATATGGAC
GAGTTATAG.GGACAGATT	GAGTTATAG.GGACAGATT
GAGTTATAG.TGATTATCG	GAGTTATAG.TGATTATCG
GATAACGTC.GCCTGGAAT	GATAACGTC.GCCTGGAAT
GATAACGTC.TGTCGTGAG	GATAACGTC.TGTCGTGAG
GATAAGCTG.AATTCGGAA	GATAAGCTG.AATTCGGAA
GATAAGCTG.AGCCTCGCA	GATAAGCTG.AGCCTCGCA
GATAAGCTG.GAGTCAAGG	GATAAGCTG.GAGTCAAGG
GATAAGCTG.GCTTCACTC	GATAAGCTG.GCTTCACTC
GATACACTA.ACTCCGGTT	GATACACTA.ACTCCGGTT
GATACACTA.CACAGCGAA	GATACACTA.CACAGCGAA
GATACACTA.CACATTCTG	GATACACTA.CACATTCTG
GATACACTA.CCAATGCCT	GATACACTA.CCAATGCCT
GATACACTA.GGTTAGATG	GATACACTA.GGTTAGATG
GATACCGGA.CACGGATAG	GATACCGGA.CACGGATAG
GATACCGGA.GATAAGCTG	GATACCGGA.GATAAGCTG
GATACCGGA.TGCTATGAA	GATACCGGA.TGCTATGAA
GATACCGGA.TGGTGCCTG	GATACCGGA.TGGTGCCTG
GATACTGTG.ACAGGAACT	GATACTGTG.ACAGGAACT
GATACTGTG.ACGGTGCCT	GATACTGTG.ACGGTGCCT
GATACTGTG.ATTGACACG	GATACTGTG.ATTGACACG
GATACTGTG.GATTGAGTA	GATACTGTG.GATTGAGTA
GATACTGTG.GCGACAACC	GATACTGTG.GCGACAACC
GATACTGTG.GTTAGAGAC	GATACTGTG.GTTAGAGAC
GATACTGTG.TATTACAGC	GATACTGTG.TATTACAGC
GATAGTTCT.ACTGGACCA	GATAGTTCT.ACTGGACCA
GATAGTTCT.AGCTATATG	GATAGTTCT.AGCTATATG
GATAGTTCT.ATCAGTCGA	GATAGTTCT.ATCAGTCGA
GATAGTTCT.CAATACCAC	GATAGTTCT.CAATACCAC
GATAGTTCT.GTACGAACG	GATAGTTCT.GTACGAACG
GATAGTTCT.GTTGATGCA	GATAGTTCT.GTTGATGCA
GATAGTTCT.TAGCTGTTG	GATAGTTCT.TAGCTGTTG
GATAGTTCT.TGACCTATG	GATAGTTCT.TGACCTATG
GATAGTTCT.TTGCTCTGC	GATAGTTCT.TTGCTCTGC
GATATATCC.ACTGGTCAG	GATATATCC.ACTGGTCAG
GATATATCC.AGACGGAGG	GATATATCC.AGACGGAGG
GATATATCC.AGTCTGGAA	GATATATCC.AGTCTGGAA
GATATATCC.CTGACGATG	GATATATCC.CTGACGATG
GATATGGAC.ATCACCGCA	GATATGGAC.ATCACCGCA
GATATGGAC.CTTATCTCA	GATATGGAC.CTTATCTCA
GATATGGAC.GTTCAGAAG	GATATGGAC.GTTCAGAAG
GATCCGCAC.CGTGTGTGG	GATCCGCAC.CGTGTGTGG
GATCCGCAC.CTATTAAGG	GATCCGCAC.CTATTAAGG
GATCCGCAC.GCCTTATCT	GATCCGCAC.GCCTTATCT
GATCCGCAC.TACAACACC	GATCCGCAC.TACAACACC
GATCGATAC.CAAGTCGAA	GATCGATAC.CAAGTCGAA
GATCGATAC.CGACCTGTA	GATCGATAC.CGACCTGTA
GATCGATAC.GTAACTCAT	GATCGATAC.GTAACTCAT
GATCGATAC.GTGTCACAC	GATCGATAC.GTGTCACAC
GATCGCACT.ATCAGGATG	GATCGCACT.ATCAGGATG
GATCGCACT.CGGACAAGT	GATCGCACT.CGGACAAGT
GATCGCGAA.AATCCGCTG	GATCGCGAA.AATCCGCTG
GATCGCGAA.ATGTCGCCT	GATCGCGAA.ATGTCGCCT
GATCGCGAA.CGCGAGTGT	GATCGCGAA.CGCGAGTGT
GATCGCGAA.GCCGTTGTT	GATCGCGAA.GCCGTTGTT
GATCGTTGA.AAGCCAAGT	GATCGTTGA.AAGCCAAGT
GATCGTTGA.ATCTACATC	GATCGTTGA.ATCTACATC
GATCGTTGA.TACGACTTG	GATCGTTGA.TACGACTTG
GATCGTTGA.TCGGACAGT	GATCGTTGA.TCGGACAGT
GATCTACTT.ACCGGTTAC	GATCTACTT.ACCGGTTAC
GATCTACTT.AGTTCAACC	GATCTACTT.AGTTCAACC
GATCTACTT.CATATGTCG	GATCTACTT.CATATGTCG
GATCTACTT.GACTGCGCA	GATCTACTT.GACTGCGCA
GATCTACTT.GAGTATCGC	GATCTACTT.GAGTATCGC
GATCTACTT.GCGTGAGCT	GATCTACTT.GCGTGAGCT
GATCTACTT.GCTCTGTGT	GATCTACTT.GCTCTGTGT
GATCTACTT.GTGGAGGTC	GATCTACTT.GTGGAGGTC
GATCTACTT.TGGTAGCAG	GATCTACTT.TGGTAGCAG
GATCTAGAG.ATACTTGCT	GATCTAGAG.ATACTTGCT
GATCTAGAG.CCGGATTGC	GATCTAGAG.CCGGATTGC
GATCTGAAT.ACTCCGGTT	GATCTGAAT.ACTCCGGTT
GATCTGAAT.AGAAGTCCT	GATCTGAAT.AGAAGTCCT
GATCTGAAT.AGATGAAGA	GATCTGAAT.AGATGAAGA
GATCTGAAT.ATTGATTGG	GATCTGAAT.ATTGATTGG
GATCTGAAT.CAAGAGAGT	GATCTGAAT.CAAGAGAGT
GATCTGAAT.GGAACCTAG	GATCTGAAT.GGAACCTAG
GATCTGAAT.GTCTCCAGG	GATCTGAAT.GTCTCCAGG
GATCTGAAT.TCATCAGAG	GATCTGAAT.TCATCAGAG
GATCTGAAT.TGCTCACAC	GATCTGAAT.TGCTCACAC
GATCTGTTC.AGTTCAACC	GATCTGTTC.AGTTCAACC
GATCTGTTC.CCATTCTGC	GATCTGTTC.CCATTCTGC
GATCTGTTC.GCGTGATAC	GATCTGTTC.GCGTGATAC
GATCTTCGC.AGTGACGAT	GATCTTCGC.AGTGACGAT
GATCTTCGC.GGACTCCTT	GATCTTCGC.GGACTCCTT
GATCTTCGC.TGAGAATCC	GATCTTCGC.TGAGAATCC
GATCTTCGC.TGTCAACCT	GATCTTCGC.TGTCAACCT
GATGCAGAA.AAGTAGGAC	GATGCAGAA.AAGTAGGAC
GATGCAGAA.AGCGTAGAA	GATGCAGAA.AGCGTAGAA
GATGCAGAA.AGTCGCGAC	GATGCAGAA.AGTCGCGAC
GATGCAGAA.CCTGTATCT	GATGCAGAA.CCTGTATCT
GATGCAGAA.GCACCATCG	GATGCAGAA.GCACCATCG
GATGCAGAA.GCCGTGAAC	GATGCAGAA.GCCGTGAAC
GATGCAGAA.TACTAGTAG	GATGCAGAA.TACTAGTAG
GATGCAGAA.TCTCATCGG	GATGCAGAA.TCTCATCGG
GATGCGACG.ATGGAGGAA	GATGCGACG.ATGGAGGAA
GATGCGACG.GCCGCCTAA	GATGCGACG.GCCGCCTAA
GATGCGACG.GTAATCAGC	GATGCGACG.GTAATCAGC
GATGCGACG.GTCAATACA	GATGCGACG.GTCAATACA
GATGCGACG.TCGTACCTT	GATGCGACG.TCGTACCTT
GATGCGACG.TGATTGTGC	GATGCGACG.TGATTGTGC
GATGCGGTT.TCTCCGCGT	GATGCGGTT.TCTCCGCGT
GATGCGGTT.TGACAAGTT	GATGCGGTT.TGACAAGTT
GATGCTCCT.ACCGATCGA	GATGCTCCT.ACCGATCGA
GATGCTCCT.GACGTCAAT	GATGCTCCT.GACGTCAAT
GATGCTCCT.GTCGCAGGT	GATGCTCCT.GTCGCAGGT
GATGTAAGG.ACATCGTCC	GATGTAAGG.ACATCGTCC
GATGTAAGG.ATTCATGTG	GATGTAAGG.ATTCATGTG
GATGTCTAG.AGACCAGCT	GATGTCTAG.AGACCAGCT
GATGTCTAG.ATCAAGAGA	GATGTCTAG.ATCAAGAGA
GATGTCTAG.CCTATTCAA	GATGTCTAG.CCTATTCAA
GATGTCTAG.CGGATTCTC	GATGTCTAG.CGGATTCTC
GATGTCTAG.GCTGACAGA	GATGTCTAG.GCTGACAGA
GATGTTACA.ACACTGTGA	GATGTTACA.ACACTGTGA
GATGTTACA.ATATCCGAT	GATGTTACA.ATATCCGAT
GATGTTACA.CACAGCGAA	GATGTTACA.CACAGCGAA
GATGTTACA.CACGGAAGT	GATGTTACA.CACGGAAGT
GATGTTACA.TTCTGAATG	GATGTTACA.TTCTGAATG
GATTAGACA.AACGGAGAT	GATTAGACA.AACGGAGAT
GATTAGACA.CAATGTGCT	GATTAGACA.CAATGTGCT
GATTAGACA.GCATGTAAG	GATTAGACA.GCATGTAAG
GATTAGACA.GCCATACAA	GATTAGACA.GCCATACAA
GATTAGACA.GGTGATAGG	GATTAGACA.GGTGATAGG
GATTAGACA.TTGGAGAAC	GATTAGACA.TTGGAGAAC
GATTAGTGT.ATCCAGCTG	GATTAGTGT.ATCCAGCTG
GATTAGTGT.CCGCTCATG	GATTAGTGT.CCGCTCATG
GATTAGTGT.CGAGCCGTT	GATTAGTGT.CGAGCCGTT
GATTAGTGT.GGATCAGGT	GATTAGTGT.GGATCAGGT
GATTATGCG.AATCGTGTT	GATTATGCG.AATCGTGTT
GATTATGCG.ACACCACAT	GATTATGCG.ACACCACAT
GATTATGCG.ACGAATCGC	GATTATGCG.ACGAATCGC
GATTATGCG.CAAGCCTCG	GATTATGCG.CAAGCCTCG
GATTATGCG.CCACTACCA	GATTATGCG.CCACTACCA
GATTATGCG.CTGAGGTTA	GATTATGCG.CTGAGGTTA
GATTATGCG.GTACCTAAC	GATTATGCG.GTACCTAAC
GATTCCTCT.GCGACAACC	GATTCCTCT.GCGACAACC
GATTCTCGG.ACGTCGCTC	GATTCTCGG.ACGTCGCTC
GATTCTCGG.CCACTTCGC	GATTCTCGG.CCACTTCGC
GATTCTCGG.CGCGATGTA	GATTCTCGG.CGCGATGTA
GATTCTCGG.CTCCTATCT	GATTCTCGG.CTCCTATCT
GATTCTCGG.TATGACCGA	GATTCTCGG.TATGACCGA
GATTCTCGG.TGTAGCAAG	GATTCTCGG.TGTAGCAAG
GATTCTCGG.TTGACCTGA	GATTCTCGG.TTGACCTGA
GATTGAGTA.CGCTTGTAG	GATTGAGTA.CGCTTGTAG
GATTGAGTA.GCCGTGAAC	GATTGAGTA.GCCGTGAAC
GATTGAGTA.TCGCGTCAT	GATTGAGTA.TCGCGTCAT
GATTGAGTA.TGCCGAACT	GATTGAGTA.TGCCGAACT
GATTGGAAG.TATACCACT	GATTGGAAG.TATACCACT
GCAACACCT.GCTGGTTCG	GCAACACCT.GCTGGTTCG
GCAACCAAC.AGCTCTCCG	GCAACCAAC.AGCTCTCCG
GCAACCAAC.CATCTCACG	GCAACCAAC.CATCTCACG
GCAACCAAC.CGATTCGAG	GCAACCAAC.CGATTCGAG
GCAACCAAC.GAACGCTGT	GCAACCAAC.GAACGCTGT
GCAACCAAC.GATTATGCG	GCAACCAAC.GATTATGCG
GCAACCAAC.GCGAGTCTA	GCAACCAAC.GCGAGTCTA
GCAACCAAC.TCAAGGTCG	GCAACCAAC.TCAAGGTCG
GCAACTCGC.ACACACGTC	GCAACTCGC.ACACACGTC
GCAACTCGC.ATATCCGAT	GCAACTCGC.ATATCCGAT
GCAACTCGC.CATTCGAAT	GCAACTCGC.CATTCGAAT
GCAACTCGC.GCACATGTT	GCAACTCGC.GCACATGTT
GCAACTCGC.GCATGTGGT	GCAACTCGC.GCATGTGGT
GCAACTCGC.TCCAAGTAA	GCAACTCGC.TCCAAGTAA
GCAACTCGC.TGTGTAGAG	GCAACTCGC.TGTGTAGAG
GCAATCACG.ATGACACAA	GCAATCACG.ATGACACAA
GCAATCACG.CAGTGAGGA	GCAATCACG.CAGTGAGGA
GCAATCACG.TCGCGTCAT	GCAATCACG.TCGCGTCAT
GCAATCACG.TCGTCCGAT	GCAATCACG.TCGTCCGAT
GCAATCACG.TGAGACAGC	GCAATCACG.TGAGACAGC
GCAATGAGA.CGATACTCT	GCAATGAGA.CGATACTCT
GCAATGAGA.TCGTTCTCC	GCAATGAGA.TCGTTCTCC
GCAATGAGA.TGCATCGGA	GCAATGAGA.TGCATCGGA
GCACAACTC.ACAGGAACT	GCACAACTC.ACAGGAACT
GCACAACTC.CCATACGAT	GCACAACTC.CCATACGAT
GCACAACTC.CTACGTTGG	GCACAACTC.CTACGTTGG
GCACAACTC.GAATAAGAG	GCACAACTC.GAATAAGAG
GCACAACTC.GCAGCTCTT	GCACAACTC.GCAGCTCTT
GCACAGTAA.AGCTCTCCG	GCACAGTAA.AGCTCTCCG
GCACAGTAA.ATCGATCCT	GCACAGTAA.ATCGATCCT
GCACAGTAA.CCACTTCGC	GCACAGTAA.CCACTTCGC
GCACAGTAA.GAACATGAC	GCACAGTAA.GAACATGAC
GCACAGTAA.GATCGATAC	GCACAGTAA.GATCGATAC
GCACAGTAA.TAAGCCATT	GCACAGTAA.TAAGCCATT
GCACAGTAA.TCCAAGTAA	GCACAGTAA.TCCAAGTAA
GCACAGTAA.TCCGTATAC	GCACAGTAA.TCCGTATAC
GCACAGTAA.TGCAGATGC	GCACAGTAA.TGCAGATGC
GCACATGTT.ATAGTGGTT	GCACATGTT.ATAGTGGTT
GCACATGTT.GCTACAATG	GCACATGTT.GCTACAATG
GCACATGTT.GTAACAGTC	GCACATGTT.GTAACAGTC
GCACATGTT.GTTCAGAAG	GCACATGTT.GTTCAGAAG
GCACATGTT.TTCTCCACA	GCACATGTT.TTCTCCACA
GCACGCATT.AAGCACAAC	GCACGCATT.AAGCACAAC
GCACGCATT.ATCCGACCA	GCACGCATT.ATCCGACCA
GCACGCATT.CAGTACATC	GCACGCATT.CAGTACATC
GCACGCATT.CATCGCTGG	GCACGCATT.CATCGCTGG
GCACGCATT.CTGGACTAA	GCACGCATT.CTGGACTAA
GCACGCATT.CTTCTGAGT	GCACGCATT.CTTCTGAGT
GCACGCATT.GCCGAGTCT	GCACGCATT.GCCGAGTCT
GCACGCATT.TAAGGTGAT	GCACGCATT.TAAGGTGAT
GCACGCATT.TATAATCGC	GCACGCATT.TATAATCGC
GCACGTAGA.AGTCGCGAC	GCACGTAGA.AGTCGCGAC
GCACGTAGA.ATAACGACA	GCACGTAGA.ATAACGACA
GCACGTAGA.CTTAGGACT	GCACGTAGA.CTTAGGACT
GCACTGGAT.AAGACTACC	GCACTGGAT.AAGACTACC
GCACTGGAT.AAGGTGCTG	GCACTGGAT.AAGGTGCTG
GCACTGGAT.ACACCGCCA	GCACTGGAT.ACACCGCCA
GCACTGGAT.ATATCCGAT	GCACTGGAT.ATATCCGAT
GCACTGGAT.CGCGATGTA	GCACTGGAT.CGCGATGTA
GCACTGGAT.GACGTGGTC	GCACTGGAT.GACGTGGTC
GCACTGGAT.GTAAGTGAG	GCACTGGAT.GTAAGTGAG
GCACTGGAT.GTTCACTCC	GCACTGGAT.GTTCACTCC
GCAGATCCG.AACGAGGTG	GCAGATCCG.AACGAGGTG
GCAGATCCG.AGAGCCGCA	GCAGATCCG.AGAGCCGCA
GCAGATCCG.AGTACTCTC	GCAGATCCG.AGTACTCTC
GCAGATCCG.CCTAAGTCT	GCAGATCCG.CCTAAGTCT
GCAGATCCG.TTAACGTTC	GCAGATCCG.TTAACGTTC
GCAGCAGTG.AACGTTCTT	GCAGCAGTG.AACGTTCTT
GCAGCAGTG.AGAAGTCCT	GCAGCAGTG.AGAAGTCCT
GCAGCAGTG.AGTGAGAGA	GCAGCAGTG.AGTGAGAGA
GCAGCAGTG.TCACCGAGG	GCAGCAGTG.TCACCGAGG
GCAGCGATA.CGCTTGTAG	GCAGCGATA.CGCTTGTAG
GCAGCGATA.GAGATACAC	GCAGCGATA.GAGATACAC
GCAGCGATA.TCGCATTCG	GCAGCGATA.TCGCATTCG
GCAGCGATA.TTGGAGAAC	GCAGCGATA.TTGGAGAAC
GCAGCTCTT.AACTGATTC	GCAGCTCTT.AACTGATTC
GCAGCTCTT.AATACGTCT	GCAGCTCTT.AATACGTCT
GCAGCTCTT.AATGTGCGT	GCAGCTCTT.AATGTGCGT
GCAGCTCTT.CACTAGACT	GCAGCTCTT.CACTAGACT
GCAGCTCTT.CCGATCTCT	GCAGCTCTT.CCGATCTCT
GCAGCTCTT.CCTCATAAC	GCAGCTCTT.CCTCATAAC
GCAGCTCTT.GACGCCGTA	GCAGCTCTT.GACGCCGTA
GCAGCTCTT.GAGCCGTTA	GCAGCTCTT.GAGCCGTTA
GCAGCTCTT.TGGTAGCAG	GCAGCTCTT.TGGTAGCAG
GCAGCTTGA.CCGCAACAC	GCAGCTTGA.CCGCAACAC
GCAGCTTGA.GAGAATCAG	GCAGCTTGA.GAGAATCAG
GCAGCTTGA.GCCTTCCAT	GCAGCTTGA.GCCTTCCAT
GCAGCTTGA.TAGCGCAGC	GCAGCTTGA.TAGCGCAGC
GCAGGAGAA.AGAGGACGT	GCAGGAGAA.AGAGGACGT
GCAGGAGAA.AGTGATGCG	GCAGGAGAA.AGTGATGCG
GCAGGAGAA.CGTGCTTGA	GCAGGAGAA.CGTGCTTGA
GCAGGAGAA.GATCTGAAT	GCAGGAGAA.GATCTGAAT
GCAGGAGAA.GGACTCCTT	GCAGGAGAA.GGACTCCTT
GCAGGAGAA.TGCTCAGCG	GCAGGAGAA.TGCTCAGCG
GCATACATG.AGTCTGGAA	GCATACATG.AGTCTGGAA
GCATACATG.CGCGAGTGT	GCATACATG.CGCGAGTGT
GCATACATG.TAGAGCCAG	GCATACATG.TAGAGCCAG
GCATACATG.TCATATCGC	GCATACATG.TCATATCGC
GCATACTCC.AGCGACACC	GCATACTCC.AGCGACACC
GCATACTCC.CAGCTTCGA	GCATACTCC.CAGCTTCGA
GCATACTCC.CAGTACATC	GCATACTCC.CAGTACATC
GCATACTCC.TCACGCGAC	GCATACTCC.TCACGCGAC
GCATGTAAG.ACAATTCGG	GCATGTAAG.ACAATTCGG
GCATGTAAG.CCACACAGA	GCATGTAAG.CCACACAGA
GCATGTAAG.GTAGACTCT	GCATGTAAG.GTAGACTCT
GCATGTGGT.CCAGTCTCA	GCATGTGGT.CCAGTCTCA
GCATGTGGT.CCGACTTGG	GCATGTGGT.CCGACTTGG
GCATGTGGT.CCTGCAGAT	GCATGTGGT.CCTGCAGAT
GCATGTGGT.CCTGCGTTA	GCATGTGGT.CCTGCGTTA
GCATGTGGT.CTAACACTG	GCATGTGGT.CTAACACTG
GCATGTGGT.GGAGACACA	GCATGTGGT.GGAGACACA
GCATGTGGT.TAACGGATA	GCATGTGGT.TAACGGATA
GCATGTGGT.TCACGACAA	GCATGTGGT.TCACGACAA
GCATTGATC.CAGGTTGTC	GCATTGATC.CAGGTTGTC
GCATTGATC.CTTCACTGT	GCATTGATC.CTTCACTGT
GCATTGATC.TATCTGTCA	GCATTGATC.TATCTGTCA
GCATTGATC.TCCTCGTCG	GCATTGATC.TCCTCGTCG
GCCAACAAT.AACGTCGAG	GCCAACAAT.AACGTCGAG
GCCAACAAT.GTATGATCT	GCCAACAAT.GTATGATCT
GCCAATGAA.TACCTATCC	GCCAATGAA.TACCTATCC
GCCAATGAA.TGTGAGTAT	GCCAATGAA.TGTGAGTAT
GCCAATGAA.TTGCAGTCA	GCCAATGAA.TTGCAGTCA
GCCACATGG.AATCAGGAG	GCCACATGG.AATCAGGAG
GCCACGAGT.GAGGTCCTT	GCCACGAGT.GAGGTCCTT
GCCACGAGT.GCATACTCC	GCCACGAGT.GCATACTCC
GCCACGAGT.GCTTACGTT	GCCACGAGT.GCTTACGTT
GCCACGAGT.GGTAACTAC	GCCACGAGT.GGTAACTAC
GCCACGAGT.TATCACCTG	GCCACGAGT.TATCACCTG
GCCATACAA.ATCATTACG	GCCATACAA.ATCATTACG
GCCATACAA.ATTCCGTAC	GCCATACAA.ATTCCGTAC
GCCATACAA.GGTAACTAC	GCCATACAA.GGTAACTAC
GCCATACAA.TAATGTAGC	GCCATACAA.TAATGTAGC
GCCATCGCT.CGACCACTT	GCCATCGCT.CGACCACTT
GCCATCGCT.GCAACTCGC	GCCATCGCT.GCAACTCGC
GCCATTAAG.CTTCACTGT	GCCATTAAG.CTTCACTGT
GCCATTAAG.GATACTGTG	GCCATTAAG.GATACTGTG
GCCATTAAG.GTGAGGACG	GCCATTAAG.GTGAGGACG
GCCATTAAG.TAGAGCCAG	GCCATTAAG.TAGAGCCAG
GCCGAACCA.CAACACCTA	GCCGAACCA.CAACACCTA
GCCGAACCA.GAGCCGTTA	GCCGAACCA.GAGCCGTTA
GCCGAACCA.TGCAGATGC	GCCGAACCA.TGCAGATGC
GCCGAGTCT.ACCGATCGA	GCCGAGTCT.ACCGATCGA
GCCGAGTCT.ATGCTGTCG	GCCGAGTCT.ATGCTGTCG
GCCGAGTCT.CATCGAAGC	GCCGAGTCT.CATCGAAGC
GCCGAGTCT.CTATGGATG	GCCGAGTCT.CTATGGATG
GCCGAGTCT.GACGGTGCT	GCCGAGTCT.GACGGTGCT
GCCGAGTCT.GCTACCGAG	GCCGAGTCT.GCTACCGAG
GCCGAGTCT.GTGACGTAA	GCCGAGTCT.GTGACGTAA
GCCGAGTCT.TCTGCAACA	GCCGAGTCT.TCTGCAACA
