TTCCTGCTA.AAGGAACAG	TTCCTGCTA.AAGGAACAG
TTCCTGCTA.GGTCGGATA	TTCCTGCTA.GGTCGGATA
TTCCTTGAC.AGTTCAACC	TTCCTTGAC.AGTTCAACC
TTCCTTGAC.CGTTACACC	TTCCTTGAC.CGTTACACC
TTCGCTGAG.TGAACTTGC	TTCGCTGAG.TGAACTTGC
TTCGGAGTC.CTCGACGAT	TTCGGAGTC.CTCGACGAT
TTCGGAGTC.GACATATGT	TTCGGAGTC.GACATATGT
TTCGGAGTC.GCCGCTATC	TTCGGAGTC.GCCGCTATC
TTCGTGATG.ACGTATGTC	TTCGTGATG.ACGTATGTC
TTCGTGATG.ATATGTCCA	TTCGTGATG.ATATGTCCA
TTCGTGATG.CACAGCGAA	TTCGTGATG.CACAGCGAA
TTCGTGATG.CAGTCGGTA	TTCGTGATG.CAGTCGGTA
TTCGTGATG.CCTTCGAGC	TTCGTGATG.CCTTCGAGC
TTCGTGATG.GATTGAGTA	TTCGTGATG.GATTGAGTA
TTCGTGATG.GCGACAACC	TTCGTGATG.GCGACAACC
TTCGTGATG.TGAACGGTT	TTCGTGATG.TGAACGGTT
TTCTCCACA.GGATTACGC	TTCTCCACA.GGATTACGC
TTCTCCACA.GTCCTTCAT	TTCTCCACA.GTCCTTCAT
TTCTCCACA.TCCTTCAAC	TTCTCCACA.TCCTTCAAC
TTCTCCACA.TGTGAGTAT	TTCTCCACA.TGTGAGTAT
TTCTGAATG.AGGTGCGAG	TTCTGAATG.AGGTGCGAG
TTCTGAATG.TAGATCTGT	TTCTGAATG.TAGATCTGT
TTCTGAATG.TCTAGGATG	TTCTGAATG.TCTAGGATG
TTCTGAATG.TGATGTGTG	TTCTGAATG.TGATGTGTG
TTCTGAATG.TTCACTGGA	TTCTGAATG.TTCACTGGA
TTCTGCCGA.CGCAACCTC	TTCTGCCGA.CGCAACCTC
TTCTGCCGA.CTCTGCGGT	TTCTGCCGA.CTCTGCGGT
TTCTGCCGA.TACATGCAC	TTCTGCCGA.TACATGCAC
TTCTGCCGA.TCTGATGAA	TTCTGCCGA.TCTGATGAA
TTCTGGTGC.ACGCTCTTA	TTCTGGTGC.ACGCTCTTA
TTCTGGTGC.CAGTACATC	TTCTGGTGC.CAGTACATC
TTCTGGTGC.CATGGTTAC	TTCTGGTGC.CATGGTTAC
TTCTGGTGC.CTTGTAACG	TTCTGGTGC.CTTGTAACG
TTCTGGTGC.GTGCTAAGC	TTCTGGTGC.GTGCTAAGC
TTGACCTGA.AGCAGACAA	TTGACCTGA.AGCAGACAA
TTGACCTGA.ATCAGAAGC	TTGACCTGA.ATCAGAAGC
TTGACCTGA.GCATACTCC	TTGACCTGA.GCATACTCC
TTGAGACGG.AATCAGGAG	TTGAGACGG.AATCAGGAG
TTGAGACGG.ACATGACTA	TTGAGACGG.ACATGACTA
TTGAGACGG.CACTGGTCC	TTGAGACGG.CACTGGTCC
TTGAGACGG.CCTAGCAAT	TTGAGACGG.CCTAGCAAT
TTGAGACGG.CTACCTGCG	TTGAGACGG.CTACCTGCG
TTGAGACGG.CTGACAGCA	TTGAGACGG.CTGACAGCA
TTGAGCTCT.TCAGCTCAG	TTGAGCTCT.TCAGCTCAG
TTGATCGTA.AACTTCTGC	TTGATCGTA.AACTTCTGC
TTGATCGTA.ACCATGTCT	TTGATCGTA.ACCATGTCT
TTGATCGTA.CAACTAATC	TTGATCGTA.CAACTAATC
TTGATCGTA.CACTGGTCC	TTGATCGTA.CACTGGTCC
TTGATGAGT.TAGAGCGTC	TTGATGAGT.TAGAGCGTC
TTGATGAGT.TCTTGGTAG	TTGATGAGT.TCTTGGTAG
TTGATGAGT.TGATTGTGC	TTGATGAGT.TGATTGTGC
TTGATGCTG.AAGTACAGA	TTGATGCTG.AAGTACAGA
TTGATGCTG.ACACTAACG	TTGATGCTG.ACACTAACG
TTGATGCTG.ACTCTAGGA	TTGATGCTG.ACTCTAGGA
TTGATGCTG.CCTCCTTGT	TTGATGCTG.CCTCCTTGT
TTGATGCTG.CTATTCCGT	TTGATGCTG.CTATTCCGT
TTGATGCTG.CTGACGATG	TTGATGCTG.CTGACGATG
TTGATGCTG.TAAGTGTAG	TTGATGCTG.TAAGTGTAG
TTGCAGTCA.CGACGTACG	TTGCAGTCA.CGACGTACG
TTGCAGTCA.GAGATGTAT	TTGCAGTCA.GAGATGTAT
TTGCAGTCA.GGACAGATT	TTGCAGTCA.GGACAGATT
TTGCAGTCA.GTAGACTCT	TTGCAGTCA.GTAGACTCT
TTGCCAGAT.ACAATTCGG	TTGCCAGAT.ACAATTCGG
TTGCCAGAT.ATTCGAAGA	TTGCCAGAT.ATTCGAAGA
TTGCCAGAT.GAATCACAT	TTGCCAGAT.GAATCACAT
TTGCCAGAT.TGCTCAGCG	TTGCCAGAT.TGCTCAGCG
TTGCCAGAT.TTACTTACG	TTGCCAGAT.TTACTTACG
TTGCCGTAG.ACTCGTCTA	TTGCCGTAG.ACTCGTCTA
TTGCCGTAG.AGCAACATT	TTGCCGTAG.AGCAACATT
TTGCCGTAG.GGTTCAGAC	TTGCCGTAG.GGTTCAGAC
TTGCGAACA.AGGTGTACA	TTGCGAACA.AGGTGTACA
TTGCGAACA.ATACAACCG	TTGCGAACA.ATACAACCG
TTGCGAACA.TGATGTGTG	TTGCGAACA.TGATGTGTG
TTGCTCTGC.CCGGTTCTA	TTGCTCTGC.CCGGTTCTA
TTGCTCTGC.CCGTTCCAA	TTGCTCTGC.CCGTTCCAA
TTGCTCTGC.CCTGTTAGC	TTGCTCTGC.CCTGTTAGC
TTGCTCTGC.CGAATGAGT	TTGCTCTGC.CGAATGAGT
TTGCTCTGC.GCCTTGTGA	TTGCTCTGC.GCCTTGTGA
TTGCTCTGC.TCCTCTAGT	TTGCTCTGC.TCCTCTAGT
TTGCTCTGC.TGGAATCGT	TTGCTCTGC.TGGAATCGT
TTGGACTTC.ACATCGTCC	TTGGACTTC.ACATCGTCC
TTGGACTTC.AGTCCGTGT	TTGGACTTC.AGTCCGTGT
TTGGACTTC.ATTGATCAC	TTGGACTTC.ATTGATCAC
TTGGACTTC.CCTGCTCCA	TTGGACTTC.CCTGCTCCA
TTGGACTTC.GATGCGGTT	TTGGACTTC.GATGCGGTT
TTGGACTTC.GCAATGAGA	TTGGACTTC.GCAATGAGA
TTGGACTTC.TTCATCCAA	TTGGACTTC.TTCATCCAA
TTGGACTTC.TTCTGGTGC	TTGGACTTC.TTCTGGTGC
TTGGAGAAC.CAAGAGAGT	TTGGAGAAC.CAAGAGAGT
TTGGTAACT.ATTAGCCAC	TTGGTAACT.ATTAGCCAC
TTGTAATGC.CACCTCAAC	TTGTAATGC.CACCTCAAC
TTGTAATGC.CGAGCTTAC	TTGTAATGC.CGAGCTTAC
TTGTAATGC.CTTGATCTA	TTGTAATGC.CTTGATCTA
TTGTAATGC.GACACGCAA	TTGTAATGC.GACACGCAA
TTGTAATGC.TGCTCACAC	TTGTAATGC.TGCTCACAC
TTGTATCAC.AGATATGGA	TTGTATCAC.AGATATGGA
TTGTATCAC.CATCAATAG	TTGTATCAC.CATCAATAG
TTGTATCAC.CCTAAGTCT	TTGTATCAC.CCTAAGTCT
TTGTATCAC.TAAGCCATT	TTGTATCAC.TAAGCCATT
TTGTCAACC.AGTTAGGTC	TTGTCAACC.AGTTAGGTC
TTGTCAACC.CCACACAGA	TTGTCAACC.CCACACAGA
TTGTCAACC.CGTCTGCTG	TTGTCAACC.CGTCTGCTG
TTGTCAACC.CTCGACTGC	TTGTCAACC.CTCGACTGC
TTGTCAACC.GTCGACATT	TTGTCAACC.GTCGACATT
TTGTCAACC.TACGTTGGA	TTGTCAACC.TACGTTGGA
TTGTTAGAG.AACTGCGAC	TTGTTAGAG.AACTGCGAC
TTGTTAGAG.AGAGGTGAA	TTGTTAGAG.AGAGGTGAA
TTGTTAGAG.GGATACAAT	TTGTTAGAG.GGATACAAT
TTGTTAGAG.TCTCCGCGT	TTGTTAGAG.TCTCCGCGT
TTGTTAGAG.TGCTCACAC	TTGTTAGAG.TGCTCACAC
