CCTCGCGTT.TGCCAGACG	CCTCGCGTT.TGCCAGACG
CCTCGCGTT.TTAAGTGGT	CCTCGCGTT.TTAAGTGGT
CCTCGGTCA.CGGTTCTAT	CCTCGGTCA.CGGTTCTAT
CCTCGGTCA.GACGCCGTA	CCTCGGTCA.GACGCCGTA
CCTCGGTCA.GTGAGGACG	CCTCGGTCA.GTGAGGACG
CCTCGGTCA.TAGGTCAAC	CCTCGGTCA.TAGGTCAAC
CCTCTCTAG.ACCATCTAA	CCTCTCTAG.ACCATCTAA
CCTCTCTAG.CGCATAACT	CCTCTCTAG.CGCATAACT
CCTCTCTAG.CGTGCCTAT	CCTCTCTAG.CGTGCCTAT
CCTCTCTAG.GATCGATAC	CCTCTCTAG.GATCGATAC
CCTCTCTAG.GCACCATCG	CCTCTCTAG.GCACCATCG
CCTCTGCAT.GTAGTTGGT	CCTCTGCAT.GTAGTTGGT
CCTCTGCAT.TACAACACC	CCTCTGCAT.TACAACACC
CCTCTTGTA.AAGTTCTCT	CCTCTTGTA.AAGTTCTCT
CCTCTTGTA.CCAATATAC	CCTCTTGTA.CCAATATAC
CCTCTTGTA.GAGAACAGG	CCTCTTGTA.GAGAACAGG
CCTCTTGTA.GGTACGAGC	CCTCTTGTA.GGTACGAGC
CCTGACCTC.AGTGACGAT	CCTGACCTC.AGTGACGAT
CCTGACCTC.CGTATTCCT	CCTGACCTC.CGTATTCCT
CCTGACCTC.CTAGGTACT	CCTGACCTC.CTAGGTACT
CCTGACCTC.CTTCTGAGT	CCTGACCTC.CTTCTGAGT
CCTGACCTC.GAACAACCA	CCTGACCTC.GAACAACCA
CCTGACCTC.GACTTCACC	CCTGACCTC.GACTTCACC
CCTGACCTC.GGTACTTCC	CCTGACCTC.GGTACTTCC
CCTGACCTC.TCAAGCGTA	CCTGACCTC.TCAAGCGTA
CCTGCAGAT.CACGGATAG	CCTGCAGAT.CACGGATAG
CCTGCAGAT.CGGAACGAG	CCTGCAGAT.CGGAACGAG
CCTGCAGAT.CGGTGAGTC	CCTGCAGAT.CGGTGAGTC
CCTGCAGAT.TATGATGTG	CCTGCAGAT.TATGATGTG
CCTGCAGAT.TCAGTAAGC	CCTGCAGAT.TCAGTAAGC
CCTGCGTTA.AAGTTCTCT	CCTGCGTTA.AAGTTCTCT
CCTGCGTTA.AATCGTGTT	CCTGCGTTA.AATCGTGTT
CCTGCGTTA.ACCTTGAAG	CCTGCGTTA.ACCTTGAAG
CCTGCGTTA.AGTAAGCCA	CCTGCGTTA.AGTAAGCCA
CCTGCGTTA.ATGAGATCC	CCTGCGTTA.ATGAGATCC
CCTGCGTTA.CCGATGTTC	CCTGCGTTA.CCGATGTTC
CCTGCGTTA.TCGTAGGAA	CCTGCGTTA.TCGTAGGAA
CCTGCGTTA.TGGATAGGT	CCTGCGTTA.TGGATAGGT
CCTGCTCCA.GGTGTTCAT	CCTGCTCCA.GGTGTTCAT
CCTGCTCCA.GTAAGTGAG	CCTGCTCCA.GTAAGTGAG
CCTGCTCCA.TAGGATTAG	CCTGCTCCA.TAGGATTAG
CCTGTATCT.CACCTAGCG	CCTGTATCT.CACCTAGCG
CCTGTATCT.CCACACAGA	CCTGTATCT.CCACACAGA
CCTGTATCT.CGTATCGAA	CCTGTATCT.CGTATCGAA
CCTGTATCT.GATTAGACA	CCTGTATCT.GATTAGACA
CCTGTATCT.GCAGCTCTT	CCTGTATCT.GCAGCTCTT
CCTGTATCT.GCGCTAGAA	CCTGTATCT.GCGCTAGAA
CCTGTCATT.ATCGAATCG	CCTGTCATT.ATCGAATCG
CCTGTCATT.CCGCAATGG	CCTGTCATT.CCGCAATGG
CCTGTCATT.GTAGACTCT	CCTGTCATT.GTAGACTCT
CCTGTCATT.GTCACAGAG	CCTGTCATT.GTCACAGAG
CCTGTCATT.GTGCTCTTG	CCTGTCATT.GTGCTCTTG
CCTGTCATT.TATTACTCG	CCTGTCATT.TATTACTCG
CCTGTCATT.TGGTGGATC	CCTGTCATT.TGGTGGATC
CCTGTCGAC.CATGGTCGA	CCTGTCGAC.CATGGTCGA
CCTGTCGAC.CCGACTTGG	CCTGTCGAC.CCGACTTGG
CCTGTTAGC.ACAGTATTG	CCTGTTAGC.ACAGTATTG
CCTGTTAGC.GACGGTGCT	CCTGTTAGC.GACGGTGCT
CCTGTTAGC.GCACCATCG	CCTGTTAGC.GCACCATCG
CCTGTTAGC.GTAACTCAT	CCTGTTAGC.GTAACTCAT
CCTTAACAT.AACGTCGAG	CCTTAACAT.AACGTCGAG
CCTTAACAT.ATTAGCCAC	CCTTAACAT.ATTAGCCAC
CCTTAACAT.CGTTCCATT	CCTTAACAT.CGTTCCATT
CCTTAACAT.GACGTTCAG	CCTTAACAT.GACGTTCAG
CCTTAACAT.GTGTCTGGA	CCTTAACAT.GTGTCTGGA
CCTTAACAT.TTGTCAACC	CCTTAACAT.TTGTCAACC
CCTTAATTC.CTGACGATG	CCTTAATTC.CTGACGATG
CCTTAATTC.GGTTAACAG	CCTTAATTC.GGTTAACAG
CCTTAATTC.TAACACGAG	CCTTAATTC.TAACACGAG
CCTTATCCG.CCTCGACCT	CCTTATCCG.CCTCGACCT
CCTTATCCG.GTTCAGAAG	CCTTATCCG.GTTCAGAAG
CCTTCCTCA.AACTGATTC	CCTTCCTCA.AACTGATTC
CCTTCCTCA.CTACGAGAA	CCTTCCTCA.CTACGAGAA
CCTTCCTCA.CTATGGATG	CCTTCCTCA.CTATGGATG
CCTTCGAGC.AGCATATGG	CCTTCGAGC.AGCATATGG
CCTTCGAGC.ATCATTACG	CCTTCGAGC.ATCATTACG
CCTTGACGG.AGCTTGGTG	CCTTGACGG.AGCTTGGTG
CCTTGACGG.CGAGCCGTT	CCTTGACGG.CGAGCCGTT
CCTTGACGG.TGTGCAGTA	CCTTGACGG.TGTGCAGTA
CCTTGCTTG.CTGGACACT	CCTTGCTTG.CTGGACACT
CCTTGCTTG.GCAGCTTGA	CCTTGCTTG.GCAGCTTGA
CCTTGCTTG.GTAACCATA	CCTTGCTTG.GTAACCATA
CCTTGTTGC.ACTACCATC	CCTTGTTGC.ACTACCATC
CCTTGTTGC.ATTCCGTAC	CCTTGTTGC.ATTCCGTAC
CGAACAATC.AGATATGGA	CGAACAATC.AGATATGGA
CGAACAGAG.TTCCGAGCG	CGAACAGAG.TTCCGAGCG
CGAAGAGGT.CGAAGAGGT	CGAAGAGGT.CGAAGAGGT
CGAATCCTG.ATGAGGTAT	CGAATCCTG.ATGAGGTAT
CGAATCCTG.CACGTCATA	CGAATCCTG.CACGTCATA
CGAATCCTG.CTCGTTCAC	CGAATCCTG.CTCGTTCAC
CGAATCCTG.GGTTCAGAC	CGAATCCTG.GGTTCAGAC
CGAATCCTG.TGTCTACAC	CGAATCCTG.TGTCTACAC
CGAATGAGT.CATTGCAGA	CGAATGAGT.CATTGCAGA
CGAATGAGT.GCCTGGAAT	CGAATGAGT.GCCTGGAAT
CGAATGAGT.GGAAGGTAT	CGAATGAGT.GGAAGGTAT
CGAATGAGT.GTCTACCAA	CGAATGAGT.GTCTACCAA
CGACAGACC.ATCTGCGTA	CGACAGACC.ATCTGCGTA
CGACAGACC.GTACCACAA	CGACAGACC.GTACCACAA
CGACAGACC.GTCCTAGTT	CGACAGACC.GTCCTAGTT
CGACAGACC.TGACAAGTT	CGACAGACC.TGACAAGTT
CGACAGACC.TGCGCTGCA	CGACAGACC.TGCGCTGCA
CGACAGGAA.AATCGCCAT	CGACAGGAA.AATCGCCAT
CGACAGGAA.ATCAAGCAT	CGACAGGAA.ATCAAGCAT
CGACAGGAA.ATCTAGGTT	CGACAGGAA.ATCTAGGTT
CGACAGGAA.CCTTATCCG	CGACAGGAA.CCTTATCCG
CGACAGGAA.GGTGGAGCT	CGACAGGAA.GGTGGAGCT
CGACAGGAA.TCCAGCAGC	CGACAGGAA.TCCAGCAGC
CGACAGGAA.TCTGAGATA	CGACAGGAA.TCTGAGATA
CGACCATCA.ACAGCATCA	CGACCATCA.ACAGCATCA
CGACCATCA.AGTATGACG	CGACCATCA.AGTATGACG
CGACCATCA.CGTACATCT	CGACCATCA.CGTACATCT
CGACCATCA.TGTACACGA	CGACCATCA.TGTACACGA
CGACCTAGC.ACCGACGGT	CGACCTAGC.ACCGACGGT
CGACCTAGC.ATTATGCAG	CGACCTAGC.ATTATGCAG
CGACCTAGC.CAAGAACCG	CGACCTAGC.CAAGAACCG
CGACCTAGC.CAGCTGGAG	CGACCTAGC.CAGCTGGAG
CGACCTAGC.GGACGAGCA	CGACCTAGC.GGACGAGCA
CGACCTGTA.ACCTAGTTA	CGACCTGTA.ACCTAGTTA
CGACCTGTA.ATAGCACGG	CGACCTGTA.ATAGCACGG
CGACCTGTA.CACTTGGAT	CGACCTGTA.CACTTGGAT
CGACGTACG.AGTCGCCGA	CGACGTACG.AGTCGCCGA
CGACGTACG.ATTAGCCAC	CGACGTACG.ATTAGCCAC
CGACGTACG.TCGCTTAAC	CGACGTACG.TCGCTTAAC
CGACGTACG.TGAGAGGAC	CGACGTACG.TGAGAGGAC
CGACGTGAT.GGAAGGTAT	CGACGTGAT.GGAAGGTAT
CGAGCCGTT.ACGCAAGAT	CGAGCCGTT.ACGCAAGAT
CGAGCCGTT.ATCAAGCAT	CGAGCCGTT.ATCAAGCAT
CGAGCCGTT.CATGGTCGA	CGAGCCGTT.CATGGTCGA
CGAGCCGTT.GATACACTA	CGAGCCGTT.GATACACTA
CGAGCCGTT.GATGTAAGG	CGAGCCGTT.GATGTAAGG
CGAGCTTAC.CAAGTCGAA	CGAGCTTAC.CAAGTCGAA
CGAGCTTAC.CCTCATAAC	CGAGCTTAC.CCTCATAAC
CGAGCTTAC.CGCGTACTA	CGAGCTTAC.CGCGTACTA
CGAGCTTAC.GCTGGTTCG	CGAGCTTAC.GCTGGTTCG
CGAGCTTAC.TATAGTGCG	CGAGCTTAC.TATAGTGCG
CGAGCTTAC.TCCGGAGCT	CGAGCTTAC.TCCGGAGCT
CGAGCTTAC.TCGGACAGT	CGAGCTTAC.TCGGACAGT
CGAGTAGCA.CCATACGAT	CGAGTAGCA.CCATACGAT
CGAGTAGCA.CCTCGGTCA	CGAGTAGCA.CCTCGGTCA
CGATACTCT.ATCGAATCG	CGATACTCT.ATCGAATCG
CGATACTCT.CTCCAGCGT	CGATACTCT.CTCCAGCGT
CGATACTCT.TCCAACGTG	CGATACTCT.TCCAACGTG
CGATAGGTG.ATATAGCGT	CGATAGGTG.ATATAGCGT
CGATCCAGA.ATCCATTAG	CGATCCAGA.ATCCATTAG
CGATCCAGA.CATAGTATG	CGATCCAGA.CATAGTATG
CGATCCAGA.TACAGTTAG	CGATCCAGA.TACAGTTAG
CGATTCGAG.CAGTATGAT	CGATTCGAG.CAGTATGAT
CGATTCGAG.TGAGCTAGA	CGATTCGAG.TGAGCTAGA
CGATTCGAG.TGGTGGATC	CGATTCGAG.TGGTGGATC
CGATTGAAC.AGCCACTTC	CGATTGAAC.AGCCACTTC
CGATTGAAC.GACACGCAA	CGATTGAAC.GACACGCAA
CGATTGAAC.GTCCTTCAT	CGATTGAAC.GTCCTTCAT
CGATTGAAC.TATGATGTG	CGATTGAAC.TATGATGTG
CGATTGAAC.TGCCATCTC	CGATTGAAC.TGCCATCTC
CGATTGAAC.TGGACTGCC	CGATTGAAC.TGGACTGCC
CGCAACCTC.AGCACCAGC	CGCAACCTC.AGCACCAGC
CGCAACCTC.CGACCTAGC	CGCAACCTC.CGACCTAGC
CGCAACCTC.GATATGGAC	CGCAACCTC.GATATGGAC
CGCAACCTC.GATTAGACA	CGCAACCTC.GATTAGACA
CGCAACCTC.GGTTGCTAT	CGCAACCTC.GGTTGCTAT
CGCAACCTC.TTGGACTTC	CGCAACCTC.TTGGACTTC
CGCAATCGA.CGACCTAGC	CGCAATCGA.CGACCTAGC
CGCAATCGA.GCAGATCCG	CGCAATCGA.GCAGATCCG
CGCAATCGA.TCGCTTAAC	CGCAATCGA.TCGCTTAAC
CGCACTCTT.AGCCTCTAG	CGCACTCTT.AGCCTCTAG
CGCACTCTT.ATGAGATCC	CGCACTCTT.ATGAGATCC
CGCACTCTT.GGTCGGTCT	CGCACTCTT.GGTCGGTCT
CGCACTCTT.GTTCCAACA	CGCACTCTT.GTTCCAACA
CGCACTGAA.GGATGCTCG	CGCACTGAA.GGATGCTCG
CGCACTGAA.TAGACACGT	CGCACTGAA.TAGACACGT
CGCAGTGTC.CCTTCGAGC	CGCAGTGTC.CCTTCGAGC
CGCAGTGTC.TAAGCACTA	CGCAGTGTC.TAAGCACTA
CGCAGTGTC.TACCTCCTC	CGCAGTGTC.TACCTCCTC
CGCAGTGTC.TCAGCTCAG	CGCAGTGTC.TCAGCTCAG
CGCAGTGTC.TGCGTCTTA	CGCAGTGTC.TGCGTCTTA
CGCATAACT.AAGCACAAC	CGCATAACT.AAGCACAAC
CGCATAACT.ACCTCCTAG	CGCATAACT.ACCTCCTAG
CGCATAACT.ATTCATGTG	CGCATAACT.ATTCATGTG
CGCATAACT.CAACGCACA	CGCATAACT.CAACGCACA
CGCATAACT.CGCAACCTC	CGCATAACT.CGCAACCTC
CGCATAACT.CTAGACATG	CGCATAACT.CTAGACATG
CGCATAACT.TATCTAGGT	CGCATAACT.TATCTAGGT
CGCATAACT.TCAATCTAG	CGCATAACT.TCAATCTAG
CGCATAACT.TCCAGCTAT	CGCATAACT.TCCAGCTAT
CGCATAACT.TGATAGAGG	CGCATAACT.TGATAGAGG
CGCATCTAC.ACTATCCTG	CGCATCTAC.ACTATCCTG
CGCATCTAC.AGCCAGGAC	CGCATCTAC.AGCCAGGAC
CGCATCTAC.GAGATGTAT	CGCATCTAC.GAGATGTAT
CGCCATTAC.CTCCAGCGT	CGCCATTAC.CTCCAGCGT
CGCCATTAC.GCTACAATG	CGCCATTAC.GCTACAATG
CGCCATTAC.TATTACTCG	CGCCATTAC.TATTACTCG
CGCCATTAC.TCCTCTAGT	CGCCATTAC.TCCTCTAGT
CGCCATTAC.TTATTCGAC	CGCCATTAC.TTATTCGAC
CGCCTGCAA.AGAGGACGT	CGCCTGCAA.AGAGGACGT
CGCCTGCAA.AGCAACATT	CGCCTGCAA.AGCAACATT
CGCCTGCAA.ATAGCCTAA	CGCCTGCAA.ATAGCCTAA
CGCCTGCAA.CACACCTGT	CGCCTGCAA.CACACCTGT
CGCCTGCAA.CGTGCCTAT	CGCCTGCAA.CGTGCCTAT
CGCCTGCAA.GACCAACAG	CGCCTGCAA.GACCAACAG
CGCCTGCAA.TAGTCAGAC	CGCCTGCAA.TAGTCAGAC
CGCCTGCAA.TCGGATGTT	CGCCTGCAA.TCGGATGTT
CGCGAGTGT.AGCGCATGA	CGCGAGTGT.AGCGCATGA
CGCGAGTGT.ATGCTTCAG	CGCGAGTGT.ATGCTTCAG
CGCGAGTGT.CACATGTGC	CGCGAGTGT.CACATGTGC
CGCGAGTGT.TCCTGTGGA	CGCGAGTGT.TCCTGTGGA
CGCGATGTA.AGCTTCGAT	CGCGATGTA.AGCTTCGAT
CGCGATGTA.CATCCGACA	CGCGATGTA.CATCCGACA
CGCGATGTA.CCTACTAGA	CGCGATGTA.CCTACTAGA
CGCGATGTA.CTATTAAGG	CGCGATGTA.CTATTAAGG
CGCGCACAT.AGTGAACGG	CGCGCACAT.AGTGAACGG
CGCGTACTA.CAGTCCTAA	CGCGTACTA.CAGTCCTAA
CGCGTGAGA.ATCCGTCTC	CGCGTGAGA.ATCCGTCTC
CGCGTGAGA.CAAGCTGCA	CGCGTGAGA.CAAGCTGCA
CGCGTGAGA.CCATGCGTC	CGCGTGAGA.CCATGCGTC
CGCGTGAGA.GGTCTCATG	CGCGTGAGA.GGTCTCATG
CGCGTGAGA.TAGTTGACG	CGCGTGAGA.TAGTTGACG
CGCGTGAGA.TGAAGACCA	CGCGTGAGA.TGAAGACCA
CGCGTGAGA.TGTGAGTAT	CGCGTGAGA.TGTGAGTAT
CGCTGTAGT.ACGATGACC	CGCTGTAGT.ACGATGACC
CGCTGTAGT.CAGGTTGTC	CGCTGTAGT.CAGGTTGTC
CGCTGTAGT.CCATTACAG	CGCTGTAGT.CCATTACAG
CGCTGTAGT.CCGAGCTGA	CGCTGTAGT.CCGAGCTGA
CGCTGTAGT.CCTATTGGT	CGCTGTAGT.CCTATTGGT
CGCTGTAGT.GTGTACCGT	CGCTGTAGT.GTGTACCGT
CGCTGTAGT.TAACTCCGA	CGCTGTAGT.TAACTCCGA
CGCTGTAGT.TCGAACGCT	CGCTGTAGT.TCGAACGCT
CGCTGTAGT.TGCGTATCT	CGCTGTAGT.TGCGTATCT
CGCTTATGA.ACGTCGCTC	CGCTTATGA.ACGTCGCTC
CGCTTATGA.CAGGATCAA	CGCTTATGA.CAGGATCAA
CGCTTATGA.CCATATCTT	CGCTTATGA.CCATATCTT
CGCTTATGA.CCTTAACAT	CGCTTATGA.CCTTAACAT
CGCTTATGA.CTCAGTGAT	CGCTTATGA.CTCAGTGAT
CGCTTATGA.GCACAGTAA	CGCTTATGA.GCACAGTAA
CGCTTATGA.GTACGTCTA	CGCTTATGA.GTACGTCTA
CGCTTCACG.AAGCCAAGT	CGCTTCACG.AAGCCAAGT
CGCTTCACG.GGTTGAAGG	CGCTTCACG.GGTTGAAGG
CGCTTGTAG.AGTAACGTA	CGCTTGTAG.AGTAACGTA
CGCTTGTAG.GAACTGCAA	CGCTTGTAG.GAACTGCAA
CGCTTGTAG.TAGAGCCAG	CGCTTGTAG.TAGAGCCAG
CGGAACGAG.AATACGTCT	CGGAACGAG.AATACGTCT
CGGAACGAG.ACTTAGCTT	CGGAACGAG.ACTTAGCTT
CGGAACGAG.ATCCTCCGA	CGGAACGAG.ATCCTCCGA
CGGAACGAG.CACCAAGAT	CGGAACGAG.CACCAAGAT
CGGAACGAG.CACGTAGAC	CGGAACGAG.CACGTAGAC
CGGAACGAG.CGTACACAC	CGGAACGAG.CGTACACAC
CGGAACGAG.GCGCTCTAT	CGGAACGAG.GCGCTCTAT
CGGAACGAG.GCTGTTCGG	CGGAACGAG.GCTGTTCGG
CGGAACGAG.TCGCATTCG	CGGAACGAG.TCGCATTCG
CGGAACGAG.TTCCTCGGT	CGGAACGAG.TTCCTCGGT
CGGAAGACG.CACTAGACT	CGGAAGACG.CACTAGACT
CGGAAGACG.GCGACACAG	CGGAAGACG.GCGACACAG
CGGAAGACG.GTAATATCG	CGGAAGACG.GTAATATCG
CGGAAGACG.TATCATGCT	CGGAAGACG.TATCATGCT
CGGAATGCA.CTACGAGAA	CGGAATGCA.CTACGAGAA
CGGAATGCA.CTCTTCAGC	CGGAATGCA.CTCTTCAGC
CGGAATGCA.CTGCAAGCC	CGGAATGCA.CTGCAAGCC
CGGAATGCA.GAGAATCAG	CGGAATGCA.GAGAATCAG
CGGAATGCA.GGATCGTTC	CGGAATGCA.GGATCGTTC
CGGAATGCA.GGTCTTGCA	CGGAATGCA.GGTCTTGCA
CGGAATGCA.TCGCCAAGC	CGGAATGCA.TCGCCAAGC
CGGAATGCA.TTGTCAACC	CGGAATGCA.TTGTCAACC
CGGACAAGT.CGTTAATGG	CGGACAAGT.CGTTAATGG
CGGACAAGT.GAGCACATT	CGGACAAGT.GAGCACATT
CGGAGACTT.AGTTACAAG	CGGAGACTT.AGTTACAAG
CGGAGACTT.CCAAGCGAG	CGGAGACTT.CCAAGCGAG
CGGAGACTT.CCTCCAATC	CGGAGACTT.CCTCCAATC
CGGATTCTC.CAGGTTGTC	CGGATTCTC.CAGGTTGTC
CGGATTCTC.GGAATTGGA	CGGATTCTC.GGAATTGGA
CGGATTCTC.GTATACAGA	CGGATTCTC.GTATACAGA
CGGATTCTC.TCACTCGCT	CGGATTCTC.TCACTCGCT
CGGTAGCTT.ATAGTGGTT	CGGTAGCTT.ATAGTGGTT
CGGTAGCTT.ATTGATCAC	CGGTAGCTT.ATTGATCAC
CGGTAGCTT.GGTGCGTAG	CGGTAGCTT.GGTGCGTAG
CGGTAGCTT.TACCTCACT	CGGTAGCTT.TACCTCACT
CGGTGAGTC.AAGGAACAG	CGGTGAGTC.AAGGAACAG
CGGTGAGTC.AGAGGACGT	CGGTGAGTC.AGAGGACGT
CGGTGAGTC.GTGGATAAG	CGGTGAGTC.GTGGATAAG
CGGTGAGTC.GTTGACCAT	CGGTGAGTC.GTTGACCAT
CGGTGAGTC.TACGTTACC	CGGTGAGTC.TACGTTACC
CGGTGAGTC.TGGTAGCAG	CGGTGAGTC.TGGTAGCAG
CGGTGTTAC.AAGGATACG	CGGTGTTAC.AAGGATACG
CGGTGTTAC.AATTGGTGA	CGGTGTTAC.AATTGGTGA
CGGTGTTAC.ACCATACTT	CGGTGTTAC.ACCATACTT
CGGTGTTAC.AGTTGAGCG	CGGTGTTAC.AGTTGAGCG
CGGTGTTAC.CTCATTAGT	CGGTGTTAC.CTCATTAGT
CGGTGTTAC.GTGCCATGA	CGGTGTTAC.GTGCCATGA
CGGTTCGTA.CAGGAGCCT	CGGTTCGTA.CAGGAGCCT
CGGTTCGTA.CAGTATGAT	CGGTTCGTA.CAGTATGAT
CGGTTCGTA.CCGCAGAAT	CGGTTCGTA.CCGCAGAAT
CGGTTCGTA.CGACAGGAA	CGGTTCGTA.CGACAGGAA
CGGTTCGTA.CTATTCCGT	CGGTTCGTA.CTATTCCGT
CGGTTCGTA.CTTGGATCA	CGGTTCGTA.CTTGGATCA
CGGTTCGTA.TCAGGTGCA	CGGTTCGTA.TCAGGTGCA
CGGTTCGTA.TGAGATCAT	CGGTTCGTA.TGAGATCAT
CGGTTCTAT.AGTACGAAT	CGGTTCTAT.AGTACGAAT
CGGTTCTAT.GACATATGT	CGGTTCTAT.GACATATGT
CGGTTCTAT.GGACTCCTT	CGGTTCTAT.GGACTCCTT
CGGTTGCGA.AAGTAGGAC	CGGTTGCGA.AAGTAGGAC
CGGTTGCGA.GTCCGCTCA	CGGTTGCGA.GTCCGCTCA
CGGTTGCGA.TCCGGAGCT	CGGTTGCGA.TCCGGAGCT
CGGTTGCGA.TCGCGTCAT	CGGTTGCGA.TCGCGTCAT
CGTAATGAC.ATTGGTTCC	CGTAATGAC.ATTGGTTCC
CGTAATGAC.CAGTGCTGC	CGTAATGAC.CAGTGCTGC
CGTAATGAC.CGTTCCATT	CGTAATGAC.CGTTCCATT
CGTAATGAC.CTTCACTGT	CGTAATGAC.CTTCACTGT
CGTAATGAC.TACGTTACC	CGTAATGAC.TACGTTACC
CGTAATGAC.TAGAGCCAG	CGTAATGAC.TAGAGCCAG
CGTAATGAC.TCAAGGTCG	CGTAATGAC.TCAAGGTCG
CGTACACAC.AGCGGTAAG	CGTACACAC.AGCGGTAAG
CGTACACAC.GAGGTCCTT	CGTACACAC.GAGGTCCTT
CGTACACAC.TCAGTAAGC	CGTACACAC.TCAGTAAGC
CGTACACAC.TGATCGGAA	CGTACACAC.TGATCGGAA
CGTACATCT.ACTATTGTC	CGTACATCT.ACTATTGTC
CGTACATCT.CCATAATCG	CGTACATCT.CCATAATCG
CGTATAGCG.AACTAACTG	CGTATAGCG.AACTAACTG
CGTATAGCG.TAGGTCAAC	CGTATAGCG.TAGGTCAAC
CGTATCGAA.ATGAGGTAT	CGTATCGAA.ATGAGGTAT
CGTATCGAA.CCGGTTCTA	CGTATCGAA.CCGGTTCTA
CGTATCGAA.CTAGACATG	CGTATCGAA.CTAGACATG
CGTATCGAA.GGATACAAT	CGTATCGAA.GGATACAAT
CGTATCGAA.GTCCACAAC	CGTATCGAA.GTCCACAAC
CGTATTCCT.CAATCTCCG	CGTATTCCT.CAATCTCCG
CGTATTCCT.GTGAATGCC	CGTATTCCT.GTGAATGCC
CGTCAGCAC.AAGCTTGCA	CGTCAGCAC.AAGCTTGCA
CGTCAGCAC.GGAGTTAGC	CGTCAGCAC.GGAGTTAGC
CGTCAGCAC.GTACGTCTA	CGTCAGCAC.GTACGTCTA
CGTCATGGA.ACGTACTGC	CGTCATGGA.ACGTACTGC
CGTCATGGA.AGCAAGTCC	CGTCATGGA.AGCAAGTCC
CGTCATGGA.ATGGATATC	CGTCATGGA.ATGGATATC
CGTCATGGA.CCGTCAGGT	CGTCATGGA.CCGTCAGGT
CGTCATGGA.CTCCACGTC	CGTCATGGA.CTCCACGTC
CGTCATGGA.TACATGCAC	CGTCATGGA.TACATGCAC
CGTCATGGA.TTATCGCAC	CGTCATGGA.TTATCGCAC
CGTCGTCAA.CTTAACAGC	CGTCGTCAA.CTTAACAGC
CGTCGTCAA.GCAATCACG	CGTCGTCAA.GCAATCACG
CGTCGTCAA.TACGTTACC	CGTCGTCAA.TACGTTACC
CGTCGTCAA.TAGAGACTA	CGTCGTCAA.TAGAGACTA
CGTCTGCTG.ATGTCGCCT	CGTCTGCTG.ATGTCGCCT
CGTCTGCTG.GCCAATGAA	CGTCTGCTG.GCCAATGAA
CGTCTGCTG.GGTAAGGAT	CGTCTGCTG.GGTAAGGAT
CGTCTGTCC.AGCTTCGAT	CGTCTGTCC.AGCTTCGAT
CGTCTGTCC.CAGTACATC	CGTCTGTCC.CAGTACATC
CGTCTGTCC.CGACGTGAT	CGTCTGTCC.CGACGTGAT
CGTCTGTCC.CTAACCGGT	CGTCTGTCC.CTAACCGGT
CGTCTGTCC.TAAGGTCCG	CGTCTGTCC.TAAGGTCCG
CGTCTGTCC.TAGACCGCA	CGTCTGTCC.TAGACCGCA
CGTGACCAG.AGCCTCTAG	CGTGACCAG.AGCCTCTAG
CGTGACCAG.AGTCATACT	CGTGACCAG.AGTCATACT
CGTGACCAG.CTGTGGTGG	CGTGACCAG.CTGTGGTGG
CGTGACCAG.TTAACGGAG	CGTGACCAG.TTAACGGAG
CGTGAGACT.AGATACGTT	CGTGAGACT.AGATACGTT
CGTGAGACT.AGCCTCTAG	CGTGAGACT.AGCCTCTAG
CGTGAGACT.ATCCACAGT	CGTGAGACT.ATCCACAGT
CGTGAGACT.GAGGTCACG	CGTGAGACT.GAGGTCACG
CGTGAGACT.GTTACTACT	CGTGAGACT.GTTACTACT
CGTGCAAGG.AGTAAGCCA	CGTGCAAGG.AGTAAGCCA
CGTGCAAGG.CAGTCTAAC	CGTGCAAGG.CAGTCTAAC
CGTGCAAGG.CCAGTCTCA	CGTGCAAGG.CCAGTCTCA
CGTGCAAGG.CTTACATGC	CGTGCAAGG.CTTACATGC
CGTGCAAGG.TATCAGTGC	CGTGCAAGG.TATCAGTGC
CGTGCAAGG.TCCTGTCCG	CGTGCAAGG.TCCTGTCCG
CGTGCCTAT.CCGTTCCAA	CGTGCCTAT.CCGTTCCAA
CGTGCCTAT.GATGCTCCT	CGTGCCTAT.GATGCTCCT
CGTGCCTAT.TAGTCGCAT	CGTGCCTAT.TAGTCGCAT
CGTGCTTGA.AATCTGACC	CGTGCTTGA.AATCTGACC
CGTGCTTGA.CCGACTTGG	CGTGCTTGA.CCGACTTGG
CGTGCTTGA.CCTATTCAA	CGTGCTTGA.CCTATTCAA
CGTGCTTGA.GCCGCCTAA	CGTGCTTGA.GCCGCCTAA
CGTGCTTGA.TGCTCAGCG	CGTGCTTGA.TGCTCAGCG
CGTGGTACC.ATCGAATCG	CGTGGTACC.ATCGAATCG
CGTGGTACC.ATGGACGTT	CGTGGTACC.ATGGACGTT
CGTGGTACC.GCAGCTTGA	CGTGGTACC.GCAGCTTGA
CGTGGTACC.TACGACCAT	CGTGGTACC.TACGACCAT
CGTGTATTC.CAGTGCTGC	CGTGTATTC.CAGTGCTGC
CGTGTATTC.GGTTCTATC	CGTGTATTC.GGTTCTATC
CGTGTCCGA.CCTCAGGTG	CGTGTCCGA.CCTCAGGTG
CGTGTCCGA.CTGATGCAC	CGTGTCCGA.CTGATGCAC
CGTGTCCGA.CTTGGATCA	CGTGTCCGA.CTTGGATCA
CGTGTCCGA.TAAGTACAC	CGTGTCCGA.TAAGTACAC
CGTGTGTGG.ACAGGTATC	CGTGTGTGG.ACAGGTATC
CGTGTGTGG.CCGCACTCA	CGTGTGTGG.CCGCACTCA
CGTGTGTGG.GGTTAGATG	CGTGTGTGG.GGTTAGATG
CGTGTGTGG.TGCCGAACT	CGTGTGTGG.TGCCGAACT
CGTTAATGG.ATGGACGTT	CGTTAATGG.ATGGACGTT
CGTTAATGG.CTAATACGC	CGTTAATGG.CTAATACGC
CGTTAATGG.CTCATGCCA	CGTTAATGG.CTCATGCCA
CGTTAATGG.GGATAGTCA	CGTTAATGG.GGATAGTCA
CGTTAATGG.TAACACATC	CGTTAATGG.TAACACATC
CGTTAATGG.TCACGACAA	CGTTAATGG.TCACGACAA
CGTTAATGG.TGTACACGA	CGTTAATGG.TGTACACGA
CGTTAATGG.TTAGCGTCT	CGTTAATGG.TTAGCGTCT
CGTTACACC.CCACGAAGG	CGTTACACC.CCACGAAGG
CGTTACACC.GTAACCATA	CGTTACACC.GTAACCATA
CGTTACACC.TCACGACAA	CGTTACACC.TCACGACAA
CGTTCCATT.AACTCCATG	CGTTCCATT.AACTCCATG
CGTTCCATT.GCGAGCAAG	CGTTCCATT.GCGAGCAAG
CGTTCCATT.TGATTATCG	CGTTCCATT.TGATTATCG
CGTTCCATT.TTACGCTCG	CGTTCCATT.TTACGCTCG
CGTTCGTAC.AAGGAAGTC	CGTTCGTAC.AAGGAAGTC
CGTTCGTAC.AGTCCGTGT	CGTTCGTAC.AGTCCGTGT
CGTTCGTAC.CAGGTTGTC	CGTTCGTAC.CAGGTTGTC
CGTTCGTAC.CCGCACTCA	CGTTCGTAC.CCGCACTCA
CGTTCGTAC.CCGTCCACT	CGTTCGTAC.CCGTCCACT
CGTTGATCC.AGTAAGCCA	CGTTGATCC.AGTAAGCCA
CGTTGATCC.ATCGTAGTG	CGTTGATCC.ATCGTAGTG
CGTTGATCC.CCTCGGTCA	CGTTGATCC.CCTCGGTCA
CGTTGATCC.GATGTCTAG	CGTTGATCC.GATGTCTAG
CGTTGATCC.GCGTGATAC	CGTTGATCC.GCGTGATAC
CGTTGATCC.GTCCGTAAG	CGTTGATCC.GTCCGTAAG
CTAACACTG.ACCGCTGTG	CTAACACTG.ACCGCTGTG
CTAACACTG.AGGTGCGAG	CTAACACTG.AGGTGCGAG
CTAACACTG.ATGCTTCAG	CTAACACTG.ATGCTTCAG
CTAACACTG.CACCAAGAT	CTAACACTG.CACCAAGAT
CTAACACTG.CACTTCCTT	CTAACACTG.CACTTCCTT
CTAACACTG.CGTCAGCAC	CTAACACTG.CGTCAGCAC
CTAACACTG.TAAGTACAC	CTAACACTG.TAAGTACAC
CTAACACTG.TATCTAGGT	CTAACACTG.TATCTAGGT
CTAACCGGT.ACGCACACT	CTAACCGGT.ACGCACACT
CTAACCGGT.ACTCACGAA	CTAACCGGT.ACTCACGAA
CTAACCGGT.AGCAGACAA	CTAACCGGT.AGCAGACAA
CTAACCGGT.CACCTTCCT	CTAACCGGT.CACCTTCCT
CTAACCGGT.CGCCATTAC	CTAACCGGT.CGCCATTAC
CTAACCGGT.GACGCTTGC	CTAACCGGT.GACGCTTGC
CTAACCGGT.TCGGATGTT	CTAACCGGT.TCGGATGTT
CTAACCGGT.TGGATAGGT	CTAACCGGT.TGGATAGGT
CTAACTAAG.CACGGAAGT	CTAACTAAG.CACGGAAGT
CTAACTAAG.CCAGATCAC	CTAACTAAG.CCAGATCAC
CTAACTAAG.CCAGTACTC	CTAACTAAG.CCAGTACTC
CTAACTAAG.CTGACGATG	CTAACTAAG.CTGACGATG
CTAACTAAG.GATGCGACG	CTAACTAAG.GATGCGACG
CTAACTAAG.TCAGCGACC	CTAACTAAG.TCAGCGACC
CTAACTAAG.TCTGATGAA	CTAACTAAG.TCTGATGAA
CTAATACGC.ATAAGACAG	CTAATACGC.ATAAGACAG
CTACCTGCG.CATTCAGTT	CTACCTGCG.CATTCAGTT
CTACCTGCG.CTCCAGCGT	CTACCTGCG.CTCCAGCGT
CTACCTGCG.GACGTCAAT	CTACCTGCG.GACGTCAAT
CTACCTGCG.GGAGTTAGC	CTACCTGCG.GGAGTTAGC
CTACCTGCG.GTGTTCCAG	CTACCTGCG.GTGTTCCAG
CTACGAGAA.ATGATAGCT	CTACGAGAA.ATGATAGCT
CTACGAGAA.TATCGAGCC	CTACGAGAA.TATCGAGCC
CTACGAGAA.TCAATGGAC	CTACGAGAA.TCAATGGAC
CTACGGTAT.ATCTAGGTT	CTACGGTAT.ATCTAGGTT
CTACGGTAT.CAACACCTA	CTACGGTAT.CAACACCTA
CTACGGTAT.CTCATTAGT	CTACGGTAT.CTCATTAGT
CTACGGTAT.GGATCAATG	CTACGGTAT.GGATCAATG
CTACGGTAT.TCAATCTAG	CTACGGTAT.TCAATCTAG
CTACGTTGG.AGGAGCAAT	CTACGTTGG.AGGAGCAAT
CTACGTTGG.GATCTTCGC	CTACGTTGG.GATCTTCGC
CTACGTTGG.GCAGATCCG	CTACGTTGG.GCAGATCCG
CTACGTTGG.GCTGGTTCG	CTACGTTGG.GCTGGTTCG
CTACTGTCA.CACACTGCC	CTACTGTCA.CACACTGCC
CTACTGTCA.GTCTTCATA	CTACTGTCA.GTCTTCATA
CTAGACATG.TGCGACGTT	CTAGACATG.TGCGACGTT
CTAGAGGTA.AACGGAGAT	CTAGAGGTA.AACGGAGAT
CTAGAGGTA.ATTCACCTC	CTAGAGGTA.ATTCACCTC
CTAGAGGTA.CCAAGCGAG	CTAGAGGTA.CCAAGCGAG
CTAGAGGTA.CCAGTTACG	CTAGAGGTA.CCAGTTACG
CTAGAGGTA.CCTCGAGAG	CTAGAGGTA.CCTCGAGAG
CTAGAGGTA.TTCAGTGCC	CTAGAGGTA.TTCAGTGCC
CTAGAGTCG.AAGCACAAC	CTAGAGTCG.AAGCACAAC
CTAGGTACT.CAACGTCTT	CTAGGTACT.CAACGTCTT
CTAGGTACT.TATCCTCAG	CTAGGTACT.TATCCTCAG
CTAGTATAG.CACCTTCCT	CTAGTATAG.CACCTTCCT
CTAGTATAG.CAGTATGAT	CTAGTATAG.CAGTATGAT
CTAGTATAG.CCATAATCG	CTAGTATAG.CCATAATCG
CTAGTATAG.GCTGGTAAC	CTAGTATAG.GCTGGTAAC
CTAGTATAG.TCTGCGCTG	CTAGTATAG.TCTGCGCTG
CTAGTCGTC.AGATGTTGG	CTAGTCGTC.AGATGTTGG
CTAGTCGTC.CCTCTCTAG	CTAGTCGTC.CCTCTCTAG
CTAGTCGTC.GGACAGATT	CTAGTCGTC.GGACAGATT
CTAGTCGTC.GTGAGGACG	CTAGTCGTC.GTGAGGACG
CTAGTCGTC.TTATCCAAG	CTAGTCGTC.TTATCCAAG
CTAGTGCTG.ACTTAGCTT	CTAGTGCTG.ACTTAGCTT
CTAGTGCTG.AGTGAACGG	CTAGTGCTG.AGTGAACGG
CTAGTGCTG.GCTACAATG	CTAGTGCTG.GCTACAATG
CTAGTGCTG.TACTAGTAG	CTAGTGCTG.TACTAGTAG
CTAGTGCTG.TCGCTTAAC	CTAGTGCTG.TCGCTTAAC
CTAGTGCTG.TGATTGTGC	CTAGTGCTG.TGATTGTGC
CTAGTGCTG.TTACGGACC	CTAGTGCTG.TTACGGACC
CTAGTTCCA.AAGGTCTGA	CTAGTTCCA.AAGGTCTGA
CTAGTTCCA.TCGATTCAG	CTAGTTCCA.TCGATTCAG
CTATACTAG.CCTTGTTGC	CTATACTAG.CCTTGTTGC
CTATACTAG.GGATACCTA	CTATACTAG.GGATACCTA
CTATACTAG.GTTAGTCAA	CTATACTAG.GTTAGTCAA
CTATACTAG.TCAGCGACC	CTATACTAG.TCAGCGACC
CTATAGCTC.AGGAAGGTG	CTATAGCTC.AGGAAGGTG
CTATAGCTC.GTACAATGC	CTATAGCTC.GTACAATGC
CTATAGCTC.GTGCATCAA	CTATAGCTC.GTGCATCAA
CTATAGCTC.TAACACGAG	CTATAGCTC.TAACACGAG
CTATAGCTC.TATCTAGGT	CTATAGCTC.TATCTAGGT
CTATCCATC.TAATCTGGA	CTATCCATC.TAATCTGGA
CTATCTTGA.GACGGTGCT	CTATCTTGA.GACGGTGCT
CTATCTTGA.GCTTGGTTC	CTATCTTGA.GCTTGGTTC
CTATCTTGA.TAGCGAGAA	CTATCTTGA.TAGCGAGAA
CTATGGATG.ATAGTCAGT	CTATGGATG.ATAGTCAGT
CTATGGATG.CACTGCTTA	CTATGGATG.CACTGCTTA
CTATGGATG.CATGGTCGA	CTATGGATG.CATGGTCGA
CTATGGATG.GTAGTTGGT	CTATGGATG.GTAGTTGGT
CTATTAAGG.ATCATGTTC	CTATTAAGG.ATCATGTTC
CTATTAAGG.GATTGAGTA	CTATTAAGG.GATTGAGTA
