ACCGAGTAG.GCAGCAGTG	ACCGAGTAG.GCAGCAGTG
ACCGAGTAG.TAGGATGCC	ACCGAGTAG.TAGGATGCC
ACCGATCGA.ACGTCTATG	ACCGATCGA.ACGTCTATG
ACCGATCGA.AGACGGAGG	ACCGATCGA.AGACGGAGG
ACCGATCGA.CAGGTATCG	ACCGATCGA.CAGGTATCG
ACCGATCGA.GCCACATGG	ACCGATCGA.GCCACATGG
ACCGATCGA.TAGCACTAT	ACCGATCGA.TAGCACTAT
ACCGCTGTG.AAGTTGCCA	ACCGCTGTG.AAGTTGCCA
ACCGCTGTG.AGACGGAGG	ACCGCTGTG.AGACGGAGG
ACCGCTGTG.CAGCTTCGA	ACCGCTGTG.CAGCTTCGA
ACCGCTGTG.CATTCCGAG	ACCGCTGTG.CATTCCGAG
ACCGCTGTG.CCTAGTCTC	ACCGCTGTG.CCTAGTCTC
ACCGCTGTG.CTGCAAGCC	ACCGCTGTG.CTGCAAGCC
ACCGCTGTG.GCGCATTAC	ACCGCTGTG.GCGCATTAC
ACCGCTGTG.TCCACCGGT	ACCGCTGTG.TCCACCGGT
ACCGGAAGG.CCACTACCA	ACCGGAAGG.CCACTACCA
ACCGGAAGG.CTGAGATAG	ACCGGAAGG.CTGAGATAG
ACCGGAAGG.CTTCTATGA	ACCGGAAGG.CTTCTATGA
ACCGGAAGG.TGCTCCTCC	ACCGGAAGG.TGCTCCTCC
ACCGGAGTA.CGCGATGTA	ACCGGAGTA.CGCGATGTA
ACCGGAGTA.GGTGATAGG	ACCGGAGTA.GGTGATAGG
ACCGGAGTA.GTGCTCTTG	ACCGGAGTA.GTGCTCTTG
ACCGGAGTA.TAGGAGCTA	ACCGGAGTA.TAGGAGCTA
ACCGGAGTA.TGATGTGTG	ACCGGAGTA.TGATGTGTG
ACCGGTTAC.AATGCAGCG	ACCGGTTAC.AATGCAGCG
ACCGGTTAC.CCATAATCG	ACCGGTTAC.CCATAATCG
ACCGGTTAC.CTGATGCAC	ACCGGTTAC.CTGATGCAC
ACCGGTTAC.TATGTATGC	ACCGGTTAC.TATGTATGC
ACCGTACGC.TCCACGTGC	ACCGTACGC.TCCACGTGC
ACCGTCACG.AACAGCAGT	ACCGTCACG.AACAGCAGT
ACCGTCACG.ATCCGTCTC	ACCGTCACG.ATCCGTCTC
ACCGTCACG.CCGCATCCT	ACCGTCACG.CCGCATCCT
ACCGTCACG.CTAGAGGTA	ACCGTCACG.CTAGAGGTA
ACCGTCACG.CTAGTGCTG	ACCGTCACG.CTAGTGCTG
ACCGTCCTA.CATACGCAG	ACCGTCCTA.CATACGCAG
ACCGTCCTA.TAATCACGC	ACCGTCCTA.TAATCACGC
ACCTAGCAC.AGTCAGTTG	ACCTAGCAC.AGTCAGTTG
ACCTAGCAC.CTGCTGCTT	ACCTAGCAC.CTGCTGCTT
ACCTAGCAC.TACCGATTG	ACCTAGCAC.TACCGATTG
ACCTAGTTA.ACACACCGT	ACCTAGTTA.ACACACCGT
ACCTAGTTA.ACGCTAGTG	ACCTAGTTA.ACGCTAGTG
ACCTAGTTA.CTCCACGTC	ACCTAGTTA.CTCCACGTC
ACCTAGTTA.GCTTCTGAA	ACCTAGTTA.GCTTCTGAA
ACCTAGTTA.GTAACCATA	ACCTAGTTA.GTAACCATA
ACCTGCAGA.AACACACTC	ACCTGCAGA.AACACACTC
ACCTGCAGA.ACAATAGGT	ACCTGCAGA.ACAATAGGT
ACCTGCAGA.ACGACAGTC	ACCTGCAGA.ACGACAGTC
ACCTGCAGA.AGATACGTT	ACCTGCAGA.AGATACGTT
ACCTGCAGA.ATAATCGAG	ACCTGCAGA.ATAATCGAG
ACCTGCAGA.CCAGTTACG	ACCTGCAGA.CCAGTTACG
ACCTGCAGA.CTATACTAG	ACCTGCAGA.CTATACTAG
ACCTGCAGA.GGAACTGCT	ACCTGCAGA.GGAACTGCT
ACCTGCAGA.GTCCTTCAT	ACCTGCAGA.GTCCTTCAT
ACCTGCAGA.TGCGCTGCA	ACCTGCAGA.TGCGCTGCA
ACCTGTACC.GATCTGTTC	ACCTGTACC.GATCTGTTC
ACCTGTACC.GTATTACTG	ACCTGTACC.GTATTACTG
ACCTGTACC.TATCCTCAG	ACCTGTACC.TATCCTCAG
ACCTTGAAG.CAGGTTGTC	ACCTTGAAG.CAGGTTGTC
ACCTTGAAG.TTCCAGATT	ACCTTGAAG.TTCCAGATT
ACGAATCGC.AACTGCGAC	ACGAATCGC.AACTGCGAC
ACGAATCGC.ATAACGACA	ACGAATCGC.ATAACGACA
ACGAATCGC.CCGATGTTC	ACGAATCGC.CCGATGTTC
ACGACAGTC.ACAGCGGTC	ACGACAGTC.ACAGCGGTC
ACGACAGTC.ACGTCTATG	ACGACAGTC.ACGTCTATG
ACGACATCT.AGCCGTTCT	ACGACATCT.AGCCGTTCT
ACGACATCT.CCGACTGTT	ACGACATCT.CCGACTGTT
ACGACATCT.CTGGACTAA	ACGACATCT.CTGGACTAA
ACGACGATT.ACCGTACGC	ACGACGATT.ACCGTACGC
ACGACGATT.ACGTTCAAT	ACGACGATT.ACGTTCAAT
ACGACTGCG.CCTCCTTGT	ACGACTGCG.CCTCCTTGT
ACGACTGCG.CTTCTGAGT	ACGACTGCG.CTTCTGAGT
ACGAGAGCA.ACGCTCTTA	ACGAGAGCA.ACGCTCTTA
ACGAGAGCA.AGCACCGTG	ACGAGAGCA.AGCACCGTG
ACGAGAGCA.ATAGCCTAA	ACGAGAGCA.ATAGCCTAA
ACGAGAGCA.ATGAGTGTG	ACGAGAGCA.ATGAGTGTG
ACGAGAGCA.CCGTTCCAA	ACGAGAGCA.CCGTTCCAA
ACGAGAGCA.GGATGCTCG	ACGAGAGCA.GGATGCTCG
ACGAGAGCA.TAGGTTAGT	ACGAGAGCA.TAGGTTAGT
ACGAGAGCA.TCGACGTTG	ACGAGAGCA.TCGACGTTG
ACGAGAGCA.TGGTAACCA	ACGAGAGCA.TGGTAACCA
ACGAGAGCA.TGTACACGA	ACGAGAGCA.TGTACACGA
ACGAGCTTC.ACGTCGCTC	ACGAGCTTC.ACGTCGCTC
ACGAGCTTC.AGATGAAGA	ACGAGCTTC.AGATGAAGA
ACGAGCTTC.GTACAATGC	ACGAGCTTC.GTACAATGC
ACGAGCTTC.TGCCAGACG	ACGAGCTTC.TGCCAGACG
ACGAGCTTC.TGTCCATAG	ACGAGCTTC.TGTCCATAG
ACGATGACC.AACTTCTGC	ACGATGACC.AACTTCTGC
ACGATGACC.AGTGAACGG	ACGATGACC.AGTGAACGG
ACGATGACC.CTAGTTCCA	ACGATGACC.CTAGTTCCA
ACGATGACC.TTGTATCAC	ACGATGACC.TTGTATCAC
ACGATGGAA.ATCCTGCCT	ACGATGGAA.ATCCTGCCT
ACGATGGAA.CATTCGAAT	ACGATGGAA.CATTCGAAT
ACGATGGAA.CCGTACGGA	ACGATGGAA.CCGTACGGA
ACGATGGAA.TGAGTGACT	ACGATGGAA.TGAGTGACT
ACGCAAGAT.AAGAGAGAG	ACGCAAGAT.AAGAGAGAG
ACGCAAGAT.AGTTCGATA	ACGCAAGAT.AGTTCGATA
ACGCAAGAT.ATAATCGAG	ACGCAAGAT.ATAATCGAG
ACGCAAGAT.ATTGACACG	ACGCAAGAT.ATTGACACG
ACGCAAGAT.CCTATTCAA	ACGCAAGAT.CCTATTCAA
ACGCAAGAT.CCTGTCATT	ACGCAAGAT.CCTGTCATT
ACGCAAGAT.TCTTAAGTG	ACGCAAGAT.TCTTAAGTG
ACGCACACT.ACCTAGTTA	ACGCACACT.ACCTAGTTA
ACGCACACT.CTATCTTGA	ACGCACACT.CTATCTTGA
ACGCACACT.GATGCAGAA	ACGCACACT.GATGCAGAA
ACGCACACT.TAACCGTGA	ACGCACACT.TAACCGTGA
ACGCACACT.TTCTCCACA	ACGCACACT.TTCTCCACA
ACGCGACAG.ACGTAGTAT	ACGCGACAG.ACGTAGTAT
ACGCGACAG.ATCCGGTCC	ACGCGACAG.ATCCGGTCC
ACGCGACAG.CGAACAGAG	ACGCGACAG.CGAACAGAG
ACGCGACAG.GGTCCTGGT	ACGCGACAG.GGTCCTGGT
ACGCGTGAC.TGCAGTTCA	ACGCGTGAC.TGCAGTTCA
ACGCTAGTG.ATTCGAAGA	ACGCTAGTG.ATTCGAAGA
ACGCTATGT.ACTGGTGCT	ACGCTATGT.ACTGGTGCT
ACGCTATGT.ATGTCGCCT	ACGCTATGT.ATGTCGCCT
ACGCTATGT.CACGGAAGT	ACGCTATGT.CACGGAAGT
ACGCTATGT.CAGGTATCG	ACGCTATGT.CAGGTATCG
ACGCTATGT.GAACTGCAA	ACGCTATGT.GAACTGCAA
ACGCTCTTA.CGACCATCA	ACGCTCTTA.CGACCATCA
ACGCTCTTA.GCGTCGTCT	ACGCTCTTA.GCGTCGTCT
ACGCTCTTA.TATGATGTG	ACGCTCTTA.TATGATGTG
ACGGACCAT.GCCATCGCT	ACGGACCAT.GCCATCGCT
ACGGACCAT.TCTAGGATG	ACGGACCAT.TCTAGGATG
ACGGTGCCT.GTATGTATC	ACGGTGCCT.GTATGTATC
ACGGTGCCT.TATCTAGGT	ACGGTGCCT.TATCTAGGT
ACGGTGTAC.CCGCATCCT	ACGGTGTAC.CCGCATCCT
ACGGTGTAC.CTCCGCATT	ACGGTGTAC.CTCCGCATT
ACGGTGTAC.TGAGTGACT	ACGGTGTAC.TGAGTGACT
ACGTACTGC.ATATGTCCA	ACGTACTGC.ATATGTCCA
ACGTACTGC.TATACCACT	ACGTACTGC.TATACCACT
ACGTACTGC.TGTGGTCCT	ACGTACTGC.TGTGGTCCT
ACGTACTGC.TGTGTAGAG	ACGTACTGC.TGTGTAGAG
ACGTAGTAT.AAGTACAGA	ACGTAGTAT.AAGTACAGA
ACGTAGTAT.ACACTAACG	ACGTAGTAT.ACACTAACG
ACGTAGTAT.ATACCGCTT	ACGTAGTAT.ATACCGCTT
ACGTAGTAT.CAAGAACCG	ACGTAGTAT.CAAGAACCG
ACGTAGTAT.GACTAGCAT	ACGTAGTAT.GACTAGCAT
ACGTAGTAT.GCCTTCCAT	ACGTAGTAT.GCCTTCCAT
ACGTAGTAT.GGATTCGTC	ACGTAGTAT.GGATTCGTC
ACGTATGTC.CCGCAGAAT	ACGTATGTC.CCGCAGAAT
ACGTCGCTC.GGAGATGAG	ACGTCGCTC.GGAGATGAG
ACGTCGCTC.TTGGTAACT	ACGTCGCTC.TTGGTAACT
ACGTCTATG.CCACGTTCT	ACGTCTATG.CCACGTTCT
ACGTCTATG.CCGCAGCTA	ACGTCTATG.CCGCAGCTA
ACGTCTATG.TAGGTTAGT	ACGTCTATG.TAGGTTAGT
ACGTGAATC.ACTTCTTGG	ACGTGAATC.ACTTCTTGG
ACGTGAATC.CTTCACTGT	ACGTGAATC.CTTCACTGT
ACGTGAATC.TCGAATAGA	ACGTGAATC.TCGAATAGA
ACGTGCTCG.ACGTCTATG	ACGTGCTCG.ACGTCTATG
ACGTGCTCG.AGAGCGCGA	ACGTGCTCG.AGAGCGCGA
ACGTGCTCG.CGTGCAAGG	ACGTGCTCG.CGTGCAAGG
ACGTGCTCG.GAACCAGTT	ACGTGCTCG.GAACCAGTT
ACGTGTAGT.ATAATGTGG	ACGTGTAGT.ATAATGTGG
ACGTGTAGT.CAGCGACGT	ACGTGTAGT.CAGCGACGT
ACGTGTAGT.GAATAAGAG	ACGTGTAGT.GAATAAGAG
ACGTGTAGT.GAATTGTTG	ACGTGTAGT.GAATTGTTG
ACGTGTAGT.TGAAGACCA	ACGTGTAGT.TGAAGACCA
ACGTTCAAT.AAGACGAAG	ACGTTCAAT.AAGACGAAG
ACGTTCAAT.AGATGAAGA	ACGTTCAAT.AGATGAAGA
ACGTTCAAT.CCAGTTACG	ACGTTCAAT.CCAGTTACG
ACGTTCAAT.GTAACCATA	ACGTTCAAT.GTAACCATA
ACGTTCAAT.TACGACTTG	ACGTTCAAT.TACGACTTG
ACGTTCAAT.TAGATCTGT	ACGTTCAAT.TAGATCTGT
ACTAACCGA.AACGGAGAT	ACTAACCGA.AACGGAGAT
ACTAACCGA.CAACTAATC	ACTAACCGA.CAACTAATC
ACTAACCGA.CCTCATAAC	ACTAACCGA.CCTCATAAC
ACTAACCGA.CTCGACTGC	ACTAACCGA.CTCGACTGC
ACTAACCGA.GGTCTTGCA	ACTAACCGA.GGTCTTGCA
ACTAAGTTC.CAGTCCTAA	ACTAAGTTC.CAGTCCTAA
ACTAAGTTC.CATGCCAGT	ACTAAGTTC.CATGCCAGT
ACTAAGTTC.CCGCAGCTA	ACTAAGTTC.CCGCAGCTA
ACTAAGTTC.CTTAACAGC	ACTAAGTTC.CTTAACAGC
ACTACCATC.CTGTCACTT	ACTACCATC.CTGTCACTT
ACTACCATC.GTCAGTTGT	ACTACCATC.GTCAGTTGT
ACTACCATC.GTCGCAGGT	ACTACCATC.GTCGCAGGT
ACTACCATC.TAAGCCATT	ACTACCATC.TAAGCCATT
ACTACTCAT.CATCTCACG	ACTACTCAT.CATCTCACG
ACTATCCTG.AACGCCTAC	ACTATCCTG.AACGCCTAC
ACTATCCTG.ACTCCTGAG	ACTATCCTG.ACTCCTGAG
ACTATCCTG.CGACCTAGC	ACTATCCTG.CGACCTAGC
ACTATTGTC.CACAGCGAA	ACTATTGTC.CACAGCGAA
ACTATTGTC.CATCCTCTC	ACTATTGTC.CATCCTCTC
ACTCACGAA.AGTTGCCTT	ACTCACGAA.AGTTGCCTT
ACTCACGAA.CAAGTCGAA	ACTCACGAA.CAAGTCGAA
ACTCACGAA.CATCCTCTC	ACTCACGAA.CATCCTCTC
ACTCACGAA.CGGAACGAG	ACTCACGAA.CGGAACGAG
ACTCACGAA.CTTCGACTG	ACTCACGAA.CTTCGACTG
ACTCACGAA.GCATGTGGT	ACTCACGAA.GCATGTGGT
ACTCACGAA.GCTGAGCAG	ACTCACGAA.GCTGAGCAG
ACTCACGAA.GTAGACTCT	ACTCACGAA.GTAGACTCT
ACTCACGAA.GTCCGCTCA	ACTCACGAA.GTCCGCTCA
ACTCACGAA.GTCGTCGAC	ACTCACGAA.GTCGTCGAC
ACTCATTCA.ATCAGGATG	ACTCATTCA.ATCAGGATG
ACTCCAACT.AACTTGTCG	ACTCCAACT.AACTTGTCG
ACTCCAACT.ATCGAATCG	ACTCCAACT.ATCGAATCG
ACTCCAACT.CAGGAGCCT	ACTCCAACT.CAGGAGCCT
ACTCCAACT.GAGCCATCC	ACTCCAACT.GAGCCATCC
ACTCCGGTT.ACTCGTCTA	ACTCCGGTT.ACTCGTCTA
ACTCCGGTT.ATAAGACAG	ACTCCGGTT.ATAAGACAG
ACTCCGGTT.CAACTAATC	ACTCCGGTT.CAACTAATC
ACTCCGGTT.GAGTATCGC	ACTCCGGTT.GAGTATCGC
ACTCCGTCG.ACATGACTA	ACTCCGTCG.ACATGACTA
ACTCCGTCG.AGATGAAGA	ACTCCGTCG.AGATGAAGA
ACTCCGTCG.AGTCTGGAA	ACTCCGTCG.AGTCTGGAA
ACTCCGTCG.CGGTTGCGA	ACTCCGTCG.CGGTTGCGA
ACTCCGTCG.CTACTGTCA	ACTCCGTCG.CTACTGTCA
ACTCCGTCG.GAGACTCGA	ACTCCGTCG.GAGACTCGA
ACTCCTGAG.CAAGGTGTG	ACTCCTGAG.CAAGGTGTG
ACTCGAGTC.AAGCCAAGT	ACTCGAGTC.AAGCCAAGT
ACTCGAGTC.CCGACTGTT	ACTCGAGTC.CCGACTGTT
ACTCGAGTC.TCGGATGTT	ACTCGAGTC.TCGGATGTT
ACTCGAGTC.TGTGTAGAG	ACTCGAGTC.TGTGTAGAG
ACTCGCTGT.AAGGATCGT	ACTCGCTGT.AAGGATCGT
ACTCGCTGT.AGGTGTACA	ACTCGCTGT.AGGTGTACA
ACTCGCTGT.GTGCGAGTA	ACTCGCTGT.GTGCGAGTA
ACTCGCTGT.TCAGCGACC	ACTCGCTGT.TCAGCGACC
ACTCGTAGG.CCGATGTTC	ACTCGTAGG.CCGATGTTC
ACTCGTAGG.GCCTAACGG	ACTCGTAGG.GCCTAACGG
ACTCGTAGG.GGAAGTATG	ACTCGTAGG.GGAAGTATG
ACTCGTAGG.TTACGCTCG	ACTCGTAGG.TTACGCTCG
ACTCGTCTA.CAGCTGGAG	ACTCGTCTA.CAGCTGGAG
ACTCGTCTA.GTCCACAAC	ACTCGTCTA.GTCCACAAC
ACTCTAGGA.CATGACGTT	ACTCTAGGA.CATGACGTT
ACTCTAGGA.TACAACACC	ACTCTAGGA.TACAACACC
ACTCTAGGA.TACGACCAT	ACTCTAGGA.TACGACCAT
ACTCTAGGA.TATGTATGC	ACTCTAGGA.TATGTATGC
ACTCTAGGA.TCGGTATCA	ACTCTAGGA.TCGGTATCA
ACTCTAGGA.TGGAATCGT	ACTCTAGGA.TGGAATCGT
ACTCTCACA.CTGTACGAC	ACTCTCACA.CTGTACGAC
ACTCTGCTC.ATCGGTGGT	ACTCTGCTC.ATCGGTGGT
ACTCTGCTC.CCACTTCGC	ACTCTGCTC.CCACTTCGC
ACTCTGCTC.CCGGTTCTA	ACTCTGCTC.CCGGTTCTA
ACTCTGCTC.GCGACCTGT	ACTCTGCTC.GCGACCTGT
ACTCTGCTC.GCGTGATAC	ACTCTGCTC.GCGTGATAC
ACTCTGCTC.GTGAGGACG	ACTCTGCTC.GTGAGGACG
ACTCTGCTC.GTGGATAAG	ACTCTGCTC.GTGGATAAG
ACTCTGCTC.TCAGTGTTC	ACTCTGCTC.TCAGTGTTC
ACTGACTAC.AACGCCTAC	ACTGACTAC.AACGCCTAC
ACTGCTAGT.AAGCCAAGT	ACTGCTAGT.AAGCCAAGT
ACTGCTAGT.CTGGACACT	ACTGCTAGT.CTGGACACT
ACTGCTAGT.TTACGCTCG	ACTGCTAGT.TTACGCTCG
ACTGGACCA.ACGCACACT	ACTGGACCA.ACGCACACT
ACTGGACCA.AGGATCATG	ACTGGACCA.AGGATCATG
ACTGGACCA.ATGAACTAG	ACTGGACCA.ATGAACTAG
ACTGGACCA.CAACTAATC	ACTGGACCA.CAACTAATC
ACTGGACCA.CAATTGTCT	ACTGGACCA.CAATTGTCT
ACTGGACCA.CATACAACC	ACTGGACCA.CATACAACC
ACTGGACCA.CTGTCTAGT	ACTGGACCA.CTGTCTAGT
ACTGGACCA.GAGTTAACT	ACTGGACCA.GAGTTAACT
ACTGGACCA.TGACAAGTT	ACTGGACCA.TGACAAGTT
ACTGGACCA.TTAGTCGGA	ACTGGACCA.TTAGTCGGA
ACTGGTCAG.ACCATTCAC	ACTGGTCAG.ACCATTCAC
ACTGGTCAG.ATCCGTCTC	ACTGGTCAG.ATCCGTCTC
ACTGGTGCT.TCTCAGGAT	ACTGGTGCT.TCTCAGGAT
ACTGGTGCT.TGATTCACC	ACTGGTGCT.TGATTCACC
ACTGTAATC.CTGGTGACA	ACTGTAATC.CTGGTGACA
ACTGTAATC.TGATTGCTG	ACTGTAATC.TGATTGCTG
ACTGTAATC.TGCCGCTAC	ACTGTAATC.TGCCGCTAC
ACTGTGTCA.ACGATGGAA	ACTGTGTCA.ACGATGGAA
ACTGTGTCA.ATGCAGTTC	ACTGTGTCA.ATGCAGTTC
ACTGTGTCA.CACTTGGAT	ACTGTGTCA.CACTTGGAT
ACTGTGTCA.GAGAACAGG	ACTGTGTCA.GAGAACAGG
ACTGTGTCA.GATCTGAAT	ACTGTGTCA.GATCTGAAT
ACTGTGTCA.GCAACCAAC	ACTGTGTCA.GCAACCAAC
ACTGTGTCA.TATGCCTTC	ACTGTGTCA.TATGCCTTC
ACTTAGCTT.AACACACTC	ACTTAGCTT.AACACACTC
ACTTCAGTA.GTAAGGTCC	ACTTCAGTA.GTAAGGTCC
ACTTCAGTA.GTTGACCAT	ACTTCAGTA.GTTGACCAT
ACTTCGCAG.CTGGTAATC	ACTTCGCAG.CTGGTAATC
ACTTCGCAG.GCCTGGAAT	ACTTCGCAG.GCCTGGAAT
ACTTCGCAG.GTGAACCAC	ACTTCGCAG.GTGAACCAC
ACTTCGCAG.TACCAGCCA	ACTTCGCAG.TACCAGCCA
ACTTCGCAG.TAGAGCCAG	ACTTCGCAG.TAGAGCCAG
ACTTCGCAG.TGAACGGTT	ACTTCGCAG.TGAACGGTT
ACTTCTAAC.AGCGGTAAG	ACTTCTAAC.AGCGGTAAG
ACTTCTAAC.CTTCCGGTA	ACTTCTAAC.CTTCCGGTA
ACTTCTAAC.GATAGTTCT	ACTTCTAAC.GATAGTTCT
ACTTCTAAC.GATGTCTAG	ACTTCTAAC.GATGTCTAG
ACTTCTAAC.GGACTATTC	ACTTCTAAC.GGACTATTC
ACTTCTAAC.GTGATGTGC	ACTTCTAAC.GTGATGTGC
ACTTCTTGG.ATGCCTGTC	ACTTCTTGG.ATGCCTGTC
ACTTCTTGG.GGTTCGCAA	ACTTCTTGG.GGTTCGCAA
ACTTGATCT.ACTCCGGTT	ACTTGATCT.ACTCCGGTT
ACTTGATCT.CCAAGTCGA	ACTTGATCT.CCAAGTCGA
ACTTGATCT.GCCTTGTGA	ACTTGATCT.GCCTTGTGA
ACTTGATCT.GTCAGCGTC	ACTTGATCT.GTCAGCGTC
ACTTGATCT.GTGCATCAA	ACTTGATCT.GTGCATCAA
AGAAGAGTC.ATTCACCTC	AGAAGAGTC.ATTCACCTC
AGAAGAGTC.CTGGTAATC	AGAAGAGTC.CTGGTAATC
AGAAGAGTC.GATTATGCG	AGAAGAGTC.GATTATGCG
AGAAGAGTC.TATACGTGG	AGAAGAGTC.TATACGTGG
AGAAGAGTC.TTGTCAACC	AGAAGAGTC.TTGTCAACC
AGAAGCTGC.AGCTTGGTG	AGAAGCTGC.AGCTTGGTG
AGAAGCTGC.CCACTACCA	AGAAGCTGC.CCACTACCA
AGAAGTAAC.ACACTAACG	AGAAGTAAC.ACACTAACG
AGAAGTAAC.AGCGGTCTA	AGAAGTAAC.AGCGGTCTA
AGAAGTCCT.ATCCGGTCC	AGAAGTCCT.ATCCGGTCC
AGAAGTCCT.TCGGACAGT	AGAAGTCCT.TCGGACAGT
AGAAGTCCT.TGCGCACTG	AGAAGTCCT.TGCGCACTG
AGAATCAGA.CAAGAGAGT	AGAATCAGA.CAAGAGAGT
AGAATCAGA.CCTGTTAGC	AGAATCAGA.CCTGTTAGC
AGAATCAGA.GTACTCTAC	AGAATCAGA.GTACTCTAC
AGAATCAGA.TCAAGCGTA	AGAATCAGA.TCAAGCGTA
AGACATATC.GTAATCAGC	AGACATATC.GTAATCAGC
AGACATCCA.AGGATGCGT	AGACATCCA.AGGATGCGT
AGACATCCA.CAAGAACCG	AGACATCCA.CAAGAACCG
AGACATCCA.CCTCTCTAG	AGACATCCA.CCTCTCTAG
AGACATCCA.GATCGCGAA	AGACATCCA.GATCGCGAA
AGACATCCA.GCAGATCCG	AGACATCCA.GCAGATCCG
AGACATCCA.GGACACTGG	AGACATCCA.GGACACTGG
AGACCACGC.ATTGCGCTA	AGACCACGC.ATTGCGCTA
AGACCACGC.CCTCCTTGT	AGACCACGC.CCTCCTTGT
AGACCACGC.CCTGTCGAC	AGACCACGC.CCTGTCGAC
AGACCACGC.TCGGACAGT	AGACCACGC.TCGGACAGT
AGACCACGC.TTAGATCGG	AGACCACGC.TTAGATCGG
AGACCAGCT.ATATAGCGT	AGACCAGCT.ATATAGCGT
AGACCAGCT.CGGACAAGT	AGACCAGCT.CGGACAAGT
AGACCAGCT.CTTATCTCA	AGACCAGCT.CTTATCTCA
AGACCAGCT.GTAACCATA	AGACCAGCT.GTAACCATA
AGACCAGCT.TCGGTATCA	AGACCAGCT.TCGGTATCA
AGACCAGCT.TGATGTGTG	AGACCAGCT.TGATGTGTG
AGACGCCTG.CACCAAGAT	AGACGCCTG.CACCAAGAT
AGACGCCTG.CCAATGCCT	AGACGCCTG.CCAATGCCT
AGACGCCTG.TATCAGTGC	AGACGCCTG.TATCAGTGC
AGACGCTAT.CGTACACAC	AGACGCTAT.CGTACACAC
AGACGCTAT.GCTCAGCCA	AGACGCTAT.GCTCAGCCA
AGACGCTAT.TAGCACTAT	AGACGCTAT.TAGCACTAT
AGACGCTAT.TATCTGTCA	AGACGCTAT.TATCTGTCA
AGACGCTAT.TCCGGAGCT	AGACGCTAT.TCCGGAGCT
AGACGGAGG.AGGAGCAAT	AGACGGAGG.AGGAGCAAT
AGACGGAGG.GAGGTGAGC	AGACGGAGG.GAGGTGAGC
AGACGGAGG.TTCCGAGCG	AGACGGAGG.TTCCGAGCG
AGACTAGTA.CATACAACC	AGACTAGTA.CATACAACC
AGACTAGTA.TGATACCGT	AGACTAGTA.TGATACCGT
AGACTTCGT.CACCTTCCT	AGACTTCGT.CACCTTCCT
AGACTTCGT.GCGGTAGTC	AGACTTCGT.GCGGTAGTC
AGACTTCGT.TACAACACC	AGACTTCGT.TACAACACC
AGACTTCGT.TCTATTAGG	AGACTTCGT.TCTATTAGG
AGACTTCGT.TTAGCGTCT	AGACTTCGT.TTAGCGTCT
AGAGAGTGG.GTCTTCATA	AGAGAGTGG.GTCTTCATA
AGAGAGTGG.TGATTATCG	AGAGAGTGG.TGATTATCG
AGAGCCGCA.AATCCGCTG	AGAGCCGCA.AATCCGCTG
AGAGCCGCA.ACAATTCGG	AGAGCCGCA.ACAATTCGG
AGAGCCGCA.CAATGTGCT	AGAGCCGCA.CAATGTGCT
AGAGCCGCA.CCGGATTGC	AGAGCCGCA.CCGGATTGC
AGAGCCGCA.TAGATAGCC	AGAGCCGCA.TAGATAGCC
AGAGCGCGA.ATCACTTCC	AGAGCGCGA.ATCACTTCC
AGAGCGCGA.GTTCAGAAG	AGAGCGCGA.GTTCAGAAG
AGAGCGCGA.TAGTGCACT	AGAGCGCGA.TAGTGCACT
AGAGCGCGA.TCACTACGT	AGAGCGCGA.TCACTACGT
AGAGCGCGA.TGCAACTCT	AGAGCGCGA.TGCAACTCT
AGAGCGGAG.AGATCGAGT	AGAGCGGAG.AGATCGAGT
AGAGCGGAG.CAGGAGCCT	AGAGCGGAG.CAGGAGCCT
AGAGCGGAG.GTGACTCTC	AGAGCGGAG.GTGACTCTC
AGAGCGGAG.TCGCCAAGC	AGAGCGGAG.TCGCCAAGC
AGAGGACGT.ACCTGTACC	AGAGGACGT.ACCTGTACC
AGAGGACGT.AGCGGAACA	AGAGGACGT.AGCGGAACA
AGAGGACGT.GAGTGTGCC	AGAGGACGT.GAGTGTGCC
AGAGGTGAA.CTCTGCGGT	AGAGGTGAA.CTCTGCGGT
AGAGGTGAA.TTATCCAAG	AGAGGTGAA.TTATCCAAG
AGAGGTGAA.TTCCGCCAG	AGAGGTGAA.TTCCGCCAG
AGATACGTT.AGATATGGA	AGATACGTT.AGATATGGA
AGATACGTT.CTAATACGC	AGATACGTT.CTAATACGC
AGATATGGA.ACGCTCTTA	AGATATGGA.ACGCTCTTA
AGATATGGA.ATTCTCTGG	AGATATGGA.ATTCTCTGG
AGATATGGA.CACTACAGG	AGATATGGA.CACTACAGG
AGATATGGA.CATATGCGA	AGATATGGA.CATATGCGA
AGATATGGA.CGGTTCTAT	AGATATGGA.CGGTTCTAT
AGATATGGA.CGTGACCAG	AGATATGGA.CGTGACCAG
AGATATGGA.GCCATACAA	AGATATGGA.GCCATACAA
AGATATGGA.GGAGACACA	AGATATGGA.GGAGACACA
AGATATGGA.TGACGATGA	AGATATGGA.TGACGATGA
AGATCGAGT.CTCTGCGGT	AGATCGAGT.CTCTGCGGT
AGATCGAGT.TGTCGTGAG	AGATCGAGT.TGTCGTGAG
AGATCTGAC.ACAGCGTAT	AGATCTGAC.ACAGCGTAT
AGATCTGAC.ATCGATCCT	AGATCTGAC.ATCGATCCT
AGATCTGAC.CAATCAAGT	AGATCTGAC.CAATCAAGT
AGATCTGAC.CGTACACAC	AGATCTGAC.CGTACACAC
AGATCTGAC.TGTGAGTAT	AGATCTGAC.TGTGAGTAT
AGATCTTCA.ATGGATATC	AGATCTTCA.ATGGATATC
AGATCTTCA.CACGGATAG	AGATCTTCA.CACGGATAG
AGATCTTCA.CCTGTATCT	AGATCTTCA.CCTGTATCT
AGATCTTCA.GCGCTCTAT	AGATCTTCA.GCGCTCTAT
AGATGAAGA.GTCTCCAGG	AGATGAAGA.GTCTCCAGG
AGATGAAGA.GTTAGATTG	AGATGAAGA.GTTAGATTG
AGATGAAGA.TACGACTTG	AGATGAAGA.TACGACTTG
AGATGAGAT.AATGCTATC	AGATGAGAT.AATGCTATC
AGATGAGAT.CCAAGCGAG	AGATGAGAT.CCAAGCGAG
AGATGAGAT.CTCGACGAT	AGATGAGAT.CTCGACGAT
AGATGAGAT.CTCGCAAGA	AGATGAGAT.CTCGCAAGA
AGATGAGAT.GTCTCCAGG	AGATGAGAT.GTCTCCAGG
AGATGAGAT.TTATCCAAG	AGATGAGAT.TTATCCAAG
AGATGTTGG.CGCACTCTT	AGATGTTGG.CGCACTCTT
AGATGTTGG.GATCGCACT	AGATGTTGG.GATCGCACT
AGATGTTGG.TAGCGCAGC	AGATGTTGG.TAGCGCAGC
AGCAACATT.ACGCGACAG	AGCAACATT.ACGCGACAG
AGCAACATT.AGATGAGAT	AGCAACATT.AGATGAGAT
AGCAACATT.ATCTGCGTA	AGCAACATT.ATCTGCGTA
AGCAACATT.ATTCCGTAC	AGCAACATT.ATTCCGTAC
AGCAACATT.CACAACCAG	AGCAACATT.CACAACCAG
AGCAACATT.CACTCACTA	AGCAACATT.CACTCACTA
AGCAACATT.CTCCGCATT	AGCAACATT.CTCCGCATT
AGCAACATT.TCGAATAGA	AGCAACATT.TCGAATAGA
AGCAAGTCC.CCTAAGAAG	AGCAAGTCC.CCTAAGAAG
AGCAAGTCC.CTCCTATCT	AGCAAGTCC.CTCCTATCT
AGCAAGTCC.CTCTAGTAA	AGCAAGTCC.CTCTAGTAA
AGCAAGTCC.GGAAGTATG	AGCAAGTCC.GGAAGTATG
AGCAAGTCC.GGATAGTCA	AGCAAGTCC.GGATAGTCA
AGCACACCT.AGAAGTAAC	AGCACACCT.AGAAGTAAC
AGCACACCT.CCGCATCCT	AGCACACCT.CCGCATCCT
AGCACACCT.CGGAAGACG	AGCACACCT.CGGAAGACG
AGCACACCT.GTAGCTACA	AGCACACCT.GTAGCTACA
AGCACACCT.GTGCTGACT	AGCACACCT.GTGCTGACT
AGCACACCT.GTTCACTCC	AGCACACCT.GTTCACTCC
AGCACACCT.TAACGGATA	AGCACACCT.TAACGGATA
AGCACCAGC.ATCCTCCGA	AGCACCAGC.ATCCTCCGA
AGCACCAGC.CTGTCTAGT	AGCACCAGC.CTGTCTAGT
AGCACCAGC.TCGATTCAG	AGCACCAGC.TCGATTCAG
AGCACCAGC.TGTGGACAA	AGCACCAGC.TGTGGACAA
AGCACCGTG.ATCTGCGTA	AGCACCGTG.ATCTGCGTA
AGCACCGTG.GTACGTCTA	AGCACCGTG.GTACGTCTA
AGCACCGTG.GTATGATCT	AGCACCGTG.GTATGATCT
AGCAGACAA.CGCGAGTGT	AGCAGACAA.CGCGAGTGT
AGCAGACAA.TCTTGGTAG	AGCAGACAA.TCTTGGTAG
AGCAGACAA.TGCGCACTG	AGCAGACAA.TGCGCACTG
AGCATATGG.AGCGCATGA	AGCATATGG.AGCGCATGA
AGCATATGG.CCACGTTCT	AGCATATGG.CCACGTTCT
AGCATATGG.CTCGTGTCC	AGCATATGG.CTCGTGTCC
AGCATATGG.CTCTGCAAG	AGCATATGG.CTCTGCAAG
AGCATTCCA.AAGGAAGTC	AGCATTCCA.AAGGAAGTC
AGCATTCCA.ACACCGCCA	AGCATTCCA.ACACCGCCA
AGCATTCCA.ACAGAGATG	AGCATTCCA.ACAGAGATG
AGCATTCCA.AGCATTGTT	AGCATTCCA.AGCATTGTT
AGCATTCCA.AGCTCTCCG	AGCATTCCA.AGCTCTCCG
AGCATTCCA.CTAGTGCTG	AGCATTCCA.CTAGTGCTG
AGCATTCCA.CTCTCAGTC	AGCATTCCA.CTCTCAGTC
AGCATTCCA.TGCAGTTCA	AGCATTCCA.TGCAGTTCA
AGCATTGTT.ATATCCGAT	AGCATTGTT.ATATCCGAT
AGCATTGTT.GAACATGAC	AGCATTGTT.GAACATGAC
AGCCACTTC.ATCGTAGTG	AGCCACTTC.ATCGTAGTG
AGCCACTTC.CCATAAGTA	AGCCACTTC.CCATAAGTA
AGCCACTTC.GCAGCAGTG	AGCCACTTC.GCAGCAGTG
AGCCACTTC.TGTGGTCCT	AGCCACTTC.TGTGGTCCT
AGCCACTTC.TGTTAAGCC	AGCCACTTC.TGTTAAGCC
AGCCAGGAC.AGAGAGTGG	AGCCAGGAC.AGAGAGTGG
AGCCAGGAC.CCGGTTCTA	AGCCAGGAC.CCGGTTCTA
AGCCAGGAC.GAGGTCCTT	AGCCAGGAC.GAGGTCCTT
AGCCAGGAC.GCGGAGATT	AGCCAGGAC.GCGGAGATT
AGCCGGATC.GACCAACAG	AGCCGGATC.GACCAACAG
AGCCGGATC.GAGATACAC	AGCCGGATC.GAGATACAC
AGCCGGATC.TAAGGTCCG	AGCCGGATC.TAAGGTCCG
AGCCGGATC.TTGGACTTC	AGCCGGATC.TTGGACTTC
AGCCGTTCT.ACAGCGGTC	AGCCGTTCT.ACAGCGGTC
AGCCGTTCT.ACCTAGTTA	AGCCGTTCT.ACCTAGTTA
AGCCGTTCT.CAGTCCTAA	AGCCGTTCT.CAGTCCTAA
AGCCGTTCT.CCGATGTTC	AGCCGTTCT.CCGATGTTC
AGCCTCGCA.AATCCGCTG	AGCCTCGCA.AATCCGCTG
AGCCTCGCA.ATTCGCTTA	AGCCTCGCA.ATTCGCTTA
AGCCTCGCA.CATCGAAGC	AGCCTCGCA.CATCGAAGC
AGCCTCGCA.GATCTTCGC	AGCCTCGCA.GATCTTCGC
AGCCTCGCA.GCTCAGCCA	AGCCTCGCA.GCTCAGCCA
AGCCTCGCA.TCGACGTTG	AGCCTCGCA.TCGACGTTG
AGCCTCGCA.TGCGTAATC	AGCCTCGCA.TGCGTAATC
AGCCTCTAG.ATGCCTGTC	AGCCTCTAG.ATGCCTGTC
AGCCTCTAG.CCTGTATCT	AGCCTCTAG.CCTGTATCT
AGCCTCTAG.GTACGCGAT	AGCCTCTAG.GTACGCGAT
AGCCTCTAG.GTGTTCCAG	AGCCTCTAG.GTGTTCCAG
AGCCTCTAG.TAATTCGTG	AGCCTCTAG.TAATTCGTG
AGCGACACC.CCTGCTCCA	AGCGACACC.CCTGCTCCA
AGCGCATGA.ATAAGACAG	AGCGCATGA.ATAAGACAG
AGCGCATGA.ATGTCGCCT	AGCGCATGA.ATGTCGCCT
AGCGCATGA.CACGTCATA	AGCGCATGA.CACGTCATA
AGCGCATGA.CACTGTATC	AGCGCATGA.CACTGTATC
AGCGCATGA.TATCAGTGC	AGCGCATGA.TATCAGTGC
AGCGGAACA.ACGCTCTTA	AGCGGAACA.ACGCTCTTA
AGCGGTAAG.AGGTATTCC	AGCGGTAAG.AGGTATTCC
AGCGGTAAG.GCAATGAGA	AGCGGTAAG.GCAATGAGA
AGCGGTAAG.GCGAAGCTC	AGCGGTAAG.GCGAAGCTC
AGCGGTCTA.CCTAAGAAG	AGCGGTCTA.CCTAAGAAG
AGCGTAGAA.TCACTCGCT	AGCGTAGAA.TCACTCGCT
AGCGTAGAA.TCTTGGTAG	AGCGTAGAA.TCTTGGTAG
AGCGTCGTC.ATATGCAGC	AGCGTCGTC.ATATGCAGC
AGCGTCGTC.CCGATCTCT	AGCGTCGTC.CCGATCTCT
AGCGTCGTC.GCCGAGTCT	AGCGTCGTC.GCCGAGTCT
AGCGTCGTC.GTTAGAGAC	AGCGTCGTC.GTTAGAGAC
AGCGTCGTC.TCGCTTAAC	AGCGTCGTC.TCGCTTAAC
AGCTACTCA.AGAAGCTGC	AGCTACTCA.AGAAGCTGC
AGCTACTCA.AGCGACACC	AGCTACTCA.AGCGACACC
AGCTACTCA.CACTTCCTT	AGCTACTCA.CACTTCCTT
AGCTACTCA.TCAGAGTCA	AGCTACTCA.TCAGAGTCA
AGCTATATG.AACGCATTG	AGCTATATG.AACGCATTG
AGCTATATG.ACGACAGTC	AGCTATATG.ACGACAGTC
AGCTATATG.ACTACTCAT	AGCTATATG.ACTACTCAT
AGCTATATG.AGCACCAGC	AGCTATATG.AGCACCAGC
AGCTATATG.TCCAGAACG	AGCTATATG.TCCAGAACG
AGCTATATG.TCCTTAGGT	AGCTATATG.TCCTTAGGT
AGCTCGTCT.CTTAACAGC	AGCTCGTCT.CTTAACAGC
AGCTCGTCT.GATACTGTG	AGCTCGTCT.GATACTGTG
AGCTCGTCT.GCGTAACAA	AGCTCGTCT.GCGTAACAA
AGCTCGTCT.GTACTCTAC	AGCTCGTCT.GTACTCTAC
AGCTGCACT.AAGGAACAG	AGCTGCACT.AAGGAACAG
