CAGTGAGGA.TTCACCTTG	CAGTGAGGA.TTCACCTTG
CAGTGAGGA.TTCCAATTC	CAGTGAGGA.TTCCAATTC
CAGTGCCAT.AGCAGACAA	CAGTGCCAT.AGCAGACAA
CAGTGCCAT.ATGTGAGAC	CAGTGCCAT.ATGTGAGAC
CAGTGCCAT.CACATATCA	CAGTGCCAT.CACATATCA
CAGTGCCAT.GTCGTTGCG	CAGTGCCAT.GTCGTTGCG
CAGTGCCAT.TATGATGTG	CAGTGCCAT.TATGATGTG
CAGTGCCAT.TGGAAGATT	CAGTGCCAT.TGGAAGATT
CAGTGCTGC.ATCCACAGT	CAGTGCTGC.ATCCACAGT
CAGTGCTGC.CGCAATCGA	CAGTGCTGC.CGCAATCGA
CAGTGCTGC.GAGACATTG	CAGTGCTGC.GAGACATTG
CAGTGCTGC.GGTGGAGCT	CAGTGCTGC.GGTGGAGCT
CAGTTACTG.ACAGCATCA	CAGTTACTG.ACAGCATCA
CAGTTACTG.CCAGCCAAT	CAGTTACTG.CCAGCCAAT
CAGTTACTG.GTTGCTCAG	CAGTTACTG.GTTGCTCAG
CAGTTACTG.TATCGGAAC	CAGTTACTG.TATCGGAAC
CAGTTGAGT.AGTCATACT	CAGTTGAGT.AGTCATACT
CAGTTGAGT.GCGACAACC	CAGTTGAGT.GCGACAACC
CAGTTGAGT.TAGGATTAG	CAGTTGAGT.TAGGATTAG
CAGTTGAGT.TGTGCTAAC	CAGTTGAGT.TGTGCTAAC
CATAAGATC.ACACACGTC	CATAAGATC.ACACACGTC
CATAAGATC.ACAGTATTG	CATAAGATC.ACAGTATTG
CATAAGATC.GATAAGCTG	CATAAGATC.GATAAGCTG
CATAAGATC.TCACATACT	CATAAGATC.TCACATACT
CATAATTGG.ATTCGAAGA	CATAATTGG.ATTCGAAGA
CATAATTGG.TCAGAGTCA	CATAATTGG.TCAGAGTCA
CATAATTGG.TCTCCGCGT	CATAATTGG.TCTCCGCGT
CATACAACC.ACGCTAGTG	CATACAACC.ACGCTAGTG
CATACAACC.CCAGATCAC	CATACAACC.CCAGATCAC
CATACAACC.CTAACTAAG	CATACAACC.CTAACTAAG
CATACAACC.CTATAGCTC	CATACAACC.CTATAGCTC
CATACAACC.GCTGACAGA	CATACAACC.GCTGACAGA
CATACGCAG.CAGTACATC	CATACGCAG.CAGTACATC
CATACGCAG.TGCAACTCT	CATACGCAG.TGCAACTCT
CATAGAGAT.GAGTCTTCG	CATAGAGAT.GAGTCTTCG
CATAGAGAT.TATGATGTG	CATAGAGAT.TATGATGTG
CATAGGTGT.AGTGTGCAC	CATAGGTGT.AGTGTGCAC
CATAGGTGT.CATTCGAAT	CATAGGTGT.CATTCGAAT
CATAGGTGT.CGAGCTTAC	CATAGGTGT.CGAGCTTAC
CATAGGTGT.TACTAGTAG	CATAGGTGT.TACTAGTAG
CATAGGTGT.TAGGATGCC	CATAGGTGT.TAGGATGCC
CATAGTATG.ACAGCGTAT	CATAGTATG.ACAGCGTAT
CATAGTATG.ATACCGCTT	CATAGTATG.ATACCGCTT
CATAGTATG.GTGCGTTCC	CATAGTATG.GTGCGTTCC
CATAGTATG.TGGTCGCTA	CATAGTATG.TGGTCGCTA
CATATGCGA.ACCTAGCAC	CATATGCGA.ACCTAGCAC
CATATGCGA.CAACGATCG	CATATGCGA.CAACGATCG
CATATGCGA.CACGCGTAA	CATATGCGA.CACGCGTAA
CATATGCGA.CAGCGTAAG	CATATGCGA.CAGCGTAAG
CATATGCGA.CGGTTCGTA	CATATGCGA.CGGTTCGTA
CATATGCGA.CGTAATGAC	CATATGCGA.CGTAATGAC
CATATGCGA.CTCCGCATT	CATATGCGA.CTCCGCATT
CATATGTCG.AAGTTGCCA	CATATGTCG.AAGTTGCCA
CATATGTCG.ACCGCTGTG	CATATGTCG.ACCGCTGTG
CATATGTCG.AGTTGCCTT	CATATGTCG.AGTTGCCTT
CATATGTCG.CACATATCA	CATATGTCG.CACATATCA
CATATGTCG.CTTATCTCA	CATATGTCG.CTTATCTCA
CATCAATAG.AAGGATACG	CATCAATAG.AAGGATACG
CATCAATAG.CGGAAGACG	CATCAATAG.CGGAAGACG
CATCAATAG.CTGTGGTGG	CATCAATAG.CTGTGGTGG
CATCAATAG.GAGGACTTA	CATCAATAG.GAGGACTTA
CATCAATAG.GCTTCTACG	CATCAATAG.GCTTCTACG
CATCAATAG.GGTTGAAGG	CATCAATAG.GGTTGAAGG
CATCCACCG.CACAATAAC	CATCCACCG.CACAATAAC
CATCCACCG.CGTTACACC	CATCCACCG.CGTTACACC
CATCCACCG.GATAAGCTG	CATCCACCG.GATAAGCTG
CATCCACCG.GTGTCTGGA	CATCCACCG.GTGTCTGGA
CATCCACCG.TACGACTTG	CATCCACCG.TACGACTTG
CATCCAGGA.ACCGAGACA	CATCCAGGA.ACCGAGACA
CATCCAGGA.ACGGTGCCT	CATCCAGGA.ACGGTGCCT
CATCCAGGA.CGCCACCAT	CATCCAGGA.CGCCACCAT
CATCCAGGA.CTACGAGAA	CATCCAGGA.CTACGAGAA
CATCCAGGA.CTAGAGGTA	CATCCAGGA.CTAGAGGTA
CATCCAGGA.GCAACTCGC	CATCCAGGA.GCAACTCGC
CATCCAGGA.GTACGCGAT	CATCCAGGA.GTACGCGAT
CATCCAGGA.GTAGAAGTT	CATCCAGGA.GTAGAAGTT
CATCCAGGA.GTCAGACCG	CATCCAGGA.GTCAGACCG
CATCCGACA.GCATGTAAG	CATCCGACA.GCATGTAAG
CATCCGACA.TACAGTTAG	CATCCGACA.TACAGTTAG
CATCCTCTC.ACAGCATCA	CATCCTCTC.ACAGCATCA
CATCCTCTC.ACTCGTCTA	CATCCTCTC.ACTCGTCTA
CATCCTCTC.ATGGACGTT	CATCCTCTC.ATGGACGTT
CATCCTCTC.CGAGTAGCA	CATCCTCTC.CGAGTAGCA
CATCGAAGC.AATCTGACC	CATCGAAGC.AATCTGACC
CATCGAAGC.CTTGATCTA	CATCGAAGC.CTTGATCTA
CATCGAAGC.GCCGCCTAA	CATCGAAGC.GCCGCCTAA
CATCGAAGC.GTCTACCAA	CATCGAAGC.GTCTACCAA
CATCGCTGG.ACACGTTGC	CATCGCTGG.ACACGTTGC
CATCGCTGG.CGGTGTTAC	CATCGCTGG.CGGTGTTAC
CATCTCACG.ATTAAGACC	CATCTCACG.ATTAAGACC
CATCTCACG.CCGCAACAC	CATCTCACG.CCGCAACAC
CATCTCACG.CCGCTATCC	CATCTCACG.CCGCTATCC
CATCTCACG.CCTGTCGAC	CATCTCACG.CCTGTCGAC
CATCTCACG.GCGAAGCTC	CATCTCACG.GCGAAGCTC
CATCTCGAT.ATGTCGCCT	CATCTCGAT.ATGTCGCCT
CATCTCGAT.CAACGTCTT	CATCTCGAT.CAACGTCTT
CATCTCGAT.CATCCACCG	CATCTCGAT.CATCCACCG
CATCTCGAT.CCTGCTCCA	CATCTCGAT.CCTGCTCCA
CATCTCGAT.CGTGTATTC	CATCTCGAT.CGTGTATTC
CATCTCGAT.CTGCATGTT	CATCTCGAT.CTGCATGTT
CATCTCGAT.CTTAGGACT	CATCTCGAT.CTTAGGACT
CATCTCGAT.GGAAGTATG	CATCTCGAT.GGAAGTATG
CATCTCGAT.GTAGGACGC	CATCTCGAT.GTAGGACGC
CATCTCGAT.GTATGCCTT	CATCTCGAT.GTATGCCTT
CATCTCGAT.TAGTGATCC	CATCTCGAT.TAGTGATCC
CATCTCGAT.TCCAGCTAT	CATCTCGAT.TCCAGCTAT
CATCTCGAT.TCTTGGTAG	CATCTCGAT.TCTTGGTAG
CATCTCGAT.TTCTGAATG	CATCTCGAT.TTCTGAATG
CATGACGTT.AATCTCCTA	CATGACGTT.AATCTCCTA
CATGACGTT.CTGATCAAG	CATGACGTT.CTGATCAAG
CATGACGTT.GCAACCAAC	CATGACGTT.GCAACCAAC
CATGCCAGT.ACAAGAATG	CATGCCAGT.ACAAGAATG
CATGCCAGT.CCGCACTCA	CATGCCAGT.CCGCACTCA
CATGCCAGT.CGGAATGCA	CATGCCAGT.CGGAATGCA
CATGCCAGT.CTTAGGACT	CATGCCAGT.CTTAGGACT
CATGCCAGT.CTTCGACTG	CATGCCAGT.CTTCGACTG
CATGCCAGT.GTCTGACGT	CATGCCAGT.GTCTGACGT
CATGCCAGT.GTGTATCTG	CATGCCAGT.GTGTATCTG
CATGGACTC.AATGTGCGT	CATGGACTC.AATGTGCGT
CATGGACTC.AGTTAGGTC	CATGGACTC.AGTTAGGTC
CATGGACTC.ATCCACAGT	CATGGACTC.ATCCACAGT
CATGGACTC.GGTTGCTAT	CATGGACTC.GGTTGCTAT
CATGGACTC.TCACTCGCT	CATGGACTC.TCACTCGCT
CATGGACTC.TCTTAAGTG	CATGGACTC.TCTTAAGTG
CATGGTCGA.AAGCATTGC	CATGGTCGA.AAGCATTGC
CATGGTCGA.ACAGGAACT	CATGGTCGA.ACAGGAACT
CATGGTCGA.AGACGCCTG	CATGGTCGA.AGACGCCTG
CATGGTCGA.AGCCTCGCA	CATGGTCGA.AGCCTCGCA
CATGGTCGA.AGTCCGTGT	CATGGTCGA.AGTCCGTGT
CATGGTCGA.ATCGCCTCT	CATGGTCGA.ATCGCCTCT
CATGGTCGA.CTTCTATGA	CATGGTCGA.CTTCTATGA
CATGGTCGA.TGAGATCAT	CATGGTCGA.TGAGATCAT
CATGGTTAC.AATCAGGAG	CATGGTTAC.AATCAGGAG
CATGGTTAC.AGAGAGTGG	CATGGTTAC.AGAGAGTGG
CATGGTTAC.ATACCGCTT	CATGGTTAC.ATACCGCTT
CATGTCCTG.CAGCCGCAA	CATGTCCTG.CAGCCGCAA
CATGTCCTG.TGGTTATAC	CATGTCCTG.TGGTTATAC
CATGTGAAC.AGCGGAACA	CATGTGAAC.AGCGGAACA
CATGTGAAC.CCTCGGTCA	CATGTGAAC.CCTCGGTCA
CATGTGAAC.CCTTCGAGC	CATGTGAAC.CCTTCGAGC
CATGTGAAC.GACGTAGCA	CATGTGAAC.GACGTAGCA
CATTATGTC.ATGAACTAG	CATTATGTC.ATGAACTAG
CATTCAGTT.CATCCAGGA	CATTCAGTT.CATCCAGGA
CATTCAGTT.CGTGCAAGG	CATTCAGTT.CGTGCAAGG
CATTCAGTT.CGTTCGTAC	CATTCAGTT.CGTTCGTAC
CATTCCGAG.AGGATGCGT	CATTCCGAG.AGGATGCGT
CATTCCGAG.GACCAGAGA	CATTCCGAG.GACCAGAGA
CATTCCGAG.GCGCTACCT	CATTCCGAG.GCGCTACCT
CATTCCGAG.TGCAACTCT	CATTCCGAG.TGCAACTCT
CATTCGAAT.ACCATGTCT	CATTCGAAT.ACCATGTCT
CATTCGAAT.ATCCACAGT	CATTCGAAT.ATCCACAGT
CATTCGAAT.ATGTGAGAC	CATTCGAAT.ATGTGAGAC
CATTCGAAT.CAGTGAGGA	CATTCGAAT.CAGTGAGGA
CATTCGAAT.CTGAGATAG	CATTCGAAT.CTGAGATAG
CATTCGAAT.GCTTGTCCT	CATTCGAAT.GCTTGTCCT
CATTCGAAT.TGCGTATCT	CATTCGAAT.TGCGTATCT
CATTGACAA.AACGCATTG	CATTGACAA.AACGCATTG
CATTGACAA.CCGATGTTC	CATTGACAA.CCGATGTTC
CATTGACAA.GAGTATCGC	CATTGACAA.GAGTATCGC
CATTGACAA.TTATGAGGA	CATTGACAA.TTATGAGGA
CATTGCAGA.AACAGCAGT	CATTGCAGA.AACAGCAGT
CATTGCAGA.AAGTACAGA	CATTGCAGA.AAGTACAGA
CATTGCAGA.CACAACGCT	CATTGCAGA.CACAACGCT
CATTGCAGA.GAGATTCCT	CATTGCAGA.GAGATTCCT
CATTGCAGA.GCGATGGTG	CATTGCAGA.GCGATGGTG
CATTGCAGA.TACAGTTAG	CATTGCAGA.TACAGTTAG
CATTGCAGA.TAGTGATCC	CATTGCAGA.TAGTGATCC
CATTGCAGA.TGGTAGCAG	CATTGCAGA.TGGTAGCAG
CATTGTTCA.AGACGCCTG	CATTGTTCA.AGACGCCTG
CATTGTTCA.CAGCCGCAA	CATTGTTCA.CAGCCGCAA
CATTGTTCA.CCGTTAGAC	CATTGTTCA.CCGTTAGAC
CATTGTTCA.GAGGTCACG	CATTGTTCA.GAGGTCACG
CATTGTTCA.TCGCTTAAC	CATTGTTCA.TCGCTTAAC
CATTGTTCA.TCGGACAGT	CATTGTTCA.TCGGACAGT
CCAACAACA.AAGACTACC	CCAACAACA.AAGACTACC
CCAACAACA.TAAGTGTAG	CCAACAACA.TAAGTGTAG
CCAACAACA.TGACGATGA	CCAACAACA.TGACGATGA
CCAACGGAA.AATCTGACC	CCAACGGAA.AATCTGACC
CCAACGGAA.CACTTGGAT	CCAACGGAA.CACTTGGAT
CCAACGGAA.GATGTAAGG	CCAACGGAA.GATGTAAGG
CCAACGGAA.GGTCTTGCA	CCAACGGAA.GGTCTTGCA
CCAACGGAA.GTTCAGAAG	CCAACGGAA.GTTCAGAAG
CCAACGGAA.TCAGACAAG	CCAACGGAA.TCAGACAAG
CCAACGGAA.TGAACCAAT	CCAACGGAA.TGAACCAAT
CCAAGCGAG.AATCTGACC	CCAAGCGAG.AATCTGACC
CCAAGCGAG.CGAATGAGT	CCAAGCGAG.CGAATGAGT
CCAAGCGAG.CGTGTATTC	CCAAGCGAG.CGTGTATTC
CCAAGCGAG.GACACGCAA	CCAAGCGAG.GACACGCAA
CCAAGCGAG.TGTGTCTAC	CCAAGCGAG.TGTGTCTAC
CCAAGTCGA.AACTGATTC	CCAAGTCGA.AACTGATTC
CCAAGTCGA.ATCGTAGTG	CCAAGTCGA.ATCGTAGTG
CCAAGTCGA.CCTCGACCT	CCAAGTCGA.CCTCGACCT
CCAAGTCGA.GCTTCACTC	CCAAGTCGA.GCTTCACTC
CCAAGTCGA.TGTTAAGCC	CCAAGTCGA.TGTTAAGCC
CCAAGTCGA.TTCATTCGC	CCAAGTCGA.TTCATTCGC
CCAATATAC.CATGCCAGT	CCAATATAC.CATGCCAGT
CCAATATAC.TAACTCCGA	CCAATATAC.TAACTCCGA
CCAATGCCT.ATCTGGTAG	CCAATGCCT.ATCTGGTAG
CCAATGCCT.CGTATCGAA	CCAATGCCT.CGTATCGAA
CCAATGCCT.TCGATTCAG	CCAATGCCT.TCGATTCAG
CCAATGCCT.TCTCATCGG	CCAATGCCT.TCTCATCGG
CCAATGCCT.TTCGCTGAG	CCAATGCCT.TTCGCTGAG
CCACAAGGT.AACGAGAAT	CCACAAGGT.AACGAGAAT
CCACAAGGT.CACACCACA	CCACAAGGT.CACACCACA
CCACAAGGT.CATCCACCG	CCACAAGGT.CATCCACCG
CCACAAGGT.CGAACAATC	CCACAAGGT.CGAACAATC
CCACAAGGT.TACGTTGGA	CCACAAGGT.TACGTTGGA
CCACACAGA.AGATACGTT	CCACACAGA.AGATACGTT
CCACACAGA.CAACGATCG	CCACACAGA.CAACGATCG
CCACACAGA.CGTTCGTAC	CCACACAGA.CGTTCGTAC
CCACACAGA.GCACTGGAT	CCACACAGA.GCACTGGAT
CCACACAGA.GCGTGAGCT	CCACACAGA.GCGTGAGCT
CCACACAGA.TTACTAGTC	CCACACAGA.TTACTAGTC
CCACATTAG.AAGCATTGC	CCACATTAG.AAGCATTGC
CCACATTAG.ATAATGTGG	CCACATTAG.ATAATGTGG
CCACATTAG.CCTGTATCT	CCACATTAG.CCTGTATCT
CCACATTAG.CCTGTTAGC	CCACATTAG.CCTGTTAGC
CCACATTAG.GCCGAGTCT	CCACATTAG.GCCGAGTCT
CCACATTAG.GCGATATGA	CCACATTAG.GCGATATGA
CCACATTAG.TCCTCTAGT	CCACATTAG.TCCTCTAGT
CCACATTAG.TCGTCCGAT	CCACATTAG.TCGTCCGAT
CCACCATGC.AGAGCCGCA	CCACCATGC.AGAGCCGCA
CCACCATGC.AGTACGAAT	CCACCATGC.AGTACGAAT
CCACCATGC.CACGACTCA	CCACCATGC.CACGACTCA
CCACCATGC.CATGACGTT	CCACCATGC.CATGACGTT
CCACCATGC.CGCCACCAT	CCACCATGC.CGCCACCAT
CCACCATGC.CTCGTCTTG	CCACCATGC.CTCGTCTTG
CCACCATGC.GTGTCACAC	CCACCATGC.GTGTCACAC
CCACCATGC.TTGATCGTA	CCACCATGC.TTGATCGTA
CCACGAAGG.AGTCATACT	CCACGAAGG.AGTCATACT
CCACGAAGG.GCGTATAGG	CCACGAAGG.GCGTATAGG
CCACGAAGG.TCAGTGCAA	CCACGAAGG.TCAGTGCAA
CCACGCCAT.CACTACAGG	CCACGCCAT.CACTACAGG
CCACGCCAT.GGTGCGTAG	CCACGCCAT.GGTGCGTAG
CCACGGATC.GGTCGGTCT	CCACGGATC.GGTCGGTCT
CCACGGATC.TCTAGGATG	CCACGGATC.TCTAGGATG
CCACGTTCT.CCTCTTGTA	CCACGTTCT.CCTCTTGTA
CCACGTTCT.TATCTAGGT	CCACGTTCT.TATCTAGGT
CCACGTTCT.TGCAGATGC	CCACGTTCT.TGCAGATGC
CCACTACCA.AAGGATCGT	CCACTACCA.AAGGATCGT
CCACTACCA.AATGCCTCA	CCACTACCA.AATGCCTCA
CCACTACCA.AGATCTGAC	CCACTACCA.AGATCTGAC
CCACTACCA.CAAGAGGAG	CCACTACCA.CAAGAGGAG
CCACTACCA.GACACGCAA	CCACTACCA.GACACGCAA
CCACTACCA.GATGCAGAA	CCACTACCA.GATGCAGAA
CCACTACCA.GTGAATGCC	CCACTACCA.GTGAATGCC
CCACTGAAG.AGTTCGATA	CCACTGAAG.AGTTCGATA
CCACTGAAG.ATGGATATC	CCACTGAAG.ATGGATATC
CCACTGAAG.CATAGAGAT	CCACTGAAG.CATAGAGAT
CCACTGAAG.CATGTGAAC	CCACTGAAG.CATGTGAAC
CCACTTCGC.AAGGATCGT	CCACTTCGC.AAGGATCGT
CCACTTCGC.ATCTAGGTT	CCACTTCGC.ATCTAGGTT
CCACTTCGC.TGGAACTAA	CCACTTCGC.TGGAACTAA
CCACTTCGC.TGGTAGCAG	CCACTTCGC.TGGTAGCAG
CCAGATCAC.ACCTAGCAC	CCAGATCAC.ACCTAGCAC
CCAGATCAC.CCTGTATCT	CCAGATCAC.CCTGTATCT
CCAGATCAC.GCCAATGAA	CCAGATCAC.GCCAATGAA
CCAGATCAC.TGAGGTCTC	CCAGATCAC.TGAGGTCTC
CCAGCCAAT.AACACACTC	CCAGCCAAT.AACACACTC
CCAGCCAAT.AGCACACCT	CCAGCCAAT.AGCACACCT
CCAGCCAAT.CACCTAGCG	CCAGCCAAT.CACCTAGCG
CCAGCCAAT.CACGGATAG	CCAGCCAAT.CACGGATAG
CCAGCCAAT.GCGCTACCT	CCAGCCAAT.GCGCTACCT
CCAGCCAAT.TTCCAATTC	CCAGCCAAT.TTCCAATTC
CCAGGAGTT.GAGCCGTTA	CCAGGAGTT.GAGCCGTTA
CCAGGAGTT.TGAACGTCA	CCAGGAGTT.TGAACGTCA
CCAGGAGTT.TGCGCTGCA	CCAGGAGTT.TGCGCTGCA
CCAGGAGTT.TTAGGAAGG	CCAGGAGTT.TTAGGAAGG
CCAGTACTC.ATAATCGAG	CCAGTACTC.ATAATCGAG
CCAGTACTC.ATGCGCCGT	CCAGTACTC.ATGCGCCGT
CCAGTACTC.CAGTAATGT	CCAGTACTC.CAGTAATGT
CCAGTACTC.CTGCAAGCC	CCAGTACTC.CTGCAAGCC
CCAGTACTC.TGCGTATCT	CCAGTACTC.TGCGTATCT
CCAGTCTCA.CGGACAAGT	CCAGTCTCA.CGGACAAGT
CCAGTCTCA.TCTACAGTT	CCAGTCTCA.TCTACAGTT
CCAGTTACG.AACGCCTAC	CCAGTTACG.AACGCCTAC
CCAGTTACG.ACTCGCTGT	CCAGTTACG.ACTCGCTGT
CCAGTTACG.AGAAGCTGC	CCAGTTACG.AGAAGCTGC
CCAGTTACG.ATACGAGGT	CCAGTTACG.ATACGAGGT
CCAGTTACG.GAACTATGG	CCAGTTACG.GAACTATGG
CCAGTTACG.GAATCACAT	CCAGTTACG.GAATCACAT
CCAGTTACG.GATCTGTTC	CCAGTTACG.GATCTGTTC
CCAGTTACG.GCACAACTC	CCAGTTACG.GCACAACTC
CCATAAGTA.ACTCGAGTC	CCATAAGTA.ACTCGAGTC
CCATAAGTA.AGGTATTCC	CCATAAGTA.AGGTATTCC
CCATAAGTA.AGGTCAGCA	CCATAAGTA.AGGTCAGCA
CCATAAGTA.AGTCGCCGA	CCATAAGTA.AGTCGCCGA
CCATAAGTA.GATCTACTT	CCATAAGTA.GATCTACTT
CCATAAGTA.TAATCTGGA	CCATAAGTA.TAATCTGGA
CCATAATCG.AACGGAGAT	CCATAATCG.AACGGAGAT
CCATAATCG.CCAACAACA	CCATAATCG.CCAACAACA
CCATAATCG.CGCATAACT	CCATAATCG.CGCATAACT
CCATAATCG.GCGAGCAAG	CCATAATCG.GCGAGCAAG
CCATAATCG.GGTTCGCAA	CCATAATCG.GGTTCGCAA
CCATAATCG.TTAGATCGG	CCATAATCG.TTAGATCGG
CCATACGAT.AATGCGTGC	CCATACGAT.AATGCGTGC
CCATACGAT.ATCCAGCTG	CCATACGAT.ATCCAGCTG
CCATACGAT.CCATCACGA	CCATACGAT.CCATCACGA
CCATACGAT.GTAAGGTCC	CCATACGAT.GTAAGGTCC
CCATACGAT.TATTGACTG	CCATACGAT.TATTGACTG
CCATAGCCA.AAGCCACAC	CCATAGCCA.AAGCCACAC
CCATAGCCA.CAGTCGGTA	CCATAGCCA.CAGTCGGTA
CCATAGCCA.GAGTCCAAT	CCATAGCCA.GAGTCCAAT
CCATAGCCA.GCGCTCTAT	CCATAGCCA.GCGCTCTAT
CCATAGCCA.GCTGTTCGG	CCATAGCCA.GCTGTTCGG
CCATAGCCA.GGTTCAGAC	CCATAGCCA.GGTTCAGAC
CCATAGCCA.TCGCAAGCA	CCATAGCCA.TCGCAAGCA
CCATATCTT.ACTCCGTCG	CCATATCTT.ACTCCGTCG
CCATATCTT.TTCCGAGCG	CCATATCTT.TTCCGAGCG
CCATATGCC.CCGGATTGC	CCATATGCC.CCGGATTGC
CCATATGCC.TTCTGCCGA	CCATATGCC.TTCTGCCGA
CCATCACGA.TCGGATGTT	CCATCACGA.TCGGATGTT
CCATCACGA.TCGTAATAG	CCATCACGA.TCGTAATAG
CCATCTAGG.AAGACGAAG	CCATCTAGG.AAGACGAAG
CCATCTAGG.CTGGTACAT	CCATCTAGG.CTGGTACAT
CCATGATGT.AACACACTC	CCATGATGT.AACACACTC
CCATGATGT.CCTGTCGAC	CCATGATGT.CCTGTCGAC
CCATGATGT.TACCTATCC	CCATGATGT.TACCTATCC
CCATGCGTC.AGTCTAAGC	CCATGCGTC.AGTCTAAGC
CCATGCGTC.CTGAGTCCA	CCATGCGTC.CTGAGTCCA
CCATGCGTC.GTCAGTTGT	CCATGCGTC.GTCAGTTGT
CCATGCGTC.TCAAGCGTA	CCATGCGTC.TCAAGCGTA
CCATTACAG.GCTTCACTC	CCATTACAG.GCTTCACTC
CCATTACAG.TCAAGCGTA	CCATTACAG.TCAAGCGTA
CCATTACAG.TGTCATAGC	CCATTACAG.TGTCATAGC
CCATTCTGC.CCAGATCAC	CCATTCTGC.CCAGATCAC
CCATTCTGC.GTCAGCGTC	CCATTCTGC.GTCAGCGTC
CCATTCTGC.TACACGGTC	CCATTCTGC.TACACGGTC
CCGAAGCGT.CACACCTGT	CCGAAGCGT.CACACCTGT
CCGAAGCGT.TAGCTGTTG	CCGAAGCGT.TAGCTGTTG
CCGAATATG.CCTTGCTTG	CCGAATATG.CCTTGCTTG
CCGAATATG.GTTGCTCAG	CCGAATATG.GTTGCTCAG
CCGAATATG.TTCGTGATG	CCGAATATG.TTCGTGATG
CCGACGTCA.AATACTCCG	CCGACGTCA.AATACTCCG
CCGACGTCA.AATGCAGCG	CCGACGTCA.AATGCAGCG
CCGACGTCA.CACAATAAC	CCGACGTCA.CACAATAAC
CCGACGTCA.TACGAGTGA	CCGACGTCA.TACGAGTGA
CCGACGTCA.TTCGGAGTC	CCGACGTCA.TTCGGAGTC
CCGACTGTT.AGGATCTCA	CCGACTGTT.AGGATCTCA
CCGACTGTT.CTGTCTAGT	CCGACTGTT.CTGTCTAGT
CCGACTGTT.TAACCGTGA	CCGACTGTT.TAACCGTGA
CCGACTTGG.GAACATGAC	CCGACTTGG.GAACATGAC
CCGACTTGG.GTTGACCAT	CCGACTTGG.GTTGACCAT
CCGACTTGG.TGACGATGA	CCGACTTGG.TGACGATGA
CCGAGCTGA.TAGCCTTGT	CCGAGCTGA.TAGCCTTGT
CCGAGCTGA.TTCACCTTG	CCGAGCTGA.TTCACCTTG
CCGAGTACT.GTTGACGTG	CCGAGTACT.GTTGACGTG
CCGAGTACT.TGTTGTCGA	CCGAGTACT.TGTTGTCGA
CCGATACCG.CCGACTTGG	CCGATACCG.CCGACTTGG
CCGATACCG.CCGTAGTTG	CCGATACCG.CCGTAGTTG
CCGATACCG.CGGAGACTT	CCGATACCG.CGGAGACTT
CCGATACCG.GTAGCATAC	CCGATACCG.GTAGCATAC
CCGATACCG.TGCCAATGG	CCGATACCG.TGCCAATGG
CCGATCAGC.CAACACCTA	CCGATCAGC.CAACACCTA
CCGATCAGC.CCGTACGGA	CCGATCAGC.CCGTACGGA
CCGATCAGC.CGTGGTACC	CCGATCAGC.CGTGGTACC
CCGATCTCT.ATTGGTTCC	CCGATCTCT.ATTGGTTCC
CCGATCTCT.CTTAAGTTG	CCGATCTCT.CTTAAGTTG
CCGATGTTC.ACACAGAAC	CCGATGTTC.ACACAGAAC
CCGATGTTC.AGTTCGATA	CCGATGTTC.AGTTCGATA
CCGATGTTC.ATGATAGCT	CCGATGTTC.ATGATAGCT
CCGCAACAC.ACAATAGGT	CCGCAACAC.ACAATAGGT
CCGCAACAC.ACCATCTAA	CCGCAACAC.ACCATCTAA
CCGCAACAC.ATGGAGAGT	CCGCAACAC.ATGGAGAGT
CCGCAACAC.GAGCGACTC	CCGCAACAC.GAGCGACTC
CCGCAACAC.TTCTCCACA	CCGCAACAC.TTCTCCACA
CCGCAATGG.ACAGGTATC	CCGCAATGG.ACAGGTATC
CCGCAATGG.CACTTCCTT	CCGCAATGG.CACTTCCTT
CCGCAATGG.CCACTGAAG	CCGCAATGG.CCACTGAAG
CCGCAATGG.CTGCAAGCC	CCGCAATGG.CTGCAAGCC
CCGCAATGG.CTGTCTAGT	CCGCAATGG.CTGTCTAGT
CCGCAATGG.GCACTGGAT	CCGCAATGG.GCACTGGAT
CCGCACTCA.ACGCACACT	CCGCACTCA.ACGCACACT
CCGCACTCA.CAAGAGAGT	CCGCACTCA.CAAGAGAGT
CCGCACTCA.CAGTATGAT	CCGCACTCA.CAGTATGAT
CCGCACTCA.CCATATCTT	CCGCACTCA.CCATATCTT
CCGCACTCA.GCTTACGTT	CCGCACTCA.GCTTACGTT
CCGCACTCA.TCGAATAGA	CCGCACTCA.TCGAATAGA
CCGCAGAAT.AGGATGCGT	CCGCAGAAT.AGGATGCGT
CCGCAGAAT.CCTCCAATC	CCGCAGAAT.CCTCCAATC
CCGCAGAAT.GATCCGCAC	CCGCAGAAT.GATCCGCAC
CCGCAGAAT.TATCGAGCC	CCGCAGAAT.TATCGAGCC
CCGCAGCTA.ACGTACTGC	CCGCAGCTA.ACGTACTGC
CCGCAGCTA.AGGTCACGT	CCGCAGCTA.AGGTCACGT
CCGCAGCTA.GCAGGAGAA	CCGCAGCTA.GCAGGAGAA
CCGCAGCTA.TCTGCAACA	CCGCAGCTA.TCTGCAACA
CCGCATCCT.CACATTCTG	CCGCATCCT.CACATTCTG
CCGCTATCC.ATTGGTTCC	CCGCTATCC.ATTGGTTCC
CCGCTATCC.CAATGCATT	CCGCTATCC.CAATGCATT
CCGCTATCC.TAACCGTGA	CCGCTATCC.TAACCGTGA
CCGCTATCC.TGCCAGACG	CCGCTATCC.TGCCAGACG
CCGCTCATG.ACTTGATCT	CCGCTCATG.ACTTGATCT
CCGCTCATG.ATGCGCTAC	CCGCTCATG.ATGCGCTAC
CCGCTCATG.ATGTGACGA	CCGCTCATG.ATGTGACGA
CCGCTCATG.CCTTAACAT	CCGCTCATG.CCTTAACAT
CCGCTCATG.CTTGATCTA	CCGCTCATG.CTTGATCTA
CCGCTCATG.GCCACGAGT	CCGCTCATG.GCCACGAGT
CCGGATTGC.ACTCCGGTT	CCGGATTGC.ACTCCGGTT
CCGGATTGC.CAACGCACA	CCGGATTGC.CAACGCACA
CCGGATTGC.CACAACCAG	CCGGATTGC.CACAACCAG
CCGGATTGC.CTATGGATG	CCGGATTGC.CTATGGATG
CCGGATTGC.GGTGTTCAT	CCGGATTGC.GGTGTTCAT
CCGGTGGTT.ACTCTCACA	CCGGTGGTT.ACTCTCACA
CCGGTGGTT.GCTGGTTCG	CCGGTGGTT.GCTGGTTCG
CCGGTTCTA.CAACGCACA	CCGGTTCTA.CAACGCACA
CCGGTTCTA.TGGAAGATT	CCGGTTCTA.TGGAAGATT
CCGGTTGAG.CTCTGTCAA	CCGGTTGAG.CTCTGTCAA
CCGGTTGAG.TTCGCTGAG	CCGGTTGAG.TTCGCTGAG
CCGTACGGA.AATGCGTGC	CCGTACGGA.AATGCGTGC
CCGTACGGA.ACGACGATT	CCGTACGGA.ACGACGATT
CCGTACGGA.AGAGGTGAA	CCGTACGGA.AGAGGTGAA
CCGTACGGA.AGTGAACGG	CCGTACGGA.AGTGAACGG
CCGTACGGA.CAACCGGTC	CCGTACGGA.CAACCGGTC
CCGTACGGA.CAGTAATGT	CCGTACGGA.CAGTAATGT
CCGTAGTTG.ACTTGATCT	CCGTAGTTG.ACTTGATCT
CCGTAGTTG.CCGTCCACT	CCGTAGTTG.CCGTCCACT
CCGTAGTTG.CTCAGCTGG	CCGTAGTTG.CTCAGCTGG
CCGTAGTTG.GGTGTTCAT	CCGTAGTTG.GGTGTTCAT
CCGTAGTTG.TCAGGACTG	CCGTAGTTG.TCAGGACTG
CCGTCAGGT.ATACAACCG	CCGTCAGGT.ATACAACCG
CCGTCAGGT.GAATTGTTG	CCGTCAGGT.GAATTGTTG
CCGTCAGGT.TGGTAGCAG	CCGTCAGGT.TGGTAGCAG
CCGTCAGGT.TTGCTCTGC	CCGTCAGGT.TTGCTCTGC
CCGTCCACT.ACTACTCAT	CCGTCCACT.ACTACTCAT
CCGTCCACT.ATAGCTTGC	CCGTCCACT.ATAGCTTGC
CCGTTAGAC.ACTATCCTG	CCGTTAGAC.ACTATCCTG
CCGTTAGAC.CACTCACTA	CCGTTAGAC.CACTCACTA
CCGTTAGAC.CAGTATGAT	CCGTTAGAC.CAGTATGAT
CCGTTAGAC.GATTAGACA	CCGTTAGAC.GATTAGACA
CCGTTAGAC.TAGCAGAGT	CCGTTAGAC.TAGCAGAGT
CCGTTAGAC.TCTACGCAA	CCGTTAGAC.TCTACGCAA
CCGTTCCAA.AGATACGTT	CCGTTCCAA.AGATACGTT
CCGTTCCAA.AGTCGCGAC	CCGTTCCAA.AGTCGCGAC
CCGTTCCAA.CACATGTGC	CCGTTCCAA.CACATGTGC
CCGTTCCAA.GGTTGCTAT	CCGTTCCAA.GGTTGCTAT
CCGTTCCAA.TAACCGTGA	CCGTTCCAA.TAACCGTGA
CCTAAGAAG.ACTCCGTCG	CCTAAGAAG.ACTCCGTCG
CCTAAGAAG.GTACGTCTA	CCTAAGAAG.GTACGTCTA
CCTAAGAAG.GTAGAGAGC	CCTAAGAAG.GTAGAGAGC
CCTAAGAAG.GTCTCTTCA	CCTAAGAAG.GTCTCTTCA
CCTAAGAAG.TAGCTGTTG	CCTAAGAAG.TAGCTGTTG
CCTAAGTCT.ACCATTCAC	CCTAAGTCT.ACCATTCAC
CCTAAGTCT.ATTGCCGAC	CCTAAGTCT.ATTGCCGAC
CCTAAGTCT.CCACTTCGC	CCTAAGTCT.CCACTTCGC
CCTAAGTCT.CGGTTGCGA	CCTAAGTCT.CGGTTGCGA
CCTAAGTCT.TACTTACCA	CCTAAGTCT.TACTTACCA
CCTACTAGA.AGTCGATCA	CCTACTAGA.AGTCGATCA
CCTACTAGA.CCACCATGC	CCTACTAGA.CCACCATGC
CCTACTAGA.GCCATCGCT	CCTACTAGA.GCCATCGCT
CCTACTAGA.GCGTGAGCT	CCTACTAGA.GCGTGAGCT
CCTACTAGA.TCGCGTCAT	CCTACTAGA.TCGCGTCAT
CCTACTAGA.TCTACAGTT	CCTACTAGA.TCTACAGTT
CCTAGAGTA.CTCGACTGC	CCTAGAGTA.CTCGACTGC
CCTAGCAAT.ATCAGGATG	CCTAGCAAT.ATCAGGATG
CCTAGCAAT.CATGGTCGA	CCTAGCAAT.CATGGTCGA
CCTAGCAAT.CCGCATCCT	CCTAGCAAT.CCGCATCCT
CCTAGCAAT.GAAGTGTGA	CCTAGCAAT.GAAGTGTGA
CCTAGTCTC.CCGGTGGTT	CCTAGTCTC.CCGGTGGTT
CCTAGTCTC.CGACCACTT	CCTAGTCTC.CGACCACTT
CCTAGTCTC.CTAGTTCCA	CCTAGTCTC.CTAGTTCCA
CCTAGTCTC.GGTTCGCAA	CCTAGTCTC.GGTTCGCAA
CCTAGTCTC.TATTCAACG	CCTAGTCTC.TATTCAACG
CCTAGTTAG.CATCAATAG	CCTAGTTAG.CATCAATAG
CCTAGTTAG.CATTGTTCA	CCTAGTTAG.CATTGTTCA
CCTAGTTAG.GGTCTCATG	CCTAGTTAG.GGTCTCATG
CCTATTCAA.AGCAAGTCC	CCTATTCAA.AGCAAGTCC
CCTATTCAA.AGTCGCGAC	CCTATTCAA.AGTCGCGAC
CCTATTCAA.CCACAAGGT	CCTATTCAA.CCACAAGGT
CCTATTCAA.CCGATGTTC	CCTATTCAA.CCGATGTTC
CCTATTCAA.CTTAGGACT	CCTATTCAA.CTTAGGACT
CCTATTCAA.CTTCTGAGT	CCTATTCAA.CTTCTGAGT
CCTATTCAA.GTATCCTGC	CCTATTCAA.GTATCCTGC
CCTATTGGT.GTGAACCAC	CCTATTGGT.GTGAACCAC
CCTCAGGTG.ACCGACGGT	CCTCAGGTG.ACCGACGGT
CCTCAGGTG.CCTTAACAT	CCTCAGGTG.CCTTAACAT
CCTCATAAC.ACCACGGAT	CCTCATAAC.ACCACGGAT
CCTCATAAC.TAAGTGTAG	CCTCATAAC.TAAGTGTAG
CCTCCAATC.GCACATGTT	CCTCCAATC.GCACATGTT
CCTCCAATC.GCTCAATGA	CCTCCAATC.GCTCAATGA
CCTCCAATC.TCGTGACGT	CCTCCAATC.TCGTGACGT
CCTCCAATC.TGTCTACAC	CCTCCAATC.TGTCTACAC
CCTCCTTGT.CAAGAACCG	CCTCCTTGT.CAAGAACCG
CCTCCTTGT.CCGGTTCTA	CCTCCTTGT.CCGGTTCTA
CCTCCTTGT.GATGCGACG	CCTCCTTGT.GATGCGACG
CCTCCTTGT.GGATCAATG	CCTCCTTGT.GGATCAATG
CCTCCTTGT.TACAGTTAG	CCTCCTTGT.TACAGTTAG
CCTCGACCT.GATCTAGAG	CCTCGACCT.GATCTAGAG
CCTCGACCT.GGTGAGTTC	CCTCGACCT.GGTGAGTTC
CCTCGACCT.GGTTCGCAA	CCTCGACCT.GGTTCGCAA
CCTCGAGAG.CAACTAATC	CCTCGAGAG.CAACTAATC
CCTCGAGAG.GACGTCAAT	CCTCGAGAG.GACGTCAAT
CCTCGAGAG.TGAGTGACT	CCTCGAGAG.TGAGTGACT
CCTCGCGTT.AGACGCTAT	CCTCGCGTT.AGACGCTAT
CCTCGCGTT.CACGTAGAC	CCTCGCGTT.CACGTAGAC
CCTCGCGTT.CAGCGACGT	CCTCGCGTT.CAGCGACGT
CCTCGCGTT.CTGAGTAGC	CCTCGCGTT.CTGAGTAGC
CCTCGCGTT.GATCGTTGA	CCTCGCGTT.GATCGTTGA
CCTCGCGTT.GTCGTGTTA	CCTCGCGTT.GTCGTGTTA
CCTCGCGTT.TCAATGGAC	CCTCGCGTT.TCAATGGAC
CCTCGCGTT.TCCGATAAC	CCTCGCGTT.TCCGATAAC
