AACAACCTA.AGTCATACT	AACAACCTA.AGTCATACT
AACACACTC.AGTGATGCG	AACACACTC.AGTGATGCG
AACACACTC.GATCGCGAA	AACACACTC.GATCGCGAA
AACAGATCG.CATGACGTT	AACAGATCG.CATGACGTT
AACCGCTGA.GATCCGCAC	AACCGCTGA.GATCCGCAC
AACCGTGAG.ACCGGAAGG	AACCGTGAG.ACCGGAAGG
AACGAGAAT.ATACCGCTT	AACGAGAAT.ATACCGCTT
AACGAGGTG.AATGCAGCG	AACGAGGTG.AATGCAGCG
AACGCATTG.TAGCCTTGT	AACGCATTG.TAGCCTTGT
AACGCCTAC.CTGAGTCCA	AACGCCTAC.CTGAGTCCA
AACGCCTAC.TGATTCACC	AACGCCTAC.TGATTCACC
AACGCTCAA.ACAGAAGAG	AACGCTCAA.ACAGAAGAG
AACGCTCAA.GCTGGTTCG	AACGCTCAA.GCTGGTTCG
AACGCTCAA.TCCACCTCA	AACGCTCAA.TCCACCTCA
AACGGAGAT.TGTGTAGAG	AACGGAGAT.TGTGTAGAG
AACGGTAGC.TTCCTAAGG	AACGGTAGC.TTCCTAAGG
AACGTCGAG.CATTCAGTT	AACGTCGAG.CATTCAGTT
AACGTCGAG.GACTATTGA	AACGTCGAG.GACTATTGA
AACGTCGAG.TAGCACTAT	AACGTCGAG.TAGCACTAT
AACGTTCTT.CCAGGAGTT	AACGTTCTT.CCAGGAGTT
AACTAACTG.GCGACAACC	AACTAACTG.GCGACAACC
AACTGATTC.CCACGTTCT	AACTGATTC.CCACGTTCT
AACTTAGCT.CATCTCGAT	AACTTAGCT.CATCTCGAT
AACTTGTCG.GGTGTTCAT	AACTTGTCG.GGTGTTCAT
AAGACGAAG.CAATGTGCT	AAGACGAAG.CAATGTGCT
AAGACGAAG.GCTACCTTA	AAGACGAAG.GCTACCTTA
AAGCAACTA.TCACCGAGG	AAGCAACTA.TCACCGAGG
AAGCAACTA.TGTGAGTAT	AAGCAACTA.TGTGAGTAT
AAGCAATCG.GTGTACCGT	AAGCAATCG.GTGTACCGT
AAGCAGCAT.CTACGTTGG	AAGCAGCAT.CTACGTTGG
AAGCTGAGG.ACAGCATCA	AAGCTGAGG.ACAGCATCA
AAGCTGAGG.GCCACGAGT	AAGCTGAGG.GCCACGAGT
AAGCTGAGG.TACGACTTG	AAGCTGAGG.TACGACTTG
AAGCTGGTC.CAAGAGAGT	AAGCTGGTC.CAAGAGAGT
AAGCTGGTC.GGTAGACAT	AAGCTGGTC.GGTAGACAT
AAGCTGGTC.TGGACTGCC	AAGCTGGTC.TGGACTGCC
AAGGATACG.TTACTTACG	AAGGATACG.TTACTTACG
AAGGATCGT.CCTTATCCG	AAGGATCGT.CCTTATCCG
AAGGTGCTG.TGGAATCGT	AAGGTGCTG.TGGAATCGT
AAGTAGGAC.TCCTCTAGT	AAGTAGGAC.TCCTCTAGT
AAGTTCTCT.CCGTAGTTG	AAGTTCTCT.CCGTAGTTG
AAGTTCTCT.GTCACAGAG	AAGTTCTCT.GTCACAGAG
AAGTTGCCA.CCACACAGA	AAGTTGCCA.CCACACAGA
AATAACTCC.CTAATACGC	AATAACTCC.CTAATACGC
AATAACTCC.GAGACTCGA	AATAACTCC.GAGACTCGA
AATACGTCT.GCGAACTCG	AATACGTCT.GCGAACTCG
AATACGTCT.GGACTCCTT	AATACGTCT.GGACTCCTT
AATACGTCT.TGAGACAGC	AATACGTCT.TGAGACAGC
AATACTCCG.ACCACGGAT	AATACTCCG.ACCACGGAT
AATACTCCG.CACTGGTCC	AATACTCCG.CACTGGTCC
AATAGACGC.GTCAGTTGT	AATAGACGC.GTCAGTTGT
AATATCAGC.ACAGCGGTC	AATATCAGC.ACAGCGGTC
AATATCAGC.CAACTAATC	AATATCAGC.CAACTAATC
AATATCAGC.CCACTACCA	AATATCAGC.CCACTACCA
AATATCGCT.AATACCTTG	AATATCGCT.AATACCTTG
AATCCTCGT.CAGCTGGAG	AATCCTCGT.CAGCTGGAG
AATCCTCGT.TCAGGTGCA	AATCCTCGT.TCAGGTGCA
AATCGCCAT.TCACTCGCT	AATCGCCAT.TCACTCGCT
AATCTCCTA.CCACGCCAT	AATCTCCTA.CCACGCCAT
AATGAGTCG.TGGACGAGA	AATGAGTCG.TGGACGAGA
AATGCAGCG.GCGATGGTG	AATGCAGCG.GCGATGGTG
AATGCAGCG.TGCGATACT	AATGCAGCG.TGCGATACT
AATGCGTGC.AACGATGAC	AATGCGTGC.AACGATGAC
AATGCGTGC.TCGTAATAG	AATGCGTGC.TCGTAATAG
AATGCTGAT.CACACCTGT	AATGCTGAT.CACACCTGT
AATGTGCGT.ATGCGTGGA	AATGTGCGT.ATGCGTGGA
AATGTGCGT.GAGGTGAGC	AATGTGCGT.GAGGTGAGC
AATGTGCGT.TAGAGCGTC	AATGTGCGT.TAGAGCGTC
AATTAGAGG.ACTCTCACA	AATTAGAGG.ACTCTCACA
AATTCGGAA.CCGATGTTC	AATTCGGAA.CCGATGTTC
AATTGGATC.CTAACCGGT	AATTGGATC.CTAACCGGT
AATTGGTGA.TCATCAGAG	AATTGGTGA.TCATCAGAG
ACAAGGTAC.CAATACCAC	ACAAGGTAC.CAATACCAC
ACAATTCGG.TCAAGGTCG	ACAATTCGG.TCAAGGTCG
ACACACCGT.AGAGGTGAA	ACACACCGT.AGAGGTGAA
ACACACCGT.ATGCGCCGT	ACACACCGT.ATGCGCCGT
ACACAGAAC.CAGTGAGGA	ACACAGAAC.CAGTGAGGA
ACACATCTG.GAGTATCGC	ACACATCTG.GAGTATCGC
ACACATCTG.GATGTTACA	ACACATCTG.GATGTTACA
ACACCGCCA.CACATGTGC	ACACCGCCA.CACATGTGC
ACACCGCCA.TGATAGAGG	ACACCGCCA.TGATAGAGG
ACACGTTGC.CAACCGGTC	ACACGTTGC.CAACCGGTC
ACACTAACG.TCGCATTCG	ACACTAACG.TCGCATTCG
ACAGAAGAG.TTGCAGTCA	ACAGAAGAG.TTGCAGTCA
ACAGAGATG.ATGCGCTAC	ACAGAGATG.ATGCGCTAC
ACAGAGATG.GTCTGACGT	ACAGAGATG.GTCTGACGT
ACAGCGGTC.CTCCACGTC	ACAGCGGTC.CTCCACGTC
ACAGCGGTC.GCACAGTAA	ACAGCGGTC.GCACAGTAA
ACAGGAACT.CCACAAGGT	ACAGGAACT.CCACAAGGT
ACAGGTATC.CAACGTCTT	ACAGGTATC.CAACGTCTT
ACATCGTCC.CCGAGTACT	ACATCGTCC.CCGAGTACT
ACATGACTA.CGTGTGTGG	ACATGACTA.CGTGTGTGG
ACATTCCAC.ACACACCGT	ACATTCCAC.ACACACCGT
ACCACGCTA.ACCGGAAGG	ACCACGCTA.ACCGGAAGG
ACCACGCTA.TTACACCTT	ACCACGCTA.TTACACCTT
ACCACTAGG.GACACCGAT	ACCACTAGG.GACACCGAT
ACCAGCGTT.CCACCATGC	ACCAGCGTT.CCACCATGC
ACCAGCGTT.CCGTCCACT	ACCAGCGTT.CCGTCCACT
ACCATACTT.CAACTCCAG	ACCATACTT.CAACTCCAG
ACCATCTAA.CCATACGAT	ACCATCTAA.CCATACGAT
ACCATTCAC.GATCGATAC	ACCATTCAC.GATCGATAC
ACCATTCAC.GTCGTTGCG	ACCATTCAC.GTCGTTGCG
ACCATTCAC.TCTGCGCTG	ACCATTCAC.TCTGCGCTG
ACCGAGACA.AGTTCAACC	ACCGAGACA.AGTTCAACC
ACCGCTGTG.TGGTCCTAG	ACCGCTGTG.TGGTCCTAG
ACCGCTGTG.TTATCGCAC	ACCGCTGTG.TTATCGCAC
ACCGCTGTG.TTGAGACGG	ACCGCTGTG.TTGAGACGG
ACCGGAAGG.CGATTGAAC	ACCGGAAGG.CGATTGAAC
ACCGTCACG.GAGTCCAAT	ACCGTCACG.GAGTCCAAT
ACCGTCACG.TCCATCATT	ACCGTCACG.TCCATCATT
ACCTCCTAG.CGGTGTTAC	ACCTCCTAG.CGGTGTTAC
ACGAATCGC.TCCGGAGCT	ACGAATCGC.TCCGGAGCT
ACGACAGTC.TACGACCAT	ACGACAGTC.TACGACCAT
ACGACATCT.GGTAGCATC	ACGACATCT.GGTAGCATC
ACGACATCT.TACCTCACT	ACGACATCT.TACCTCACT
ACGAGCTTC.ACCAGCGTT	ACGAGCTTC.ACCAGCGTT
ACGAGCTTC.GTAGCATAC	ACGAGCTTC.GTAGCATAC
ACGATGACC.CTGGTACAT	ACGATGACC.CTGGTACAT
ACGCAAGAT.ACTTGATCT	ACGCAAGAT.ACTTGATCT
ACGCACACT.GCGGAGATT	ACGCACACT.GCGGAGATT
ACGCACACT.GGAACCTAG	ACGCACACT.GGAACCTAG
ACGCGACAG.TCTGCAACA	ACGCGACAG.TCTGCAACA
ACGCTAGTG.GCAACTCGC	ACGCTAGTG.GCAACTCGC
ACGCTAGTG.GCGACCTGT	ACGCTAGTG.GCGACCTGT
ACGCTATGT.AGATCTTCA	ACGCTATGT.AGATCTTCA
ACGCTCTTA.CAACCTGGT	ACGCTCTTA.CAACCTGGT
ACGGACCAT.AATGCACTT	ACGGACCAT.AATGCACTT
ACGGACCAT.ATAAGTTCG	ACGGACCAT.ATAAGTTCG
ACGGACCAT.GTAACGCGA	ACGGACCAT.GTAACGCGA
ACGGTGCCT.ATAAGACAG	ACGGTGCCT.ATAAGACAG
ACGGTGTAC.TTCTGAATG	ACGGTGTAC.TTCTGAATG
ACGTAGTAT.ATCTACATC	ACGTAGTAT.ATCTACATC
ACGTAGTAT.GATAAGCTG	ACGTAGTAT.GATAAGCTG
ACGTAGTAT.TAATCTGGA	ACGTAGTAT.TAATCTGGA
ACGTGCTCG.GCAGCTTGA	ACGTGCTCG.GCAGCTTGA
ACGTGTAGT.TAACACATC	ACGTGTAGT.TAACACATC
ACGTTCAAT.GACGCCGTA	ACGTTCAAT.GACGCCGTA
ACTAACCGA.TCGGAACGA	ACTAACCGA.TCGGAACGA
ACTATTGTC.ACAGCGTAT	ACTATTGTC.ACAGCGTAT
ACTCATTCA.GTAGGACGC	ACTCATTCA.GTAGGACGC
ACTCCGGTT.GTAATCAGC	ACTCCGGTT.GTAATCAGC
ACTCGAGTC.CTCAGTGAT	ACTCGAGTC.CTCAGTGAT
ACTCGCTGT.AGTCTAAGC	ACTCGCTGT.AGTCTAAGC
ACTCTCACA.CATCTCACG	ACTCTCACA.CATCTCACG
ACTCTGCTC.GTAAGTGAG	ACTCTGCTC.GTAAGTGAG
ACTGCTAGT.ATATCAGCC	ACTGCTAGT.ATATCAGCC
ACTGCTAGT.CGTGAGACT	ACTGCTAGT.CGTGAGACT
ACTGCTAGT.CTCGTCTTG	ACTGCTAGT.CTCGTCTTG
ACTGCTAGT.CTTGTAACG	ACTGCTAGT.CTTGTAACG
ACTGGACCA.ACGTAGTAT	ACTGGACCA.ACGTAGTAT
ACTGGACCA.AGACCAGCT	ACTGGACCA.AGACCAGCT
ACTGGACCA.GTGGTTACC	ACTGGACCA.GTGGTTACC
ACTGGACCA.TTCGCATCC	ACTGGACCA.TTCGCATCC
ACTGGTGCT.TGGAACTAA	ACTGGTGCT.TGGAACTAA
ACTGTAATC.ACTTCTTGG	ACTGTAATC.ACTTCTTGG
ACTGTAATC.GCTTACTAG	ACTGTAATC.GCTTACTAG
ACTGTGTCA.ATGCTCACC	ACTGTGTCA.ATGCTCACC
ACTTAGCTT.TTCTCCACA	ACTTAGCTT.TTCTCCACA
ACTTCGCAG.GTAATATCG	ACTTCGCAG.GTAATATCG
ACTTCTAAC.AGCGTAGAA	ACTTCTAAC.AGCGTAGAA
ACTTCTAAC.CTCCGCATT	ACTTCTAAC.CTCCGCATT
ACTTCTAAC.TCGCTGTAA	ACTTCTAAC.TCGCTGTAA
AGAAGAGTC.ACGATGACC	AGAAGAGTC.ACGATGACC
AGAAGTAAC.CGACGTGAT	AGAAGTAAC.CGACGTGAT
AGAAGTAAC.TCGTAATAG	AGAAGTAAC.TCGTAATAG
AGACATATC.CCACTTCGC	AGACATATC.CCACTTCGC
AGACATATC.TACTGATGA	AGACATATC.TACTGATGA
AGACATCCA.CTCGTCTTG	AGACATCCA.CTCGTCTTG
AGACCAGCT.GCGAAGACA	AGACCAGCT.GCGAAGACA
AGACTTCGT.TAGGAGGAT	AGACTTCGT.TAGGAGGAT
AGAGGACGT.CCGTCAGGT	AGAGGACGT.CCGTCAGGT
AGAGGACGT.GCTTACTAG	AGAGGACGT.GCTTACTAG
AGAGGTGAA.AGTGTTCTG	AGAGGTGAA.AGTGTTCTG
AGAGGTGAA.TCTCAGGAT	AGAGGTGAA.TCTCAGGAT
AGATATGGA.CAGTGCCAT	AGATATGGA.CAGTGCCAT
AGATATGGA.TGAGAGGAC	AGATATGGA.TGAGAGGAC
AGATCTGAC.AACGCCTAC	AGATCTGAC.AACGCCTAC
AGATCTGAC.GTATGATCT	AGATCTGAC.GTATGATCT
AGATCTTCA.ATAGTCAGT	AGATCTTCA.ATAGTCAGT
AGATGAAGA.ATGAGATCC	AGATGAAGA.ATGAGATCC
AGATGAAGA.CAAGAGGAG	AGATGAAGA.CAAGAGGAG
AGATGAAGA.GCTTGTCCT	AGATGAAGA.GCTTGTCCT
AGATGAAGA.TGATTATCG	AGATGAAGA.TGATTATCG
AGATGAGAT.CTGGTACAT	AGATGAGAT.CTGGTACAT
AGATGAGAT.TCGAATAGA	AGATGAGAT.TCGAATAGA
AGATGAGAT.TCGGACAGT	AGATGAGAT.TCGGACAGT
AGCAAGTCC.AGGTACCAA	AGCAAGTCC.AGGTACCAA
AGCACACCT.TGCCGAACT	AGCACACCT.TGCCGAACT
AGCAGACAA.TGTATGTAG	AGCAGACAA.TGTATGTAG
AGCATATGG.CCTTAATTC	AGCATATGG.CCTTAATTC
AGCATTCCA.ACACATCTG	AGCATTCCA.ACACATCTG
AGCCAGGAC.GTGAACCAC	AGCCAGGAC.GTGAACCAC
AGCCGTTCT.TGATAGAGG	AGCCGTTCT.TGATAGAGG
AGCCTCGCA.ACGTGTAGT	AGCCTCGCA.ACGTGTAGT
AGCGCATGA.TCAAGCGTA	AGCGCATGA.TCAAGCGTA
AGCGGAACA.TCGCTGTAA	AGCGGAACA.TCGCTGTAA
AGCGGAACA.TGGAGTGGA	AGCGGAACA.TGGAGTGGA
AGCGGAACA.TGTAGGTTA	AGCGGAACA.TGTAGGTTA
AGCGGTAAG.GAGTCAAGG	AGCGGTAAG.GAGTCAAGG
AGCGGTCTA.GCCAACAAT	AGCGGTCTA.GCCAACAAT
AGCTACTCA.ACAACCGGA	AGCTACTCA.ACAACCGGA
AGCTACTCA.CACCTCAAC	AGCTACTCA.CACCTCAAC
AGCTACTCA.TCGTCCGAT	AGCTACTCA.TCGTCCGAT
AGCTATATG.ACTAAGTTC	AGCTATATG.ACTAAGTTC
AGCTATATG.TATTACTCG	AGCTATATG.TATTACTCG
AGCTTCGAT.CCTTCGAGC	AGCTTCGAT.CCTTCGAGC
AGCTTGGTG.TAGGAGGAT	AGCTTGGTG.TAGGAGGAT
AGGAATTGG.CAGTCCTAA	AGGAATTGG.CAGTCCTAA
AGGATCATG.CAGATCGAC	AGGATCATG.CAGATCGAC
AGGATCTCA.CGTCTGCTG	AGGATCTCA.CGTCTGCTG
AGGATTACT.CGTTCGTAC	AGGATTACT.CGTTCGTAC
AGGATTGAG.GTAGCCTTG	AGGATTGAG.GTAGCCTTG
AGGTACCAA.GAGGTGAGC	AGGTACCAA.GAGGTGAGC
AGGTACCAA.GGTCTCATG	AGGTACCAA.GGTCTCATG
AGGTATTCC.CGACGTGAT	AGGTATTCC.CGACGTGAT
AGGTCAGCA.ATCTGCGTA	AGGTCAGCA.ATCTGCGTA
AGGTCAGCA.GACTATTGA	AGGTCAGCA.GACTATTGA
AGGTCCGTC.AGTGTTCTG	AGGTCCGTC.AGTGTTCTG
AGGTGCGAG.TAGAGACTA	AGGTGCGAG.TAGAGACTA
AGGTGTACA.AATTCGGAA	AGGTGTACA.AATTCGGAA
AGGTGTACA.GGATAGTCA	AGGTGTACA.GGATAGTCA
AGTAAGCCA.CATGTCCTG	AGTAAGCCA.CATGTCCTG
AGTAAGCCA.GTGTACCGT	AGTAAGCCA.GTGTACCGT
AGTAATCAG.TATAGTGCG	AGTAATCAG.TATAGTGCG
AGTAATGGT.TGTTAAGCC	AGTAATGGT.TGTTAAGCC
AGTACGAAT.GTGTCCGTG	AGTACGAAT.GTGTCCGTG
AGTACTCTC.CTCGTCTTG	AGTACTCTC.CTCGTCTTG
AGTACTCTC.TATTGCTAC	AGTACTCTC.TATTGCTAC
AGTAGAGGA.CCACCATGC	AGTAGAGGA.CCACCATGC
AGTCAGTTG.AGCCACTTC	AGTCAGTTG.AGCCACTTC
AGTCAGTTG.CTGAGTCCA	AGTCAGTTG.CTGAGTCCA
AGTCCAGTG.ACAGGTATC	AGTCCAGTG.ACAGGTATC
AGTCGATCA.AGTACGAAT	AGTCGATCA.AGTACGAAT
AGTCGATCA.CAATCTCCG	AGTCGATCA.CAATCTCCG
AGTCGCGAC.AGTGACGAT	AGTCGCGAC.AGTGACGAT
AGTCGCGAC.GCTACCTTA	AGTCGCGAC.GCTACCTTA
AGTCGCGAC.GTCCGTAAG	AGTCGCGAC.GTCCGTAAG
AGTCGTCCG.CTGTCTAGT	AGTCGTCCG.CTGTCTAGT
AGTCTGGAA.ATAGCTTGC	AGTCTGGAA.ATAGCTTGC
AGTCTGGAA.CGAGCTTAC	AGTCTGGAA.CGAGCTTAC
AGTGACGAT.CCGCAGCTA	AGTGACGAT.CCGCAGCTA
AGTGAGAGA.GCTTCTACG	AGTGAGAGA.GCTTCTACG
AGTGATGCG.GGAAGAAGC	AGTGATGCG.GGAAGAAGC
AGTGGAATG.ACATGACTA	AGTGGAATG.ACATGACTA
AGTGGAATG.GAGATACAC	AGTGGAATG.GAGATACAC
AGTGGAATG.TTGGACTTC	AGTGGAATG.TTGGACTTC
AGTGTGCAC.AATCCTCGT	AGTGTGCAC.AATCCTCGT
AGTGTGCAC.GTTGCATGG	AGTGTGCAC.GTTGCATGG
AGTGTTCTG.ACACCACAT	AGTGTTCTG.ACACCACAT
AGTGTTCTG.TTGATGCTG	AGTGTTCTG.TTGATGCTG
AGTTATCGC.TGCTGCGTC	AGTTATCGC.TGCTGCGTC
AGTTCAACC.CGCGAGTGT	AGTTCAACC.CGCGAGTGT
AGTTGCCTT.AGTTGAGCG	AGTTGCCTT.AGTTGAGCG
ATAAGACAG.GCAACCAAC	ATAAGACAG.GCAACCAAC
ATAAGTTCG.CTCTACGCA	ATAAGTTCG.CTCTACGCA
ATAATGTGG.ACAGCGGTC	ATAATGTGG.ACAGCGGTC
ATACAACCG.CAGGATCAA	ATACAACCG.CAGGATCAA
ATACCGAAG.GACTCAGTG	ATACCGAAG.GACTCAGTG
ATACCGAAG.GTCATTCTA	ATACCGAAG.GTCATTCTA
ATACCGCTT.CTGACGGAT	ATACCGCTT.CTGACGGAT
ATACCGCTT.GAGGTCACG	ATACCGCTT.GAGGTCACG
ATACCGCTT.TATGACCGA	ATACCGCTT.TATGACCGA
ATACGAGGT.GCCTGGAAT	ATACGAGGT.GCCTGGAAT
ATACGAGGT.TCATGCAGG	ATACGAGGT.TCATGCAGG
ATAGACCGA.GAGTGCATA	ATAGACCGA.GAGTGCATA
ATAGAGCAG.ATAAGTTCG	ATAGAGCAG.ATAAGTTCG
ATAGCACGG.CCACTGAAG	ATAGCACGG.CCACTGAAG
ATAGCCTAA.ACTCGCTGT	ATAGCCTAA.ACTCGCTGT
ATAGCCTAA.TAGCCAGTG	ATAGCCTAA.TAGCCAGTG
ATAGCTTGC.CTCGTTCAC	ATAGCTTGC.CTCGTTCAC
ATAGTGGTT.AGGATTGAG	ATAGTGGTT.AGGATTGAG
ATATCAGCC.TTACCTCTC	ATATCAGCC.TTACCTCTC
ATATCCGAT.TGGAATCGT	ATATCCGAT.TGGAATCGT
ATATGCAGC.GGAACTGCT	ATATGCAGC.GGAACTGCT
ATATGTCCA.ACACACCGT	ATATGTCCA.ACACACCGT
ATATGTCCA.ACTGTGTCA	ATATGTCCA.ACTGTGTCA
ATATGTCCA.GCAGCGATA	ATATGTCCA.GCAGCGATA
ATATTCGCA.ATGCAGTTC	ATATTCGCA.ATGCAGTTC
ATATTCGCA.GACACCGAT	ATATTCGCA.GACACCGAT
ATCAAGAGA.CATACGCAG	ATCAAGAGA.CATACGCAG
ATCAAGAGA.CGTTGATCC	ATCAAGAGA.CGTTGATCC
ATCAAGAGA.CTCCACGTC	ATCAAGAGA.CTCCACGTC
ATCAAGCAT.TCCAAGTAA	ATCAAGCAT.TCCAAGTAA
ATCACTTCC.CGTCGTCAA	ATCACTTCC.CGTCGTCAA
ATCACTTCC.TCTCGATGC	ATCACTTCC.TCTCGATGC
ATCAGAAGC.TGCTCCTCC	ATCAGAAGC.TGCTCCTCC
ATCAGTCGA.TGCTATGAA	ATCAGTCGA.TGCTATGAA
ATCATAGAC.GTGAATGCC	ATCATAGAC.GTGAATGCC
ATCATGTTC.TCCAATCAT	ATCATGTTC.TCCAATCAT
ATCATTACG.GCGTATAGG	ATCATTACG.GCGTATAGG
ATCCAATGA.TCTCAGGAT	ATCCAATGA.TCTCAGGAT
ATCCACAGT.CGAGCCGTT	ATCCACAGT.CGAGCCGTT
ATCCACAGT.TCACATACT	ATCCACAGT.TCACATACT
ATCCAGCTG.CTGGACTAA	ATCCAGCTG.CTGGACTAA
ATCCAGCTG.TTCTGAATG	ATCCAGCTG.TTCTGAATG
ATCCATTAG.ATACGAGGT	ATCCATTAG.ATACGAGGT
ATCCGACCA.CCACTTCGC	ATCCGACCA.CCACTTCGC
ATCCGGTCC.AATTAGAGG	ATCCGGTCC.AATTAGAGG
ATCCGGTCC.ATAAGACAG	ATCCGGTCC.ATAAGACAG
ATCCGTCTC.GCGCTTCTC	ATCCGTCTC.GCGCTTCTC
ATCCGTCTC.GTGGATAAG	ATCCGTCTC.GTGGATAAG
ATCCTCCGA.CGCTTGTAG	ATCCTCCGA.CGCTTGTAG
ATCCTCCGA.TAGGATTAG	ATCCTCCGA.TAGGATTAG
ATCCTGCCT.GCACGCATT	ATCCTGCCT.GCACGCATT
ATCCTGCCT.TCACACTGC	ATCCTGCCT.TCACACTGC
ATCGAATCG.ATTAGCGGT	ATCGAATCG.ATTAGCGGT
ATCGCCTCT.TTATCCAAG	ATCGCCTCT.TTATCCAAG
ATCTAGGTT.GCATACATG	ATCTAGGTT.GCATACATG
ATCTCGAAC.CGCATAACT	ATCTCGAAC.CGCATAACT
ATCTCGAAC.GTCCTAGTT	ATCTCGAAC.GTCCTAGTT
ATCTCGTGA.CTTAACAGC	ATCTCGTGA.CTTAACAGC
ATCTCTGCT.TACTACTGT	ATCTCTGCT.TACTACTGT
ATCTGGTAG.AGCGGTAAG	ATCTGGTAG.AGCGGTAAG
ATCTGGTAG.CAAGAACCG	ATCTGGTAG.CAAGAACCG
ATCTGGTAG.GCTACAATG	ATCTGGTAG.GCTACAATG
ATCTGGTAG.TGGTGGATC	ATCTGGTAG.TGGTGGATC
ATGAACTAG.GCAACACCT	ATGAACTAG.GCAACACCT
ATGAACTAG.GTCGTTGCG	ATGAACTAG.GTCGTTGCG
ATGACACAA.GGACAGATT	ATGACACAA.GGACAGATT
ATGACACAA.TAGTTGACG	ATGACACAA.TAGTTGACG
ATGACACAA.TATGTATGC	ATGACACAA.TATGTATGC
ATGACACAA.TGCCACCGA	ATGACACAA.TGCCACCGA
ATGAGATCC.GAGCCATCC	ATGAGATCC.GAGCCATCC
ATGCGCCGT.CTGTACGAC	ATGCGCCGT.CTGTACGAC
ATGCGCTAC.ACAGCGGTC	ATGCGCTAC.ACAGCGGTC
ATGCGGATT.CTCGCAAGA	ATGCGGATT.CTCGCAAGA
ATGCGTGGA.ACGTATGTC	ATGCGTGGA.ACGTATGTC
ATGCTGTCG.GTTGCATGG	ATGCTGTCG.GTTGCATGG
ATGCTTCAG.AACGCATTG	ATGCTTCAG.AACGCATTG
ATGCTTCAG.TAGACCGCA	ATGCTTCAG.TAGACCGCA
ATGCTTCAG.TGTGCTAAC	ATGCTTCAG.TGTGCTAAC
ATGGACGTT.ACTCGAGTC	ATGGACGTT.ACTCGAGTC
ATGGAGAGT.GCAGCAGTG	ATGGAGAGT.GCAGCAGTG
ATGGAGAGT.TCTTAGCGA	ATGGAGAGT.TCTTAGCGA
ATGGAGGAA.GAGTCAAGG	ATGGAGGAA.GAGTCAAGG
ATGGAGGAA.TTGCGAACA	ATGGAGGAA.TTGCGAACA
ATGTCGCCT.CAGCTTCGA	ATGTCGCCT.CAGCTTCGA
ATGTGAGAC.CTGAGTCCA	ATGTGAGAC.CTGAGTCCA
ATTAAGACC.CCAAGTCGA	ATTAAGACC.CCAAGTCGA
ATTAGCACA.TGCCATCTC	ATTAGCACA.TGCCATCTC
ATTAGCCAC.TTAACGTTC	ATTAGCCAC.TTAACGTTC
ATTAGCGGT.CTAGAGGTA	ATTAGCGGT.CTAGAGGTA
ATTCATGTG.ATGACACAA	ATTCATGTG.ATGACACAA
ATTCATGTG.CCTAGTTAG	ATTCATGTG.CCTAGTTAG
ATTCATGTG.CTGTAGAAG	ATTCATGTG.CTGTAGAAG
ATTCCGTAC.CGGTTCTAT	ATTCCGTAC.CGGTTCTAT
ATTCGAAGA.TGCGTATCT	ATTCGAAGA.TGCGTATCT
ATTCGAAGA.TTCCTCGGT	ATTCGAAGA.TTCCTCGGT
ATTCGCTTA.GGTAAGGAT	ATTCGCTTA.GGTAAGGAT
ATTCTCTGG.ATGTCGCCT	ATTCTCTGG.ATGTCGCCT
ATTCTCTGG.TCGCTTAAC	ATTCTCTGG.TCGCTTAAC
ATTGACACG.TCGCCAAGC	ATTGACACG.TCGCCAAGC
ATTGCCGAC.AAGCATTGC	ATTGCCGAC.AAGCATTGC
ATTGCGCTA.CAAGAGAGT	ATTGCGCTA.CAAGAGAGT
ATTGCGCTA.CACTGGTCC	ATTGCGCTA.CACTGGTCC
ATTGGTTCC.AATAACTCC	ATTGGTTCC.AATAACTCC
ATTGGTTCC.ACCATTCAC	ATTGGTTCC.ACCATTCAC
ATTGGTTCC.AGTTCGATA	ATTGGTTCC.AGTTCGATA
ATTGGTTCC.CAGGATCAA	ATTGGTTCC.CAGGATCAA
ATTGGTTCC.CTGTGGTGG	ATTGGTTCC.CTGTGGTGG
CAACACCTA.GCGACACAG	CAACACCTA.GCGACACAG
CAACGTCTT.GTTGATGCA	CAACGTCTT.GTTGATGCA
CAACTCCAG.CCATGATGT	CAACTCCAG.CCATGATGT
CAAGCTGCA.GGATCAATG	CAAGCTGCA.GGATCAATG
CAAGGTGTG.CGAGCCGTT	CAAGGTGTG.CGAGCCGTT
CAAGGTGTG.GTACGCGAT	CAAGGTGTG.GTACGCGAT
CAAGTCGAA.CATTCCGAG	CAAGTCGAA.CATTCCGAG
CACAACGCT.TGAGTTAAG	CACAACGCT.TGAGTTAAG
CACAATAAC.GCGGACGAA	CACAATAAC.GCGGACGAA
CACATATCA.GAGTTATAG	CACATATCA.GAGTTATAG
CACATGTGC.CGACCATCA	CACATGTGC.CGACCATCA
CACATTCTG.ATACAACCG	CACATTCTG.ATACAACCG
CACCAGAAG.GTGCTAAGC	CACCAGAAG.GTGCTAAGC
CACCTACGC.GGTAGCATC	CACCTACGC.GGTAGCATC
CACCTAGCG.CCAGTTACG	CACCTAGCG.CCAGTTACG
CACCTCGGA.CACAACCAG	CACCTCGGA.CACAACCAG
CACGCGTAA.CAGTGCCAT	CACGCGTAA.CAGTGCCAT
CACGCGTAA.CATCTCGAT	CACGCGTAA.CATCTCGAT
CACGCGTAA.GATTAGACA	CACGCGTAA.GATTAGACA
CACGCGTAA.TCAAGGTCG	CACGCGTAA.TCAAGGTCG
CACGGAAGT.ACGTACTGC	CACGGAAGT.ACGTACTGC
CACTACAGG.ACTTCTTGG	CACTACAGG.ACTTCTTGG
CACTACAGG.CTCTTCAGC	CACTACAGG.CTCTTCAGC
CACTACAGG.GCGGTAGTC	CACTACAGG.GCGGTAGTC
CACTGCTTA.AACGGAGAT	CACTGCTTA.AACGGAGAT
CACTGCTTA.CAATCAAGT	CACTGCTTA.CAATCAAGT
CACTGCTTA.GTAAGTGAG	CACTGCTTA.GTAAGTGAG
CACTGTATC.ATGAGCAGG	CACTGTATC.ATGAGCAGG
CACTGTATC.TGGAGAACC	CACTGTATC.TGGAGAACC
CACTTCCTT.GACCGCTTC	CACTTCCTT.GACCGCTTC
CAGAAGTGA.TATCCTCAG	CAGAAGTGA.TATCCTCAG
CAGATCGAC.GAATCACAT	CAGATCGAC.GAATCACAT
CAGATCGAC.GTATGCCTT	CAGATCGAC.GTATGCCTT
CAGCGTAAG.ATGTCCTCC	CAGCGTAAG.ATGTCCTCC
CAGCTAGTT.GGTAAGTGA	CAGCTAGTT.GGTAAGTGA
CAGCTCTTC.GTAGTGGAG	CAGCTCTTC.GTAGTGGAG
CAGGATCAA.TCACACTGC	CAGGATCAA.TCACACTGC
CAGGTATCG.AATGCGTGC	CAGGTATCG.AATGCGTGC
CAGGTTGTC.CCACAAGGT	CAGGTTGTC.CCACAAGGT
CAGGTTGTC.GCCGTGAAC	CAGGTTGTC.GCCGTGAAC
CAGTAATGT.TGTCACATA	CAGTAATGT.TGTCACATA
CAGTACATC.CGCGTGAGA	CAGTACATC.CGCGTGAGA
CAGTACATC.GATATGGAC	CAGTACATC.GATATGGAC
CAGTACATC.TCAGCTCAG	CAGTACATC.TCAGCTCAG
CAGTACATC.TGGTCCTAG	CAGTACATC.TGGTCCTAG
CAGTCCTAA.AGATACGTT	CAGTCCTAA.AGATACGTT
CAGTGCTGC.CTGTGGTGG	CAGTGCTGC.CTGTGGTGG
CATAAGATC.TAACATTGG	CATAAGATC.TAACATTGG
CATACGCAG.GTAGCCTTG	CATACGCAG.GTAGCCTTG
CATAGTATG.TCGCAAGCA	CATAGTATG.TCGCAAGCA
CATATGCGA.ACTAAGTTC	CATATGCGA.ACTAAGTTC
CATATGCGA.CATTGTTCA	CATATGCGA.CATTGTTCA
CATATGCGA.TCGTGCCAC	CATATGCGA.TCGTGCCAC
CATATGTCG.TTCCTGCTA	CATATGTCG.TTCCTGCTA
CATCAATAG.GGTTGCTAT	CATCAATAG.GGTTGCTAT
CATCAATAG.TTAGTCGGA	CATCAATAG.TTAGTCGGA
CATCCACCG.CTCAGGTAC	CATCCACCG.CTCAGGTAC
CATCCACCG.GAATCGAGA	CATCCACCG.GAATCGAGA
CATCCAGGA.GGTCCTGGT	CATCCAGGA.GGTCCTGGT
CATCCAGGA.GGTTGCTAT	CATCCAGGA.GGTTGCTAT
CATCCGACA.ATGGAGGAA	CATCCGACA.ATGGAGGAA
CATCCGACA.TCCGATCTG	CATCCGACA.TCCGATCTG
CATCCGACA.TGATTCACC	CATCCGACA.TGATTCACC
CATCCGACA.TTACGGACC	CATCCGACA.TTACGGACC
CATCCTCTC.TTCGCTGAG	CATCCTCTC.TTCGCTGAG
CATCGAAGC.TCCTGTCCG	CATCGAAGC.TCCTGTCCG
CATCTCGAT.ACGCAAGAT	CATCTCGAT.ACGCAAGAT
CATCTCGAT.CAACGATCG	CATCTCGAT.CAACGATCG
CATGGACTC.TATAGTGCG	CATGGACTC.TATAGTGCG
CATGGTCGA.GACTTGATT	CATGGTCGA.GACTTGATT
CATGGTTAC.CCTGCTCCA	CATGGTTAC.CCTGCTCCA
CATGGTTAC.GACTCAGTG	CATGGTTAC.GACTCAGTG
CATGTCCTG.AGATCTTCA	CATGTCCTG.AGATCTTCA
CATGTCCTG.GTCACAGAG	CATGTCCTG.GTCACAGAG
CATTATGTC.ATAACGACA	CATTATGTC.ATAACGACA
CATTCAGTT.TCGTGCCAC	CATTCAGTT.TCGTGCCAC
CATTCAGTT.TGCTTACGG	CATTCAGTT.TGCTTACGG
CATTCCGAG.TTCACTGGA	CATTCCGAG.TTCACTGGA
CATTCGAAT.GCTTACGTT	CATTCGAAT.GCTTACGTT
CATTGACAA.GAGACGATC	CATTGACAA.GAGACGATC
CATTGACAA.GGTAATCTA	CATTGACAA.GGTAATCTA
CATTGCAGA.ACTCATTCA	CATTGCAGA.ACTCATTCA
CATTGTTCA.GTAGAGAGC	CATTGTTCA.GTAGAGAGC
CCAACAACA.GTCGCAGGT	CCAACAACA.GTCGCAGGT
CCAACAACA.GTCTTCATA	CCAACAACA.GTCTTCATA
CCAACAACA.TACCGATTG	CCAACAACA.TACCGATTG
CCAAGCGAG.CGCACTGAA	CCAAGCGAG.CGCACTGAA
CCAATATAC.CAACACCTA	CCAATATAC.CAACACCTA
CCAATATAC.CGTCAGCAC	CCAATATAC.CGTCAGCAC
CCACATTAG.TTATTCGAC	CCACATTAG.TTATTCGAC
CCACCATGC.GGTAGACAT	CCACCATGC.GGTAGACAT
CCACGCCAT.GGTAACTAC	CCACGCCAT.GGTAACTAC
CCACTGAAG.TATTGCTAC	CCACTGAAG.TATTGCTAC
CCAGATCAC.AGCGACACC	CCAGATCAC.AGCGACACC
CCAGATCAC.AGTTGCCTT	CCAGATCAC.AGTTGCCTT
CCAGCCAAT.GCTACAATG	CCAGCCAAT.GCTACAATG
CCAGGAGTT.AGTTACAAG	CCAGGAGTT.AGTTACAAG
CCAGGAGTT.GCACAGTAA	CCAGGAGTT.GCACAGTAA
CCAGGAGTT.TGCCATCTC	CCAGGAGTT.TGCCATCTC
CCAGTCTCA.CATTGTTCA	CCAGTCTCA.CATTGTTCA
CCAGTCTCA.TGATGACAG	CCAGTCTCA.TGATGACAG
CCATAAGTA.ACTCTAGGA	CCATAAGTA.ACTCTAGGA
CCATAATCG.CTGGTCGGT	CCATAATCG.CTGGTCGGT
CCATAATCG.GCAGGAGAA	CCATAATCG.GCAGGAGAA
CCATAATCG.GTATGATCT	CCATAATCG.GTATGATCT
CCATACGAT.GTGCTCGGA	CCATACGAT.GTGCTCGGA
CCATCACGA.CTCTCAGTC	CCATCACGA.CTCTCAGTC
CCATGATGT.AGCCTCTAG	CCATGATGT.AGCCTCTAG
CCATGATGT.ATAAGTTCG	CCATGATGT.ATAAGTTCG
CCATGATGT.ATCCGACCA	CCATGATGT.ATCCGACCA
CCATGCGTC.CGCTGTAGT	CCATGCGTC.CGCTGTAGT
CCATTCTGC.CTGGTAATC	CCATTCTGC.CTGGTAATC
CCATTCTGC.TAGTGCACT	CCATTCTGC.TAGTGCACT
CCGAAGCGT.GCGTGATAC	CCGAAGCGT.GCGTGATAC
CCGAGTACT.ATGTGAGAC	CCGAGTACT.ATGTGAGAC
CCGAGTACT.GGAGCTCAA	CCGAGTACT.GGAGCTCAA
CCGATCAGC.ACCTAGCAC	CCGATCAGC.ACCTAGCAC
CCGATCAGC.CAGTCTAAC	CCGATCAGC.CAGTCTAAC
CCGATCAGC.GAGTGCATA	CCGATCAGC.GAGTGCATA
CCGATCAGC.GCCGAACCA	CCGATCAGC.GCCGAACCA
CCGATGTTC.GTGCATCAA	CCGATGTTC.GTGCATCAA
CCGCAACAC.CTTGGATCA	CCGCAACAC.CTTGGATCA
CCGCAACAC.GGTTAACAG	CCGCAACAC.GGTTAACAG
CCGCACTCA.TAGCGCAGC	CCGCACTCA.TAGCGCAGC
CCGCAGCTA.CATCGCTGG	CCGCAGCTA.CATCGCTGG
CCGCATCCT.ATCCGTCTC	CCGCATCCT.ATCCGTCTC
CCGCATCCT.ATGGAGAGT	CCGCATCCT.ATGGAGAGT
CCGCATCCT.CTAGGTACT	CCGCATCCT.CTAGGTACT
CCGCATCCT.GATTAGACA	CCGCATCCT.GATTAGACA
CCGCATCCT.GCGCTTCTC	CCGCATCCT.GCGCTTCTC
CCGCTATCC.GGAAGTATG	CCGCTATCC.GGAAGTATG
CCGGATTGC.ACGTCTATG	CCGGATTGC.ACGTCTATG
CCGGATTGC.GTAACAGTC	CCGGATTGC.GTAACAGTC
CCGGTTGAG.ATCTAGGTT	CCGGTTGAG.ATCTAGGTT
CCGTCAGGT.AGCCACTTC	CCGTCAGGT.AGCCACTTC
CCGTCAGGT.CCATAAGTA	CCGTCAGGT.CCATAAGTA
CCGTCCACT.CCGGTGGTT	CCGTCCACT.CCGGTGGTT
CCGTTAGAC.TCGACGTTG	CCGTTAGAC.TCGACGTTG
CCGTTAGAC.TGCCATCTC	CCGTTAGAC.TGCCATCTC
CCGTTCCAA.CGATAGGTG	CCGTTCCAA.CGATAGGTG
