TAGACCTAC.CCTTCGAGC	TAGACCTAC.CCTTCGAGC
TAGACCTAC.TTCCAGATT	TAGACCTAC.TTCCAGATT
TAGAGACTA.TGCATACAT	TAGAGACTA.TGCATACAT
TAGAGCGTC.CACTTCCTT	TAGAGCGTC.CACTTCCTT
TAGAGCGTC.CATCCAGGA	TAGAGCGTC.CATCCAGGA
TAGATAGCC.CAGTATGAT	TAGATAGCC.CAGTATGAT
TAGATCTGT.AGTCGCCGA	TAGATCTGT.AGTCGCCGA
TAGATCTGT.CCATTCTGC	TAGATCTGT.CCATTCTGC
TAGCACTAT.CTCAGGTAC	TAGCACTAT.CTCAGGTAC
TAGCAGAGT.CACACTGCC	TAGCAGAGT.CACACTGCC
TAGCCAGTG.CAACGATCG	TAGCCAGTG.CAACGATCG
TAGCCAGTG.TCTGTGAAG	TAGCCAGTG.TCTGTGAAG
TAGCCTTGT.ATGTCGCCT	TAGCCTTGT.ATGTCGCCT
TAGCCTTGT.CCTGACCTC	TAGCCTTGT.CCTGACCTC
TAGCGCAGC.TCGTCATTC	TAGCGCAGC.TCGTCATTC
TAGGAGCTA.GGACAGATT	TAGGAGCTA.GGACAGATT
TAGGAGGAT.TGTCACATA	TAGGAGGAT.TGTCACATA
TAGGAGGAT.TGTGTAGAG	TAGGAGGAT.TGTGTAGAG
TAGGATTAG.GGTCTCATG	TAGGATTAG.GGTCTCATG
TAGTACGTA.AACAGATCG	TAGTACGTA.AACAGATCG
TAGTCGCAT.AGATCGAGT	TAGTCGCAT.AGATCGAGT
TAGTCGCAT.CTTCCGTGG	TAGTCGCAT.CTTCCGTGG
TAGTCGCAT.TCTGCGCTG	TAGTCGCAT.TCTGCGCTG
TAGTGCACT.TCAGTAAGC	TAGTGCACT.TCAGTAAGC
TATACGGAT.TAGGAGCTA	TATACGGAT.TAGGAGCTA
TATCGAGCC.CTATCTTGA	TATCGAGCC.CTATCTTGA
TATCTAGGT.AGACTTCGT	TATCTAGGT.AGACTTCGT
TATCTGTCA.GTAAGTGAG	TATCTGTCA.GTAAGTGAG
TATGACCGA.TCCAATCAT	TATGACCGA.TCCAATCAT
TATGCCTTC.TTGTCAACC	TATGCCTTC.TTGTCAACC
TATGGTTGG.CTGACAGCA	TATGGTTGG.CTGACAGCA
TATGGTTGG.TAGATCTGT	TATGGTTGG.TAGATCTGT
TATGTACCT.GACAATGTT	TATGTACCT.GACAATGTT
TATGTATGC.GTCGTTAGA	TATGTATGC.GTCGTTAGA
TATTACAGC.GGTGAGCGT	TATTACAGC.GGTGAGCGT
TATTACAGC.TGACAAGTT	TATTACAGC.TGACAAGTT
TATTACAGC.TGCGACGTT	TATTACAGC.TGCGACGTT
TATTCAACG.AAGCCACAC	TATTCAACG.AAGCCACAC
TATTCAACG.CCAATATAC	TATTCAACG.CCAATATAC
TATTCAACG.CCACCATGC	TATTCAACG.CCACCATGC
TATTCAACG.GTAGCTACA	TATTCAACG.GTAGCTACA
TATTGCTAC.CCGGTGGTT	TATTGCTAC.CCGGTGGTT
TCAACACTC.GTCCGTAAG	TCAACACTC.GTCCGTAAG
TCAACACTC.TCAGAGTCA	TCAACACTC.TCAGAGTCA
TCAAGGAGT.CCACAAGGT	TCAAGGAGT.CCACAAGGT
TCAATGGAC.ACCGGAAGG	TCAATGGAC.ACCGGAAGG
TCAATGGAC.ATGCTCACC	TCAATGGAC.ATGCTCACC
TCAATGGAC.GATGCGACG	TCAATGGAC.GATGCGACG
TCAATGGAC.TCTCATCGG	TCAATGGAC.TCTCATCGG
TCACACTGC.CTAGAGGTA	TCACACTGC.CTAGAGGTA
TCACACTGC.GCCGAACCA	TCACACTGC.GCCGAACCA
TCACAGGTA.CTGATCAAG	TCACAGGTA.CTGATCAAG
TCACATACT.GGAGCATCT	TCACATACT.GGAGCATCT
TCACCGAGG.CCGATACCG	TCACCGAGG.CCGATACCG
TCACCGAGG.TACTAGTAG	TCACCGAGG.TACTAGTAG
TCACCGAGG.TTGCGAACA	TCACCGAGG.TTGCGAACA
TCACGACAA.GGTGAGTTC	TCACGACAA.GGTGAGTTC
TCACGACAA.TTAGTCGGA	TCACGACAA.TTAGTCGGA
TCACTACGT.TCCACCTCA	TCACTACGT.TCCACCTCA
TCAGACAAG.AGAATCAGA	TCAGACAAG.AGAATCAGA
TCAGACAAG.TTGCCAGAT	TCAGACAAG.TTGCCAGAT
TCAGAGCGT.TTAGATCGG	TCAGAGCGT.TTAGATCGG
TCAGAGTCA.AACGCATTG	TCAGAGTCA.AACGCATTG
TCAGAGTCA.TAGGTCAAC	TCAGAGTCA.TAGGTCAAC
TCAGCTCAG.TGACCTATG	TCAGCTCAG.TGACCTATG
TCAGCTCAG.TGCAGATGC	TCAGCTCAG.TGCAGATGC
TCAGGTGCA.CTCGTCTTG	TCAGGTGCA.CTCGTCTTG
TCAGTAAGC.GGTCCTAAG	TCAGTAAGC.GGTCCTAAG
TCATATCGC.ACGACTGCG	TCATATCGC.ACGACTGCG
TCATATCGC.CCTTGCTTG	TCATATCGC.CCTTGCTTG
TCATGCAGG.CCTAGCAAT	TCATGCAGG.CCTAGCAAT
TCATGCAGG.CTGCGTCAC	TCATGCAGG.CTGCGTCAC
TCATGCTCA.ACTGTAATC	TCATGCTCA.ACTGTAATC
TCATGCTCA.CATTCGAAT	TCATGCTCA.CATTCGAAT
TCCAACGTG.TGGATTAGC	TCCAACGTG.TGGATTAGC
TCCAAGTAA.ACGTACTGC	TCCAAGTAA.ACGTACTGC
TCCACCTCA.CTGACAGCA	TCCACCTCA.CTGACAGCA
TCCAGAACG.TAGGATGCC	TCCAGAACG.TAGGATGCC
TCCAGCAGC.CAGCTTACC	TCCAGCAGC.CAGCTTACC
TCCAGCAGC.TGCTGCGTC	TCCAGCAGC.TGCTGCGTC
TCCAGCTAT.ACAGTATTG	TCCAGCTAT.ACAGTATTG
TCCAGCTAT.CACCTCGGA	TCCAGCTAT.CACCTCGGA
TCCATCATT.TTAGATCGG	TCCATCATT.TTAGATCGG
TCCGATAAC.CACATATCA	TCCGATAAC.CACATATCA
TCCGATCTG.TTGAGCTCT	TCCGATCTG.TTGAGCTCT
TCCGTATAC.CGACGTGAT	TCCGTATAC.CGACGTGAT
TCCTATTCC.ACGTGAATC	TCCTATTCC.ACGTGAATC
TCCTGTCCG.TGCCGAACT	TCCTGTCCG.TGCCGAACT
TCCTGTGGA.GACACCGAT	TCCTGTGGA.GACACCGAT
TCCTGTGGA.TTGCGAACA	TCCTGTGGA.TTGCGAACA
TCCTTAGGT.CGCCATTAC	TCCTTAGGT.CGCCATTAC
TCCTTCAAC.GCAGCTTGA	TCCTTCAAC.GCAGCTTGA
TCGAACGCT.ATGTCGCCT	TCGAACGCT.ATGTCGCCT
TCGAACGCT.CGCTTATGA	TCGAACGCT.CGCTTATGA
TCGAATAGA.TCAAGGTCG	TCGAATAGA.TCAAGGTCG
TCGACGTTG.CTGGTAATC	TCGACGTTG.CTGGTAATC
TCGACGTTG.GCATTGATC	TCGACGTTG.GCATTGATC
TCGATTCAG.AAGGAACAG	TCGATTCAG.AAGGAACAG
TCGATTCAG.CCGAGTACT	TCGATTCAG.CCGAGTACT
TCGCATTCG.GATGCGACG	TCGCATTCG.GATGCGACG
TCGCCAAGC.CATCCAGGA	TCGCCAAGC.CATCCAGGA
TCGCGTCAT.CTTATCTCA	TCGCGTCAT.CTTATCTCA
TCGCTGATT.CTGATGCAC	TCGCTGATT.CTGATGCAC
TCGCTGTAA.ATGCTTCAG	TCGCTGTAA.ATGCTTCAG
TCGGACAGT.ATTCGAAGA	TCGGACAGT.ATTCGAAGA
TCGGACAGT.TTAACGGAG	TCGGACAGT.TTAACGGAG
TCGGATGTT.GGTTCGCAA	TCGGATGTT.GGTTCGCAA
TCGTCCGAT.TACCAGCCA	TCGTCCGAT.TACCAGCCA
TCGTGACGT.TACAGGACT	TCGTGACGT.TACAGGACT
TCGTTCTCC.AGCTCTCCG	TCGTTCTCC.AGCTCTCCG
TCGTTCTCC.CAGCGTAAG	TCGTTCTCC.CAGCGTAAG
TCTAATACC.ACCTTGAAG	TCTAATACC.ACCTTGAAG
TCTAATACC.ATCTGGTAG	TCTAATACC.ATCTGGTAG
TCTACAGTT.ACGTTCAAT	TCTACAGTT.ACGTTCAAT
TCTACAGTT.AGGAAGGTG	TCTACAGTT.AGGAAGGTG
TCTACGCAA.CTGTTACCA	TCTACGCAA.CTGTTACCA
TCTACGCAA.GGTTGCTAT	TCTACGCAA.GGTTGCTAT
TCTACGCAA.TGTGCAGTA	TCTACGCAA.TGTGCAGTA
TCTAGGATG.TTACGCTCG	TCTAGGATG.TTACGCTCG
TCTCAGGAT.TCGTACCTT	TCTCAGGAT.TCGTACCTT
TCTCATCGG.CCAGCCAAT	TCTCATCGG.CCAGCCAAT
TCTCATCGG.GCCTTATCT	TCTCATCGG.GCCTTATCT
TCTCCGCGT.AGCTATATG	TCTCCGCGT.AGCTATATG
TCTCCGCGT.TCAGCGACC	TCTCCGCGT.TCAGCGACC
TCTCGATGC.TGTTACTGA	TCTCGATGC.TGTTACTGA
TCTCGTATC.GGAGCATCT	TCTCGTATC.GGAGCATCT
TCTGAGATA.ACGCACACT	TCTGAGATA.ACGCACACT
TCTGAGATA.CTCAGTGAT	TCTGAGATA.CTCAGTGAT
TCTGCAACA.AACTTAGCT	TCTGCAACA.AACTTAGCT
TCTGCAACA.CCGATGTTC	TCTGCAACA.CCGATGTTC
TCTGCAACA.GTGCTGACT	TCTGCAACA.GTGCTGACT
TCTGCGCTG.ATCTCTGCT	TCTGCGCTG.ATCTCTGCT
TCTGCGCTG.GCGTCGTCT	TCTGCGCTG.GCGTCGTCT
TCTGCGCTG.TCCTCTAGT	TCTGCGCTG.TCCTCTAGT
TCTTGGTAG.ATAAGACAG	TCTTGGTAG.ATAAGACAG
TCTTGGTAG.TAGCAGAGT	TCTTGGTAG.TAGCAGAGT
TCTTGGTAG.TTAGGAAGG	TCTTGGTAG.TTAGGAAGG
TGAACGTCA.TATTCAACG	TGAACGTCA.TATTCAACG
TGAAGACCA.ACCGACGGT	TGAAGACCA.ACCGACGGT
TGACCAAGT.CGATAGGTG	TGACCAAGT.CGATAGGTG
TGACCAAGT.GCCTTATCT	TGACCAAGT.GCCTTATCT
TGACCTCCT.TCGCGTCAT	TGACCTCCT.TCGCGTCAT
TGACGGTTG.AGCTTGGTG	TGACGGTTG.AGCTTGGTG
TGAGAATCC.CGCGATGTA	TGAGAATCC.CGCGATGTA
TGAGAATCC.GCCATCGCT	TGAGAATCC.GCCATCGCT
TGAGACAGC.TAGAGACTA	TGAGACAGC.TAGAGACTA
TGAGAGGAC.GCTGGTAAC	TGAGAGGAC.GCTGGTAAC
TGAGATCAT.ACTAAGTTC	TGAGATCAT.ACTAAGTTC
TGAGATCAT.TCAGAGCGT	TGAGATCAT.TCAGAGCGT
TGAGCTAGA.GCGATATGA	TGAGCTAGA.GCGATATGA
TGAGCTAGA.TCTGTGAAG	TGAGCTAGA.TCTGTGAAG
TGAGGTCTC.CCGCAATGG	TGAGGTCTC.CCGCAATGG
TGAGGTCTC.TTACTTACG	TGAGGTCTC.TTACTTACG
TGAGTGACT.TAGTACGTA	TGAGTGACT.TAGTACGTA
TGAGTTAAG.TGATAGAGG	TGAGTTAAG.TGATAGAGG
TGATACCGT.ACCTAGTTA	TGATACCGT.ACCTAGTTA
TGATACCGT.CTGGAGCGA	TGATACCGT.CTGGAGCGA
TGATAGAGG.TCTGTGAAG	TGATAGAGG.TCTGTGAAG
TGATCGGAA.ATGCTTCAG	TGATCGGAA.ATGCTTCAG
TGATCGGAA.TATACGGAT	TGATCGGAA.TATACGGAT
TGATCGGAA.TATTGACTG	TGATCGGAA.TATTGACTG
TGATCTCGG.AATGCACTT	TGATCTCGG.AATGCACTT
TGATCTCGG.GATGTTACA	TGATCTCGG.GATGTTACA
TGATCTCGG.GGTAACTAC	TGATCTCGG.GGTAACTAC
TGATGACAG.CCGATGTTC	TGATGACAG.CCGATGTTC
TGATGGACA.TCCACCGGT	TGATGGACA.TCCACCGGT
TGATGTGTG.AATAACTCC	TGATGTGTG.AATAACTCC
TGATGTGTG.AGCGGTAAG	TGATGTGTG.AGCGGTAAG
TGATTCACC.ACTGGACCA	TGATTCACC.ACTGGACCA
TGATTCACC.AGCATATGG	TGATTCACC.AGCATATGG
TGATTCACC.TATGTACCT	TGATTCACC.TATGTACCT
TGATTGCTG.CACACCTGT	TGATTGCTG.CACACCTGT
TGATTGCTG.CTATTAAGG	TGATTGCTG.CTATTAAGG
TGATTGTGC.GCAATGAGA	TGATTGTGC.GCAATGAGA
TGCAACTCT.TCTACGCAA	TGCAACTCT.TCTACGCAA
TGCAGATGC.TTAGCGTCT	TGCAGATGC.TTAGCGTCT
TGCAGCCTT.CAAGCCTCG	TGCAGCCTT.CAAGCCTCG
TGCAGCCTT.CTGCAAGCC	TGCAGCCTT.CTGCAAGCC
TGCAGCCTT.GATCTACTT	TGCAGCCTT.GATCTACTT
TGCAGTCGG.TGGTGGATC	TGCAGTCGG.TGGTGGATC
TGCATACAT.ATGTGAGAC	TGCATACAT.ATGTGAGAC
TGCATCGGA.CTATAGCTC	TGCATCGGA.CTATAGCTC
TGCCAGACG.CCAGTACTC	TGCCAGACG.CCAGTACTC
TGCCATCTC.CTTGATCTA	TGCCATCTC.CTTGATCTA
TGCCGACTA.TTCGCATCC	TGCCGACTA.TTCGCATCC
TGCCTGGTT.CAGTTACTG	TGCCTGGTT.CAGTTACTG
TGCGCACTG.CATCCAGGA	TGCGCACTG.CATCCAGGA
TGCGCACTG.TCCAGCTAT	TGCGCACTG.TCCAGCTAT
TGCGCTGCA.AGAAGTAAC	TGCGCTGCA.AGAAGTAAC
TGCGTATCT.AACTTGTCG	TGCGTATCT.AACTTGTCG
TGCGTCTTA.ATCCTGCCT	TGCGTCTTA.ATCCTGCCT
TGCGTCTTA.CACTGGTCC	TGCGTCTTA.CACTGGTCC
TGCGTGCCA.GACCGTAGT	TGCGTGCCA.GACCGTAGT
TGCTATGAA.CGTGTGTGG	TGCTATGAA.CGTGTGTGG
TGCTCACAC.GCGATGGTG	TGCTCACAC.GCGATGGTG
TGCTCAGCG.AGCTTCGAT	TGCTCAGCG.AGCTTCGAT
TGCTTACGG.AGATATGGA	TGCTTACGG.AGATATGGA
TGGAACTAA.ACTCCTGAG	TGGAACTAA.ACTCCTGAG
TGGAACTAA.CTCGCAAGA	TGGAACTAA.CTCGCAAGA
TGGAACTAA.GTAGCATAC	TGGAACTAA.GTAGCATAC
TGGAAGATT.CACGGATAG	TGGAAGATT.CACGGATAG
TGGAAGATT.GAACTCGTA	TGGAAGATT.GAACTCGTA
TGGAAGATT.GCTGGTTCG	TGGAAGATT.GCTGGTTCG
TGGAATCGT.AACTGATTC	TGGAATCGT.AACTGATTC
TGGAATCGT.ATCGCCTCT	TGGAATCGT.ATCGCCTCT
TGGAATCGT.TGCCAGACG	TGGAATCGT.TGCCAGACG
TGGACTGCC.ACTCCTGAG	TGGACTGCC.ACTCCTGAG
TGGAGAACC.AGGAGCAAT	TGGAGAACC.AGGAGCAAT
TGGAGTGGA.CTGTGCTCA	TGGAGTGGA.CTGTGCTCA
TGGAGTGGA.TCCGATAAC	TGGAGTGGA.TCCGATAAC
TGGATAGGT.TACCGATTG	TGGATAGGT.TACCGATTG
TGGATTAGC.CTTAACAGC	TGGATTAGC.CTTAACAGC
TGGTCTACG.CTTATTGAG	TGGTCTACG.CTTATTGAG
TGTAACAGT.ACACATCTG	TGTAACAGT.ACACATCTG
TGTACACGA.GGTTGAAGG	TGTACACGA.GGTTGAAGG
TGTACACGA.TCGCCAAGC	TGTACACGA.TCGCCAAGC
TGTAGATCG.CTTCTGAGT	TGTAGATCG.CTTCTGAGT
TGTAGATCG.GTGCACGAG	TGTAGATCG.GTGCACGAG
TGTAGGTTA.GCTATGTAA	TGTAGGTTA.GCTATGTAA
TGTAGGTTA.GCTGGTTCG	TGTAGGTTA.GCTGGTTCG
TGTATCGTG.CCTAGTTAG	TGTATCGTG.CCTAGTTAG
TGTATCGTG.GTAGGACGC	TGTATCGTG.GTAGGACGC
TGTATGTAG.ACAGGAACT	TGTATGTAG.ACAGGAACT
TGTCAACCT.ATTAGCCAC	TGTCAACCT.ATTAGCCAC
TGTCAACCT.CCGACTGTT	TGTCAACCT.CCGACTGTT
TGTCACATA.CCTATTGGT	TGTCACATA.CCTATTGGT
TGTCCATAG.ACTCCTGAG	TGTCCATAG.ACTCCTGAG
TGTCCATAG.AGTACTACA	TGTCCATAG.AGTACTACA
TGTCCATAG.TTCAGTGCC	TGTCCATAG.TTCAGTGCC
TGTCGTGAG.GCCGTTGTT	TGTCGTGAG.GCCGTTGTT
TGTGAGTAT.ATCACTTCC	TGTGAGTAT.ATCACTTCC
TGTGAGTAT.GTGCACGAG	TGTGAGTAT.GTGCACGAG
TGTGCAGTA.GTCTGAGCC	TGTGCAGTA.GTCTGAGCC
TGTGGACAA.AGCTCTCCG	TGTGGACAA.AGCTCTCCG
TGTGTCTAC.ATCTTACAG	TGTGTCTAC.ATCTTACAG
TTAACGGAG.AGTGAGAGA	TTAACGGAG.AGTGAGAGA
TTAACGTTC.TGCATCGGA	TTAACGTTC.TGCATCGGA
TTACACCTT.AATACCTTG	TTACACCTT.AATACCTTG
TTACACCTT.CTGCGTCAC	TTACACCTT.CTGCGTCAC
TTACACCTT.GGTTCGCAA	TTACACCTT.GGTTCGCAA
TTACAGTGT.TATCTAGGT	TTACAGTGT.TATCTAGGT
TTACGCTCG.ATGGTTCGA	TTACGCTCG.ATGGTTCGA
TTACGGACC.AGTAATCAG	TTACGGACC.AGTAATCAG
TTAGATCGG.CATATGTCG	TTAGATCGG.CATATGTCG
TTAGCGTCT.AACTGCGAC	TTAGCGTCT.AACTGCGAC
TTAGTCGGA.AGCATATGG	TTAGTCGGA.AGCATATGG
TTAGTCGGA.CAGCTGGAG	TTAGTCGGA.CAGCTGGAG
TTATCGCAC.CTTCGTGCA	TTATCGCAC.CTTCGTGCA
TTATGAGGA.AGCGTAGAA	TTATGAGGA.AGCGTAGAA
TTATTCGAC.AGGTCAGCA	TTATTCGAC.AGGTCAGCA
TTATTCGAC.ATCTCGAAC	TTATTCGAC.ATCTCGAAC
TTCACTCCT.ATCAAGCAT	TTCACTCCT.ATCAAGCAT
TTCAGTGCC.AGACGCCTG	TTCAGTGCC.AGACGCCTG
TTCATCCAA.AGTGTTCTG	TTCATCCAA.AGTGTTCTG
TTCATCCAA.CTTGGTCAT	TTCATCCAA.CTTGGTCAT
TTCATTCGC.TAACACATC	TTCATTCGC.TAACACATC
TTCATTCGC.TCCGGAGCT	TTCATTCGC.TCCGGAGCT
TTCCAATTC.GAGACATTG	TTCCAATTC.GAGACATTG
TTCCAGATT.CATCTCACG	TTCCAGATT.CATCTCACG
TTCCATACC.CTTGGTCAT	TTCCATACC.CTTGGTCAT
TTCCATACC.GATACCGGA	TTCCATACC.GATACCGGA
TTCCTAAGG.AATCGCCAT	TTCCTAAGG.AATCGCCAT
TTCCTAAGG.CATATGCGA	TTCCTAAGG.CATATGCGA
TTCCTAAGG.CCGCAATGG	TTCCTAAGG.CCGCAATGG
TTCCTAAGG.GCCTGGAAT	TTCCTAAGG.GCCTGGAAT
TTCCTCGGT.GATCCGCAC	TTCCTCGGT.GATCCGCAC
TTCCTCGGT.TACGAACTC	TTCCTCGGT.TACGAACTC
TTCGCTGAG.CGAGCTTAC	TTCGCTGAG.CGAGCTTAC
TTCGGAGTC.CATCAATAG	TTCGGAGTC.CATCAATAG
TTCTGGTGC.TGATAGAGG	TTCTGGTGC.TGATAGAGG
TTGACCTGA.CAATACCAC	TTGACCTGA.CAATACCAC
TTGACCTGA.TCCTTCAAC	TTGACCTGA.TCCTTCAAC
TTGAGACGG.CCATCACGA	TTGAGACGG.CCATCACGA
TTGAGCTCT.CCATGATGT	TTGAGCTCT.CCATGATGT
TTGAGCTCT.TCCTTAGGT	TTGAGCTCT.TCCTTAGGT
TTGCAGTCA.ATTGGTTCC	TTGCAGTCA.ATTGGTTCC
TTGCAGTCA.CAACGTCTT	TTGCAGTCA.CAACGTCTT
TTGCCAGAT.GAAGTGTGA	TTGCCAGAT.GAAGTGTGA
TTGCTCTGC.GTGAGGACG	TTGCTCTGC.GTGAGGACG
TTGGAGAAC.ACGGTGCCT	TTGGAGAAC.ACGGTGCCT
TTGGAGAAC.GCCTAACGG	TTGGAGAAC.GCCTAACGG
TTGGAGAAC.GGTCGGATA	TTGGAGAAC.GGTCGGATA
TTGGTAACT.CTGTCACTT	TTGGTAACT.CTGTCACTT
TTGTATCAC.CATATGTCG	TTGTATCAC.CATATGTCG
TTGTATCAC.CATGTGAAC	TTGTATCAC.CATGTGAAC
TTGTTAGAG.GGTTGCTAT	TTGTTAGAG.GGTTGCTAT
TTGTTAGAG.GTAATCAGC	TTGTTAGAG.GTAATCAGC
