CCGTTCCAA.TTCATCCAA	CCGTTCCAA.TTCATCCAA
CCTACTAGA.CATCCAGGA	CCTACTAGA.CATCCAGGA
CCTACTAGA.TCTAGTGAC	CCTACTAGA.TCTAGTGAC
CCTCAGGTG.ACCATACTT	CCTCAGGTG.ACCATACTT
CCTCGACCT.ACATGGATT	CCTCGACCT.ACATGGATT
CCTCGACCT.ACTGGTGCT	CCTCGACCT.ACTGGTGCT
CCTCGACCT.GGTGGAGCT	CCTCGACCT.GGTGGAGCT
CCTCGACCT.TCACGACAA	CCTCGACCT.TCACGACAA
CCTCGAGAG.GCGACACAG	CCTCGAGAG.GCGACACAG
CCTCGGTCA.CCTGTCATT	CCTCGGTCA.CCTGTCATT
CCTCGGTCA.GATGCGGTT	CCTCGGTCA.GATGCGGTT
CCTCTCTAG.TAGTGATCC	CCTCTCTAG.TAGTGATCC
CCTCTGCAT.GAACCTTCA	CCTCTGCAT.GAACCTTCA
CCTGACCTC.CATCGAAGC	CCTGACCTC.CATCGAAGC
CCTGCAGAT.CAAGAGGAG	CCTGCAGAT.CAAGAGGAG
CCTGCGTTA.TGCCAATGG	CCTGCGTTA.TGCCAATGG
CCTGCTCCA.AAGGATACG	CCTGCTCCA.AAGGATACG
CCTGCTCCA.TTGATGCTG	CCTGCTCCA.TTGATGCTG
CCTGTATCT.CAAGCCTCG	CCTGTATCT.CAAGCCTCG
CCTGTTAGC.AGGTATTCC	CCTGTTAGC.AGGTATTCC
CCTGTTAGC.CATCCGACA	CCTGTTAGC.CATCCGACA
CCTTAATTC.GTCTCCAGG	CCTTAATTC.GTCTCCAGG
CCTTCGAGC.AGTACTCTC	CCTTCGAGC.AGTACTCTC
CCTTGCTTG.ACTGTGTCA	CCTTGCTTG.ACTGTGTCA
CGAACAATC.ATTGACACG	CGAACAATC.ATTGACACG
CGAACAGAG.CGAGCCGTT	CGAACAGAG.CGAGCCGTT
CGAAGAGGT.CCTCGACCT	CGAAGAGGT.CCTCGACCT
CGAAGAGGT.GGTACTTCC	CGAAGAGGT.GGTACTTCC
CGAATGAGT.AGACTAGTA	CGAATGAGT.AGACTAGTA
CGAATGAGT.TAGGAGCTA	CGAATGAGT.TAGGAGCTA
CGAATGAGT.TCACTCGCT	CGAATGAGT.TCACTCGCT
CGACAGACC.CTGTACGAC	CGACAGACC.CTGTACGAC
CGACAGGAA.CCTCATAAC	CGACAGGAA.CCTCATAAC
CGACAGGAA.GACATAACG	CGACAGGAA.GACATAACG
CGACCACTT.CATTCAGTT	CGACCACTT.CATTCAGTT
CGACCACTT.TACGAACTC	CGACCACTT.TACGAACTC
CGACCACTT.TAGTGCACT	CGACCACTT.TAGTGCACT
CGACCATCA.ACTTAGCTT	CGACCATCA.ACTTAGCTT
CGACCATCA.TTAACGTTC	CGACCATCA.TTAACGTTC
CGACCTAGC.GCTACCTTA	CGACCTAGC.GCTACCTTA
CGACCTGTA.CACAACCAG	CGACCTGTA.CACAACCAG
CGACGTACG.ATATCAGCC	CGACGTACG.ATATCAGCC
CGAGCTTAC.GATCTACTT	CGAGCTTAC.GATCTACTT
CGAGTAGCA.CCTACTAGA	CGAGTAGCA.CCTACTAGA
CGATAGGTG.ACCGCTGTG	CGATAGGTG.ACCGCTGTG
CGATAGGTG.GCAGCGATA	CGATAGGTG.GCAGCGATA
CGATTGAAC.ACGTAGTAT	CGATTGAAC.ACGTAGTAT
CGATTGAAC.ATCTCTGCT	CGATTGAAC.ATCTCTGCT
CGCAACCTC.AATTGGATC	CGCAACCTC.AATTGGATC
CGCAATCGA.GGTCCTGGT	CGCAATCGA.GGTCCTGGT
CGCACTCTT.GCGTCGTCT	CGCACTCTT.GCGTCGTCT
CGCACTCTT.TCCAACGTG	CGCACTCTT.TCCAACGTG
CGCACTGAA.GTTCACTCC	CGCACTGAA.GTTCACTCC
CGCAGTGTC.TGATGTGTG	CGCAGTGTC.TGATGTGTG
CGCATAACT.CAGCTCTTC	CGCATAACT.CAGCTCTTC
CGCATAACT.GGTGTGACC	CGCATAACT.GGTGTGACC
CGCATCTAC.CTGCTTAGG	CGCATCTAC.CTGCTTAGG
CGCCACCAT.CCGACGTCA	CGCCACCAT.CCGACGTCA
CGCCATTAC.TGAACGGTT	CGCCATTAC.TGAACGGTT
CGCCATTAC.TGTTACTGA	CGCCATTAC.TGTTACTGA
CGCCTGCAA.ACTGGACCA	CGCCTGCAA.ACTGGACCA
CGCGAGTGT.CCTTAATTC	CGCGAGTGT.CCTTAATTC
CGCTGTAGT.GTGTTGGAA	CGCTGTAGT.GTGTTGGAA
CGCTTATGA.ATAATGTGG	CGCTTATGA.ATAATGTGG
CGCTTATGA.GCTACCGAG	CGCTTATGA.GCTACCGAG
CGCTTATGA.GGAACCTAG	CGCTTATGA.GGAACCTAG
CGCTTCACG.AAGCTTGCA	CGCTTCACG.AAGCTTGCA
CGCTTGTAG.GCCGCTATC	CGCTTGTAG.GCCGCTATC
CGGAACGAG.AATCAGGAG	CGGAACGAG.AATCAGGAG
CGGAACGAG.AGCTACTCA	CGGAACGAG.AGCTACTCA
CGGAACGAG.GATCTACTT	CGGAACGAG.GATCTACTT
CGGAAGACG.GGTTACGCA	CGGAAGACG.GGTTACGCA
CGGAAGACG.TATCACCTG	CGGAAGACG.TATCACCTG
CGGACAAGT.AGTAATGGT	CGGACAAGT.AGTAATGGT
CGGACAAGT.GCGACAACC	CGGACAAGT.GCGACAACC
CGGACAAGT.GTCGCAGGT	CGGACAAGT.GTCGCAGGT
CGGTCGACA.GAGTCACCA	CGGTCGACA.GAGTCACCA
CGGTGTTAC.GTAACTCAT	CGGTGTTAC.GTAACTCAT
CGGTTCTAT.CTATCCATC	CGGTTCTAT.CTATCCATC
CGGTTGCGA.AACGGTAGC	CGGTTGCGA.AACGGTAGC
CGGTTGCGA.CTGGACACT	CGGTTGCGA.CTGGACACT
CGGTTGCGA.GATCGCACT	CGGTTGCGA.GATCGCACT
CGTACATCT.GTCTCTTCA	CGTACATCT.GTCTCTTCA
CGTATAGCG.CTCTAAGAG	CGTATAGCG.CTCTAAGAG
CGTATCGAA.ATCTGCGTA	CGTATCGAA.ATCTGCGTA
CGTCAGCAC.ACACCACAT	CGTCAGCAC.ACACCACAT
CGTCATGGA.TTACTAGTC	CGTCATGGA.TTACTAGTC
CGTCGTCAA.GATAAGCTG	CGTCGTCAA.GATAAGCTG
CGTGAGACT.CCGCAACAC	CGTGAGACT.CCGCAACAC
CGTGCAAGG.AAGTTGCCA	CGTGCAAGG.AAGTTGCCA
CGTGCAAGG.TGATGACAG	CGTGCAAGG.TGATGACAG
CGTGCCTAT.ATCTCGTGA	CGTGCCTAT.ATCTCGTGA
CGTGCCTAT.GGACGAGCA	CGTGCCTAT.GGACGAGCA
CGTGCTTGA.CTAATACGC	CGTGCTTGA.CTAATACGC
CGTGGTACC.ACTTCTAAC	CGTGGTACC.ACTTCTAAC
CGTGGTACC.GACGTTCAG	CGTGGTACC.GACGTTCAG
CGTGTCCGA.GATTGGAAG	CGTGTCCGA.GATTGGAAG
CGTTACACC.CTCGACTGC	CGTTACACC.CTCGACTGC
CGTTGATCC.CGCGATGTA	CGTTGATCC.CGCGATGTA
CTAACACTG.AGTCTGGAA	CTAACACTG.AGTCTGGAA
CTAACACTG.ATACAACCG	CTAACACTG.ATACAACCG
CTAACTAAG.CCGATGTTC	CTAACTAAG.CCGATGTTC
CTAATACGC.TAGGATTAG	CTAATACGC.TAGGATTAG
CTAATACGC.TTCCGCCAG	CTAATACGC.TTCCGCCAG
CTACCTGCG.ACGGTGCCT	CTACCTGCG.ACGGTGCCT
CTACCTGCG.CAGTTACTG	CTACCTGCG.CAGTTACTG
CTACCTGCG.CCTCTTGTA	CTACCTGCG.CCTCTTGTA
CTACGAGAA.CGACCTAGC	CTACGAGAA.CGACCTAGC
CTACGTTGG.ATTAAGACC	CTACGTTGG.ATTAAGACC
CTACTGTCA.CAACTCCAG	CTACTGTCA.CAACTCCAG
CTACTGTCA.GTGTCGAGC	CTACTGTCA.GTGTCGAGC
CTAGAGGTA.ATGGAGAGT	CTAGAGGTA.ATGGAGAGT
CTAGAGTCG.GCTACAATG	CTAGAGTCG.GCTACAATG
CTAGAGTCG.TGTTACTGA	CTAGAGTCG.TGTTACTGA
CTAGTCGTC.AAGTAGGAC	CTAGTCGTC.AAGTAGGAC
CTAGTCGTC.ATATTCGCA	CTAGTCGTC.ATATTCGCA
CTAGTCGTC.TGAGGTCTC	CTAGTCGTC.TGAGGTCTC
CTATACTAG.ACGGACCAT	CTATACTAG.ACGGACCAT
CTATAGCTC.GAAGAGCAC	CTATAGCTC.GAAGAGCAC
CTATCCATC.CCGCATCCT	CTATCCATC.CCGCATCCT
CTATCCATC.TTCACTCCT	CTATCCATC.TTCACTCCT
CTATCTTGA.TTACGCTCG	CTATCTTGA.TTACGCTCG
CTATTAAGG.GTAGACTCT	CTATTAAGG.GTAGACTCT
CTATTAAGG.TATAGTGCG	CTATTAAGG.TATAGTGCG
CTCAGCTGG.CACGTAGAC	CTCAGCTGG.CACGTAGAC
CTCAGGTAC.TAATGTAGC	CTCAGGTAC.TAATGTAGC
CTCAGGTAC.TACAACACC	CTCAGGTAC.TACAACACC
CTCAGTGAT.GTAAGGTCC	CTCAGTGAT.GTAAGGTCC
CTCAGTGAT.TAACGTGTC	CTCAGTGAT.TAACGTGTC
CTCATGCCA.TGATTGTGC	CTCATGCCA.TGATTGTGC
CTCATTAGT.ACTCGCTGT	CTCATTAGT.ACTCGCTGT
CTCATTAGT.ATGCCTTCA	CTCATTAGT.ATGCCTTCA
CTCCACGTC.TGACGATGA	CTCCACGTC.TGACGATGA
CTCCAGCGT.AGAGCCGCA	CTCCAGCGT.AGAGCCGCA
CTCCTGACG.CCTGTTAGC	CTCCTGACG.CCTGTTAGC
CTCGAACTG.GGATAGTCA	CTCGAACTG.GGATAGTCA
CTCGACGAT.AAGAGAACT	CTCGACGAT.AAGAGAACT
CTCGACGAT.GAGCAGGAA	CTCGACGAT.GAGCAGGAA
CTCGCAAGA.ACGTATGTC	CTCGCAAGA.ACGTATGTC
CTCGCAAGA.CACGGAAGT	CTCGCAAGA.CACGGAAGT
CTCGCAAGA.CGGAAGACG	CTCGCAAGA.CGGAAGACG
CTCGTCTTG.GTCTCCAGG	CTCGTCTTG.GTCTCCAGG
CTCGTTCAC.AACGCTCAA	CTCGTTCAC.AACGCTCAA
CTCGTTCAC.ATCAGAAGC	CTCGTTCAC.ATCAGAAGC
CTCGTTCAC.GATTGGAAG	CTCGTTCAC.GATTGGAAG
CTCTAAGAG.GCCAACAAT	CTCTAAGAG.GCCAACAAT
CTCTCAGTC.TGCGTATCT	CTCTCAGTC.TGCGTATCT
CTCTCGATA.ATAATGTGG	CTCTCGATA.ATAATGTGG
CTCTGCAAG.TCACGCGAC	CTCTGCAAG.TCACGCGAC
CTGACGATG.AGTCGCGAC	CTGACGATG.AGTCGCGAC
CTGACGGAT.GCGGTAAGT	CTGACGGAT.GCGGTAAGT
CTGAGATAG.ATCATTACG	CTGAGATAG.ATCATTACG
CTGAGATAG.TTGCGAACA	CTGAGATAG.TTGCGAACA
CTGAGTAGC.ACAGCGGTC	CTGAGTAGC.ACAGCGGTC
CTGAGTAGC.ATTCCGTAC	CTGAGTAGC.ATTCCGTAC
CTGAGTAGC.CCGAGTACT	CTGAGTAGC.CCGAGTACT
CTGAGTAGC.TACCTCCTC	CTGAGTAGC.TACCTCCTC
CTGATCAAG.CCAATATAC	CTGATCAAG.CCAATATAC
CTGATCAAG.TGATAGAGG	CTGATCAAG.TGATAGAGG
CTGCAGAGC.CTGGTGACA	CTGCAGAGC.CTGGTGACA
CTGCAGAGC.GCCACGAGT	CTGCAGAGC.GCCACGAGT
CTGCGATTC.CGAAGAGGT	CTGCGATTC.CGAAGAGGT
CTGCGATTC.GCAGGAGAA	CTGCGATTC.GCAGGAGAA
CTGCTTAGG.AGGAGGTGA	CTGCTTAGG.AGGAGGTGA
CTGCTTAGG.TACAACACC	CTGCTTAGG.TACAACACC
CTGGAGCGA.ATTCATGTG	CTGGAGCGA.ATTCATGTG
CTGGTAATC.ATTAAGACC	CTGGTAATC.ATTAAGACC
CTGGTAATC.GCTTACTAG	CTGGTAATC.GCTTACTAG
CTGGTCGGT.CCTGTATCT	CTGGTCGGT.CCTGTATCT
CTGGTGACA.AACGTTCTT	CTGGTGACA.AACGTTCTT
CTGGTGACA.CCAAGCGAG	CTGGTGACA.CCAAGCGAG
CTGTACGAC.CCGGTTCTA	CTGTACGAC.CCGGTTCTA
CTGTCACTT.AGGTATTCC	CTGTCACTT.AGGTATTCC
CTGTCACTT.GGAAGTATG	CTGTCACTT.GGAAGTATG
CTGTCACTT.TCGTAATAG	CTGTCACTT.TCGTAATAG
CTGTTACCA.ATAGTCAGT	CTGTTACCA.ATAGTCAGT
CTGTTACCA.TCCTGTCCG	CTGTTACCA.TCCTGTCCG
CTTAACAGC.TGTATGTAG	CTTAACAGC.TGTATGTAG
CTTAATCGT.CGTGTGTGG	CTTAATCGT.CGTGTGTGG
CTTACCTAG.TGATGGACA	CTTACCTAG.TGATGGACA
CTTATCTCA.TAAGTGTAG	CTTATCTCA.TAAGTGTAG
CTTCACTGT.GACGTGGTC	CTTCACTGT.GACGTGGTC
CTTCACTGT.TCCGATAAC	CTTCACTGT.TCCGATAAC
CTTCCGGTA.AACAGCAGT	CTTCCGGTA.AACAGCAGT
CTTCGTGCA.CCGCATCCT	CTTCGTGCA.CCGCATCCT
CTTCTATGA.CTCAGTGAT	CTTCTATGA.CTCAGTGAT
CTTCTCATC.AGAAGTAAC	CTTCTCATC.AGAAGTAAC
CTTCTGAGT.GAGGTGAGC	CTTCTGAGT.GAGGTGAGC
CTTGCGACC.GTCGACATT	CTTGCGACC.GTCGACATT
CTTGGATCA.CTCGCAAGA	CTTGGATCA.CTCGCAAGA
CTTGGTCAT.ACTACCATC	CTTGGTCAT.ACTACCATC
CTTGGTCAT.TGAGAATCC	CTTGGTCAT.TGAGAATCC
GAACTCGTA.GCTACAATG	GAACTCGTA.GCTACAATG
GAACTGCAA.TGCGTATCT	GAACTGCAA.TGCGTATCT
GAAGGATCA.AACTGATTC	GAAGGATCA.AACTGATTC
GAAGGATCA.ACTTAGCTT	GAAGGATCA.ACTTAGCTT
GAATCGAGA.ACCAGCGTT	GAATCGAGA.ACCAGCGTT
GAATCGAGA.GGATAGTCA	GAATCGAGA.GGATAGTCA
GAATTCAGT.ATGTCGCCT	GAATTCAGT.ATGTCGCCT
GACAATGTT.CGCAATCGA	GACAATGTT.CGCAATCGA
GACACCGAT.CGTGACCAG	GACACCGAT.CGTGACCAG
GACATAACG.CACAGCGAA	GACATAACG.CACAGCGAA
GACATATGT.GCTCTCCAA	GACATATGT.GCTCTCCAA
GACCAACAG.ACTCGTCTA	GACCAACAG.ACTCGTCTA
GACCAACAG.TAGTACGTA	GACCAACAG.TAGTACGTA
GACCACTCG.GTCTTCATA	GACCACTCG.GTCTTCATA
GACCAGAGA.ATACCGCTT	GACCAGAGA.ATACCGCTT
GACCGCTTC.AGGATCATG	GACCGCTTC.AGGATCATG
GACCGGTAG.TCGTACCTT	GACCGGTAG.TCGTACCTT
GACCGTAGT.AACAGCAGT	GACCGTAGT.AACAGCAGT
GACCGTAGT.ATCATTACG	GACCGTAGT.ATCATTACG
GACGCCGTA.GTGTATCTG	GACGCCGTA.GTGTATCTG
GACGGACTA.CGCGTACTA	GACGGACTA.CGCGTACTA
GACGTCAAT.ACGTCGCTC	GACGTCAAT.ACGTCGCTC
GACGTCAAT.CAATCATAC	GACGTCAAT.CAATCATAC
GACTAGCAT.ATGAACTAG	GACTAGCAT.ATGAACTAG
GACTAGCAT.TACCTATCC	GACTAGCAT.TACCTATCC
GACTATTGA.CGCTTGTAG	GACTATTGA.CGCTTGTAG
GACTATTGA.GTACAATGC	GACTATTGA.GTACAATGC
GACTCAGTG.TACTGATGA	GACTCAGTG.TACTGATGA
GACTCTCAC.CCTTCGAGC	GACTCTCAC.CCTTCGAGC
GACTCTGGT.CTGTTACCA	GACTCTGGT.CTGTTACCA
GACTGCCTG.TCACGACAA	GACTGCCTG.TCACGACAA
GACTGCGCA.TATCGAGCC	GACTGCGCA.TATCGAGCC
GACTTCACC.GTTAATTCG	GACTTCACC.GTTAATTCG
GACTTCACC.TCAACACTC	GACTTCACC.TCAACACTC
GACTTGATT.GCACTGGAT	GACTTGATT.GCACTGGAT
GACTTGATT.TCTCAGGAT	GACTTGATT.TCTCAGGAT
GAGAATCAG.GTGTTGGAA	GAGAATCAG.GTGTTGGAA
GAGACATTG.CTGTTACCA	GAGACATTG.CTGTTACCA
GAGACTCGA.AATCGCCAT	GAGACTCGA.AATCGCCAT
GAGACTCGA.ACGACATCT	GAGACTCGA.ACGACATCT
GAGACTCGA.GTGACTCTC	GAGACTCGA.GTGACTCTC
GAGACTCGA.TCTAGCTGG	GAGACTCGA.TCTAGCTGG
GAGACTCGA.TCTAGTGAC	GAGACTCGA.TCTAGTGAC
GAGATACAC.CACGCGTAA	GAGATACAC.CACGCGTAA
GAGATACAC.GATGCAGAA	GAGATACAC.GATGCAGAA
GAGATTCCT.CGCACTCTT	GAGATTCCT.CGCACTCTT
GAGATTCCT.GCCATCGCT	GAGATTCCT.GCCATCGCT
GAGCACATT.CAGTGCTGC	GAGCACATT.CAGTGCTGC
GAGCAGGAA.AGCCACTTC	GAGCAGGAA.AGCCACTTC
GAGCAGGAA.GCGCTAGAA	GAGCAGGAA.GCGCTAGAA
GAGCGACTC.AACAGATCG	GAGCGACTC.AACAGATCG
GAGCTCTCA.ACCTTGAAG	GAGCTCTCA.ACCTTGAAG
GAGGTCACG.AGTGAACGG	GAGGTCACG.AGTGAACGG
GAGGTCCTT.TGACCTCCT	GAGGTCCTT.TGACCTCCT
GAGGTGAGC.CTTGATCTA	GAGGTGAGC.CTTGATCTA
GAGTATCGC.CTTAACAGC	GAGTATCGC.CTTAACAGC
GAGTCAAGG.TCCAGCAGC	GAGTCAAGG.TCCAGCAGC
GAGTCGTAC.CCTAGTTAG	GAGTCGTAC.CCTAGTTAG
GAGTGCATA.TTACTAGTC	GAGTGCATA.TTACTAGTC
GAGTGTGCC.CTATAGCTC	GAGTGTGCC.CTATAGCTC
GAGTTAACT.ACGACGATT	GAGTTAACT.ACGACGATT
GAGTTAACT.CTTCACTGT	GAGTTAACT.CTTCACTGT
GAGTTAACT.TTAGCGTCT	GAGTTAACT.TTAGCGTCT
GAGTTATAG.CTTGCGACC	GAGTTATAG.CTTGCGACC
GATAAGCTG.TCCTTCGTA	GATAAGCTG.TCCTTCGTA
GATACTGTG.CTGGTCGGT	GATACTGTG.CTGGTCGGT
GATACTGTG.GAACAACCA	GATACTGTG.GAACAACCA
GATACTGTG.GTAACTCAT	GATACTGTG.GTAACTCAT
GATAGTTCT.ATCAAGAGA	GATAGTTCT.ATCAAGAGA
GATAGTTCT.TTCCTTGAC	GATAGTTCT.TTCCTTGAC
GATCGATAC.CCACGTTCT	GATCGATAC.CCACGTTCT
GATCGATAC.CGCAATCGA	GATCGATAC.CGCAATCGA
GATCGCACT.CAGCGACGT	GATCGCACT.CAGCGACGT
GATCGCACT.GCACCATCG	GATCGCACT.GCACCATCG
GATCGCGAA.CCGCTATCC	GATCGCGAA.CCGCTATCC
GATCTGAAT.AATCTGACC	GATCTGAAT.AATCTGACC
GATCTGTTC.AGGTATTCC	GATCTGTTC.AGGTATTCC
GATCTGTTC.TGGTGGATC	GATCTGTTC.TGGTGGATC
GATCTTCGC.TGGACTGCC	GATCTTCGC.TGGACTGCC
GATGCAGAA.TCAATCTAG	GATGCAGAA.TCAATCTAG
GATGCGACG.CTTCGTGCA	GATGCGACG.CTTCGTGCA
GATGCGGTT.CGAGTAGCA	GATGCGGTT.CGAGTAGCA
GATGTAAGG.AGTCGATCA	GATGTAAGG.AGTCGATCA
GATGTCTAG.GGTAGACAT	GATGTCTAG.GGTAGACAT
GATGTTACA.CACCAGAAG	GATGTTACA.CACCAGAAG
GATTATGCG.GCTACAATG	GATTATGCG.GCTACAATG
GATTGAGTA.ATTATGCAG	GATTGAGTA.ATTATGCAG
GCAACCAAC.AGCAACATT	GCAACCAAC.AGCAACATT
GCAACTCGC.GTAGCATAC	GCAACTCGC.GTAGCATAC
GCAATGAGA.CATTGTTCA	GCAATGAGA.CATTGTTCA
GCACATGTT.CCGACTGTT	GCACATGTT.CCGACTGTT
GCACGCATT.AGACATCCA	GCACGCATT.AGACATCCA
GCACGTAGA.CTAGTTCCA	GCACGTAGA.CTAGTTCCA
GCAGCAGTG.ATCATAGAC	GCAGCAGTG.ATCATAGAC
GCAGCTTGA.GTGTCACAC	GCAGCTTGA.GTGTCACAC
GCATACATG.GCAGATCCG	GCATACATG.GCAGATCCG
GCATACTCC.GGAACCTAG	GCATACTCC.GGAACCTAG
GCATGTAAG.AATGCGTGC	GCATGTAAG.AATGCGTGC
GCATGTAAG.GTAACGCGA	GCATGTAAG.GTAACGCGA
GCATGTAAG.TCTTAGCGA	GCATGTAAG.TCTTAGCGA
GCATTGATC.TTACGGACC	GCATTGATC.TTACGGACC
GCCAACAAT.GCGACCTGT	GCCAACAAT.GCGACCTGT
GCCAACAAT.TCCTATTCC	GCCAACAAT.TCCTATTCC
GCCATACAA.TACCTATCC	GCCATACAA.TACCTATCC
GCCATCGCT.TATCCTCAG	GCCATCGCT.TATCCTCAG
GCCATTAAG.ACAAGTACA	GCCATTAAG.ACAAGTACA
GCCATTAAG.CACAACGCT	GCCATTAAG.CACAACGCT
GCCGAACCA.ACTCATTCA	GCCGAACCA.ACTCATTCA
GCCGAGTCT.CACCTTCCT	GCCGAGTCT.CACCTTCCT
GCCGAGTCT.TCACGACAA	GCCGAGTCT.TCACGACAA
GCCGCCTAA.CCGAATATG	GCCGCCTAA.CCGAATATG
GCCGCCTAA.GCCATCGCT	GCCGCCTAA.GCCATCGCT
GCCGCTATC.TCAGCTCAG	GCCGCTATC.TCAGCTCAG
GCCGTGAAC.CAGGATCAA	GCCGTGAAC.CAGGATCAA
GCCTGCATC.GCGGAGATT	GCCTGCATC.GCGGAGATT
GCCTTAGAG.TACGAGTGA	GCCTTAGAG.TACGAGTGA
GCCTTATCT.GGTTCGCAA	GCCTTATCT.GGTTCGCAA
GCCTTCCAT.TCCGGAGCT	GCCTTCCAT.TCCGGAGCT
GCCTTGTGA.TAGTTGACG	GCCTTGTGA.TAGTTGACG
GCGAACTCG.TGCAGCCTT	GCGAACTCG.TGCAGCCTT
GCGATGGTG.GTTAATTCG	GCGATGGTG.GTTAATTCG
GCGCTACCT.AAGCCACAC	GCGCTACCT.AAGCCACAC
GCGCTACCT.GATTCTCGG	GCGCTACCT.GATTCTCGG
GCGCTACCT.GTACAATGC	GCGCTACCT.GTACAATGC
GCGCTAGAA.TGGAGTGGA	GCGCTAGAA.TGGAGTGGA
GCGCTCTAT.GGAGTACAG	GCGCTCTAT.GGAGTACAG
GCGCTTCTC.TGAGTTAAG	GCGCTTCTC.TGAGTTAAG
GCGGAGATT.GGACTCCTT	GCGGAGATT.GGACTCCTT
GCGGTAGTC.CTGAGTCCA	GCGGTAGTC.CTGAGTCCA
GCGTAACAA.ACCTGTACC	GCGTAACAA.ACCTGTACC
GCGTCGTCT.CCTCGCGTT	GCGTCGTCT.CCTCGCGTT
GCGTCGTCT.TAGAGACTA	GCGTCGTCT.TAGAGACTA
GCGTCGTCT.TCATCAGAG	GCGTCGTCT.TCATCAGAG
GCTACAATG.AGAGGTGAA	GCTACAATG.AGAGGTGAA
GCTACCGAG.GCGCTTCTC	GCTACCGAG.GCGCTTCTC
GCTACCGAG.TATCGAGCC	GCTACCGAG.TATCGAGCC
GCTACCGAG.TTGATGAGT	GCTACCGAG.TTGATGAGT
GCTAGCTCC.AACTCCATG	GCTAGCTCC.AACTCCATG
GCTAGCTCC.AGAGCGCGA	GCTAGCTCC.AGAGCGCGA
GCTAGCTCC.CGCATCTAC	GCTAGCTCC.CGCATCTAC
GCTAGTGGA.AACGCCTAC	GCTAGTGGA.AACGCCTAC
GCTCAGCCA.CGTGACCAG	GCTCAGCCA.CGTGACCAG
GCTCCTAGC.AACGATGAC	GCTCCTAGC.AACGATGAC
GCTCTCCAA.GTAAGGTCC	GCTCTCCAA.GTAAGGTCC
GCTGACAGA.AGGTGTACA	GCTGACAGA.AGGTGTACA
GCTGACAGA.TGCCAATGG	GCTGACAGA.TGCCAATGG
GCTGTTCGG.AGCGTAGAA	GCTGTTCGG.AGCGTAGAA
GCTGTTCGG.CCTGACCTC	GCTGTTCGG.CCTGACCTC
GCTTACGTT.CTAGGTACT	GCTTACGTT.CTAGGTACT
GCTTACTAG.TAGCTGTTG	GCTTACTAG.TAGCTGTTG
GCTTACTAG.TCGTGACGT	GCTTACTAG.TCGTGACGT
GCTTAGAAC.TACGTTACC	GCTTAGAAC.TACGTTACC
GCTTAGAAC.TCTCAGGAT	GCTTAGAAC.TCTCAGGAT
GCTTCACTC.CATACGCAG	GCTTCACTC.CATACGCAG
GCTTCTGAA.GATGCTCCT	GCTTCTGAA.GATGCTCCT
GCTTGTCCT.CCTGTCGAC	GCTTGTCCT.CCTGTCGAC
GCTTGTCCT.CTTGGATCA	GCTTGTCCT.CTTGGATCA
GGAACCTAG.AATGCTGAT	GGAACCTAG.AATGCTGAT
GGAACCTAG.ATGGATATC	GGAACCTAG.ATGGATATC
GGAACTGCT.GACTTCACC	GGAACTGCT.GACTTCACC
GGAAGGTAT.ATCCGTCTC	GGAAGGTAT.ATCCGTCTC
GGAAGTATG.GTATGCCTT	GGAAGTATG.GTATGCCTT
GGAATTCAC.GAATCGAGA	GGAATTCAC.GAATCGAGA
GGAATTGGA.AGAGGTGAA	GGAATTGGA.AGAGGTGAA
GGAATTGGA.CGTCAGCAC	GGAATTGGA.CGTCAGCAC
GGACGAGCA.AAGGTGCTG	GGACGAGCA.AAGGTGCTG
GGACGAGCA.GTTGCATGG	GGACGAGCA.GTTGCATGG
GGACTATTC.ACTTGATCT	GGACTATTC.ACTTGATCT
GGACTATTC.AGATCGAGT	GGACTATTC.AGATCGAGT
GGACTCCTT.TCCAAGTAA	GGACTCCTT.TCCAAGTAA
GGAGCATCT.CTGTGGTGG	GGAGCATCT.CTGTGGTGG
GGAGCTCAA.AGTTGCCTT	GGAGCTCAA.AGTTGCCTT
GGAGTACAG.GTCTTCATA	GGAGTACAG.GTCTTCATA
GGATACAAT.GCCTGGAAT	GGATACAAT.GCCTGGAAT
GGATACAAT.GTCGTGTTA	GGATACAAT.GTCGTGTTA
GGATACCTA.CGAGTAGCA	GGATACCTA.CGAGTAGCA
GGATAGTCA.TCAGTAAGC	GGATAGTCA.TCAGTAAGC
GGATAGTCA.TTGTTAGAG	GGATAGTCA.TTGTTAGAG
GGATCAGGT.ACTTCTTGG	GGATCAGGT.ACTTCTTGG
GGATGCGAA.GGTGTTCAT	GGATGCGAA.GGTGTTCAT
GGATGCTCG.TATTACAGC	GGATGCTCG.TATTACAGC
GGATTACGC.AGTTACAAG	GGATTACGC.AGTTACAAG
GGATTACGC.TTACCTCTC	GGATTACGC.TTACCTCTC
GGATTCGTC.ACCACGGAT	GGATTCGTC.ACCACGGAT
GGATTCGTC.CACCTCGGA	GGATTCGTC.CACCTCGGA
GGTAACTAC.ACCGTCCTA	GGTAACTAC.ACCGTCCTA
GGTAACTAC.GGTACGAGC	GGTAACTAC.GGTACGAGC
GGTAAGTGA.ACCTAGTTA	GGTAAGTGA.ACCTAGTTA
GGTACGAGC.CTGTGCTCA	GGTACGAGC.CTGTGCTCA
GGTACTTCC.GCGGTAGTC	GGTACTTCC.GCGGTAGTC
GGTAGACAT.GCACGTAGA	GGTAGACAT.GCACGTAGA
GGTAGTGTT.GTGAATGCC	GGTAGTGTT.GTGAATGCC
GGTCCTAAG.GCGTGATAC	GGTCCTAAG.GCGTGATAC
GGTCCTAAG.TCGATTCAG	GGTCCTAAG.TCGATTCAG
GGTCCTGGT.ATCACCGCA	GGTCCTGGT.ATCACCGCA
GGTCCTGGT.TTCACTGGA	GGTCCTGGT.TTCACTGGA
GGTCTCATG.TACCGATTG	GGTCTCATG.TACCGATTG
GGTCTTGCA.CAAGCCTCG	GGTCTTGCA.CAAGCCTCG
GGTCTTGCA.TACCTCCTC	GGTCTTGCA.TACCTCCTC
GGTGAGTTC.GCCAATGAA	GGTGAGTTC.GCCAATGAA
GGTGTGACC.GACCGTAGT	GGTGTGACC.GACCGTAGT
GGTGTTCAT.GCAGCTTGA	GGTGTTCAT.GCAGCTTGA
GGTTACGCA.TCGTCCGAT	GGTTACGCA.TCGTCCGAT
GGTTCTATC.CTAGAGGTA	GGTTCTATC.CTAGAGGTA
GGTTCTATC.GGTGCGTAG	GGTTCTATC.GGTGCGTAG
GGTTCTATC.TGCATCGGA	GGTTCTATC.TGCATCGGA
GTAACGCGA.AGCTGCACT	GTAACGCGA.AGCTGCACT
GTAACGCGA.TGGAACTAA	GTAACGCGA.TGGAACTAA
GTAAGGTCC.AGGTGCGAG	GTAAGGTCC.AGGTGCGAG
GTAAGGTCC.ATGTGAGAC	GTAAGGTCC.ATGTGAGAC
GTAAGGTCC.GGTAACTAC	GTAAGGTCC.GGTAACTAC
GTAAGTGAG.ACGATGACC	GTAAGTGAG.ACGATGACC
GTAATCAGC.CCACGGATC	GTAATCAGC.CCACGGATC
GTAATCAGC.GGTAGTGTT	GTAATCAGC.GGTAGTGTT
GTACCACAA.AATACGTCT	GTACCACAA.AATACGTCT
GTACCACAA.TATGCCTTC	GTACCACAA.TATGCCTTC
GTACCTAAC.TGAGTTAAG	GTACCTAAC.TGAGTTAAG
GTACGAACG.ACAACGAGC	GTACGAACG.ACAACGAGC
GTACGCGAT.GCTCAGCCA	GTACGCGAT.GCTCAGCCA
GTACGCGAT.TCGCAAGCA	GTACGCGAT.TCGCAAGCA
GTAGAAGTT.CCGACTTGG	GTAGAAGTT.CCGACTTGG
GTAGCCTTG.AGGTACCAA	GTAGCCTTG.AGGTACCAA
GTAGCTACA.AATACGTCT	GTAGCTACA.AATACGTCT
GTAGTGGAG.ATCACTTCC	GTAGTGGAG.ATCACTTCC
GTATACAGA.CCATTACAG	GTATACAGA.CCATTACAG
GTATGCCTT.ACCATTCAC	GTATGCCTT.ACCATTCAC
GTATGCCTT.CACATTCTG	GTATGCCTT.CACATTCTG
GTATGCCTT.CGTCTGCTG	GTATGCCTT.CGTCTGCTG
GTATGCCTT.GCTTACTAG	GTATGCCTT.GCTTACTAG
GTATGTATC.CTCATGCCA	GTATGTATC.CTCATGCCA
GTCACAGAG.TCGCATTCG	GTCACAGAG.TCGCATTCG
GTCACTATG.TGGAGAACC	GTCACTATG.TGGAGAACC
GTCAGACCG.GCACCATCG	GTCAGACCG.GCACCATCG
GTCAGCGTC.GTGACTCTC	GTCAGCGTC.GTGACTCTC
GTCATTCTA.AACTGCGAC	GTCATTCTA.AACTGCGAC
GTCATTCTA.ATTCGAAGA	GTCATTCTA.ATTCGAAGA
GTCCACAAC.ATACCGCTT	GTCCACAAC.ATACCGCTT
GTCCACAAC.CACATATCA	GTCCACAAC.CACATATCA
GTCCGTAAG.TAGCCTTGT	GTCCGTAAG.TAGCCTTGT
GTCCTAGTT.ATGCGGATT	GTCCTAGTT.ATGCGGATT
GTCCTAGTT.CTTACCTAG	GTCCTAGTT.CTTACCTAG
GTCCTTCAT.ACTCTCACA	GTCCTTCAT.ACTCTCACA
GTCCTTCAT.AGCCTCGCA	GTCCTTCAT.AGCCTCGCA
GTCCTTCAT.CAGCTTACC	GTCCTTCAT.CAGCTTACC
GTCGACATT.CCTTAATTC	GTCGACATT.CCTTAATTC
GTCGCAGGT.TTGGAGAAC	GTCGCAGGT.TTGGAGAAC
GTCGTTAGA.ACCATTCAC	GTCGTTAGA.ACCATTCAC
GTCGTTGCG.AGACATCCA	GTCGTTGCG.AGACATCCA
GTCTACCAA.TGTGCCATG	GTCTACCAA.TGTGCCATG
GTCTCTTCA.GCGTTCAGA	GTCTCTTCA.GCGTTCAGA
GTCTTATGC.CACCTACGC	GTCTTATGC.CACCTACGC
GTCTTCTCG.AGGATCTCA	GTCTTCTCG.AGGATCTCA
GTGACTCTC.TCACTACGT	GTGACTCTC.TCACTACGT
GTGACTCTC.TGATTGTGC	GTGACTCTC.TGATTGTGC
GTGATGTGC.GCAGGAGAA	GTGATGTGC.GCAGGAGAA
GTGCACGAG.ATTCGAAGA	GTGCACGAG.ATTCGAAGA
GTGCACGAG.CCTCGGTCA	GTGCACGAG.CCTCGGTCA
GTGCACGAG.CTTCGTGCA	GTGCACGAG.CTTCGTGCA
GTGCCATGA.ATATAGCGT	GTGCCATGA.ATATAGCGT
GTGCCATGA.GATGCTCCT	GTGCCATGA.GATGCTCCT
GTGCCATGA.TATTGCTAC	GTGCCATGA.TATTGCTAC
GTGCTGACT.ATCTGGTAG	GTGCTGACT.ATCTGGTAG
GTGGACTGG.CGTAATGAC	GTGGACTGG.CGTAATGAC
GTGGAGGTC.AATCGTGTT	GTGGAGGTC.AATCGTGTT
GTGTACCGT.GCCATCGCT	GTGTACCGT.GCCATCGCT
GTGTATCTG.GGTTGCTAT	GTGTATCTG.GGTTGCTAT
GTGTCGAGC.GGTCGGATA	GTGTCGAGC.GGTCGGATA
GTGTCTGGA.CTGTGCTCA	GTGTCTGGA.CTGTGCTCA
GTGTCTGGA.GTGAATGCC	GTGTCTGGA.GTGAATGCC
GTGTTCCAG.TGCAACTCT	GTGTTCCAG.TGCAACTCT
GTTAATTCG.CCTTAATTC	GTTAATTCG.CCTTAATTC
GTTAGTCAA.TAGCACACG	GTTAGTCAA.TAGCACACG
GTTATCGAT.GTCGTTGCG	GTTATCGAT.GTCGTTGCG
GTTCACTCC.ACACACCGT	GTTCACTCC.ACACACCGT
GTTCACTCC.ACATCGTCC	GTTCACTCC.ACATCGTCC
GTTCCAACA.TCTAGGATG	GTTCCAACA.TCTAGGATG
GTTGCATGG.ACCACGGAT	GTTGCATGG.ACCACGGAT
GTTGCATGG.GACACGCAA	GTTGCATGG.GACACGCAA
TAACACATC.GGATAGTCA	TAACACATC.GGATAGTCA
TAACACATC.TTATGAGGA	TAACACATC.TTATGAGGA
TAACCGTGA.CTGTACGAC	TAACCGTGA.CTGTACGAC
TAACCGTGA.GTATCCTGC	TAACCGTGA.GTATCCTGC
TAACTCCGA.AGATGAAGA	TAACTCCGA.AGATGAAGA
TAAGCCATT.AGCATTCCA	TAAGCCATT.AGCATTCCA
TAAGCCATT.TGAGTGACT	TAAGCCATT.TGAGTGACT
TAAGGTGAT.CAACCGGTC	TAAGGTGAT.CAACCGGTC
TAAGGTGAT.GCTCTGTGT	TAAGGTGAT.GCTCTGTGT
TAATCTGGA.AACCATGGT	TAATCTGGA.AACCATGGT
TAATTCGTG.TACGTTACC	TAATTCGTG.TACGTTACC
TACAAGAGG.TGCGCTGCA	TACAAGAGG.TGCGCTGCA
TACAGGACT.ACCATCTAA	TACAGGACT.ACCATCTAA
TACAGGACT.CCTCTCTAG	TACAGGACT.CCTCTCTAG
TACATGCAC.CCAACAACA	TACATGCAC.CCAACAACA
TACATGCAC.TACAGGACT	TACATGCAC.TACAGGACT
TACCATGTA.GTTCAGAAG	TACCATGTA.GTTCAGAAG
TACCATGTA.TAGACCTAC	TACCATGTA.TAGACCTAC
TACCGATTG.ACATCGTCC	TACCGATTG.ACATCGTCC
TACCGCGTT.TCGTTCTCC	TACCGCGTT.TCGTTCTCC
TACCTCACT.AGCGACACC	TACCTCACT.AGCGACACC
TACCTCACT.CCAGCCAAT	TACCTCACT.CCAGCCAAT
TACCTCACT.GGTCTTGCA	TACCTCACT.GGTCTTGCA
TACGACTTG.ATAGTCAGT	TACGACTTG.ATAGTCAGT
TACGTTACC.CGTGTGTGG	TACGTTACC.CGTGTGTGG
TACTACTGT.TCCACCGGT	TACTACTGT.TCCACCGGT
TACTTACCA.AGGATTACT	TACTTACCA.AGGATTACT
TACTTACCA.TCCAGCTAT	TACTTACCA.TCCAGCTAT
TAGACCGCA.CGATCCAGA	TAGACCGCA.CGATCCAGA
TAGACCTAC.CAGCACGTG	TAGACCTAC.CAGCACGTG
