TGGTAACCA.CTCAGCTGG	TGGTAACCA.CTCAGCTGG
TGGTAACCA.TCCATCATT	TGGTAACCA.TCCATCATT
TGGTAGCAG.ACTAAGTTC	TGGTAGCAG.ACTAAGTTC
TGGTAGCAG.AGCCACTTC	TGGTAGCAG.AGCCACTTC
TGGTAGCAG.CAACCGGTC	TGGTAGCAG.CAACCGGTC
TGGTAGCAG.CCACGCCAT	TGGTAGCAG.CCACGCCAT
TGGTAGCAG.GCCTTATCT	TGGTAGCAG.GCCTTATCT
TGGTAGCAG.GTCGTGTTA	TGGTAGCAG.GTCGTGTTA
TGGTAGCAG.TACACGGTC	TGGTAGCAG.TACACGGTC
TGGTCCTAG.ACGGTGCCT	TGGTCCTAG.ACGGTGCCT
TGGTCCTAG.CAAGTCGAA	TGGTCCTAG.CAAGTCGAA
TGGTCCTAG.TCGGATGTT	TGGTCCTAG.TCGGATGTT
TGGTCCTAG.TGATGTGTG	TGGTCCTAG.TGATGTGTG
TGGTCGCTA.AGCATATGG	TGGTCGCTA.AGCATATGG
TGGTCGCTA.AGTGACGAT	TGGTCGCTA.AGTGACGAT
TGGTCGCTA.CAGAGCACC	TGGTCGCTA.CAGAGCACC
TGGTCGCTA.TAATCACGC	TGGTCGCTA.TAATCACGC
TGGTCTACG.CGTGGTACC	TGGTCTACG.CGTGGTACC
TGGTCTACG.TCACCGAGG	TGGTCTACG.TCACCGAGG
TGGTCTACG.TTGATGAGT	TGGTCTACG.TTGATGAGT
TGGTGCCTG.CCTGCAGAT	TGGTGCCTG.CCTGCAGAT
TGGTGGATC.ATAGTCAGT	TGGTGGATC.ATAGTCAGT
TGGTGGATC.ATGACACAA	TGGTGGATC.ATGACACAA
TGGTGGATC.CAGCTCTTC	TGGTGGATC.CAGCTCTTC
TGGTGGATC.CGAAGAGGT	TGGTGGATC.CGAAGAGGT
TGGTGGATC.GTCGTTGCG	TGGTGGATC.GTCGTTGCG
TGGTGGTAA.CGGAAGACG	TGGTGGTAA.CGGAAGACG
TGGTTATAC.ACACACCGT	TGGTTATAC.ACACACCGT
TGGTTATAC.CATAGGTGT	TGGTTATAC.CATAGGTGT
TGGTTATAC.CCTTAACAT	TGGTTATAC.CCTTAACAT
TGGTTATAC.GTGAATGCC	TGGTTATAC.GTGAATGCC
TGTAACAGT.GATGCAGAA	TGTAACAGT.GATGCAGAA
TGTAACAGT.GCTTCACTC	TGTAACAGT.GCTTCACTC
TGTAACAGT.GTGCATCAA	TGTAACAGT.GTGCATCAA
TGTACACGA.AATCTGACC	TGTACACGA.AATCTGACC
TGTACACGA.ATGAACTAG	TGTACACGA.ATGAACTAG
TGTACACGA.CGTACACAC	TGTACACGA.CGTACACAC
TGTACACGA.TGATCTCGG	TGTACACGA.TGATCTCGG
TGTAGATCG.CCATATGCC	TGTAGATCG.CCATATGCC
TGTAGATCG.GCACGCATT	TGTAGATCG.GCACGCATT
TGTAGATCG.GTCAACTGA	TGTAGATCG.GTCAACTGA
TGTAGCAAG.AACAACCTA	TGTAGCAAG.AACAACCTA
TGTAGCAAG.AACCATGGT	TGTAGCAAG.AACCATGGT
TGTAGCAAG.GCTGTTCGG	TGTAGCAAG.GCTGTTCGG
TGTAGCAAG.GTCGTGTTA	TGTAGCAAG.GTCGTGTTA
TGTAGCAAG.TTGCGAACA	TGTAGCAAG.TTGCGAACA
TGTAGGTTA.ATCCGACCA	TGTAGGTTA.ATCCGACCA
TGTAGGTTA.CATCTCGAT	TGTAGGTTA.CATCTCGAT
TGTAGGTTA.TGTCATAGC	TGTAGGTTA.TGTCATAGC
TGTATCGTG.TTCAACTAC	TGTATCGTG.TTCAACTAC
TGTATGTAG.CAGTTACTG	TGTATGTAG.CAGTTACTG
TGTATGTAG.GTGACTCTC	TGTATGTAG.GTGACTCTC
TGTCAACCT.AACGGTAGC	TGTCAACCT.AACGGTAGC
TGTCAACCT.ACTCGTAGG	TGTCAACCT.ACTCGTAGG
TGTCAACCT.CAAGAGGAG	TGTCAACCT.CAAGAGGAG
TGTCAACCT.CCTCTCTAG	TGTCAACCT.CCTCTCTAG
TGTCAACCT.GCAACTCGC	TGTCAACCT.GCAACTCGC
TGTCAACCT.GCATACATG	TGTCAACCT.GCATACATG
TGTCAACCT.TGCGATACT	TGTCAACCT.TGCGATACT
TGTCACATA.GACTTCACC	TGTCACATA.GACTTCACC
TGTCATAGC.AGTATGACG	TGTCATAGC.AGTATGACG
TGTCATAGC.ATACTTGCT	TGTCATAGC.ATACTTGCT
TGTCATAGC.ATAGCTTGC	TGTCATAGC.ATAGCTTGC
TGTCATAGC.CTGGAGCGA	TGTCATAGC.CTGGAGCGA
TGTCATAGC.GGTTAGATG	TGTCATAGC.GGTTAGATG
TGTCATAGC.TTCATCCAA	TGTCATAGC.TTCATCCAA
TGTCCATAG.ATAGAGCAG	TGTCCATAG.ATAGAGCAG
TGTCCATAG.CGAGTAGCA	TGTCCATAG.CGAGTAGCA
TGTCGTACA.GAATCAACC	TGTCGTACA.GAATCAACC
TGTCGTACA.TCGTACCTT	TGTCGTACA.TCGTACCTT
TGTCGTGAG.AGAGCGGAG	TGTCGTGAG.AGAGCGGAG
TGTCGTGAG.GTCTGACGT	TGTCGTGAG.GTCTGACGT
TGTCGTGAG.TATTCAACG	TGTCGTGAG.TATTCAACG
TGTCTACAC.AGGATGCGT	TGTCTACAC.AGGATGCGT
TGTCTACAC.AGTGAACGG	TGTCTACAC.AGTGAACGG
TGTCTACAC.GCCGCCTAA	TGTCTACAC.GCCGCCTAA
TGTGAGTAT.CGACCTGTA	TGTGAGTAT.CGACCTGTA
TGTGAGTAT.CGGAATGCA	TGTGAGTAT.CGGAATGCA
TGTGAGTAT.CTCGCAAGA	TGTGAGTAT.CTCGCAAGA
TGTGAGTAT.GGTGCGTAG	TGTGAGTAT.GGTGCGTAG
TGTGCAGTA.ATCACCGCA	TGTGCAGTA.ATCACCGCA
TGTGCAGTA.GATGCGACG	TGTGCAGTA.GATGCGACG
TGTGCAGTA.GCGCTACCT	TGTGCAGTA.GCGCTACCT
TGTGCCATG.ACTGGTCAG	TGTGCCATG.ACTGGTCAG
TGTGCCATG.ATGAACTAG	TGTGCCATG.ATGAACTAG
TGTGCCATG.CATTGCAGA	TGTGCCATG.CATTGCAGA
TGTGCCATG.CGTTCCATT	TGTGCCATG.CGTTCCATT
TGTGCCATG.TAAGGTGAT	TGTGCCATG.TAAGGTGAT
TGTGCTAAC.AGTTGTGTA	TGTGCTAAC.AGTTGTGTA
TGTGCTAAC.CCGCAATGG	TGTGCTAAC.CCGCAATGG
TGTGCTAAC.CTCTAAGAG	TGTGCTAAC.CTCTAAGAG
TGTGCTAAC.TCTACATCC	TGTGCTAAC.TCTACATCC
TGTGGACAA.CCATGCGTC	TGTGGACAA.CCATGCGTC
TGTGGACAA.TCCAACGTG	TGTGGACAA.TCCAACGTG
TGTGGTCCT.CCAGATCAC	TGTGGTCCT.CCAGATCAC
TGTGGTCCT.CTCCAGCGT	TGTGGTCCT.CTCCAGCGT
TGTGGTCCT.CTCGTGTCC	TGTGGTCCT.CTCGTGTCC
TGTGTAGAG.ACATGGATT	TGTGTAGAG.ACATGGATT
TGTGTAGAG.GACGTTCAG	TGTGTAGAG.GACGTTCAG
TGTGTAGAG.GCCGTGAAC	TGTGTAGAG.GCCGTGAAC
TGTGTAGAG.TATAATCGC	TGTGTAGAG.TATAATCGC
TGTGTCTAC.CCATATCTT	TGTGTCTAC.CCATATCTT
TGTGTCTAC.CTTCGACTG	TGTGTCTAC.CTTCGACTG
TGTTAAGCC.ACTCGTCTA	TGTTAAGCC.ACTCGTCTA
TGTTAAGCC.AGGATTGAG	TGTTAAGCC.AGGATTGAG
TGTTAAGCC.TGCTTACGG	TGTTAAGCC.TGCTTACGG
TGTTACTGA.TCTAATACC	TGTTACTGA.TCTAATACC
TGTTGTCGA.AGGTACCAA	TGTTGTCGA.AGGTACCAA
TGTTGTCGA.CCGATCAGC	TGTTGTCGA.CCGATCAGC
TGTTGTCGA.GACCGCTTC	TGTTGTCGA.GACCGCTTC
TGTTGTCGA.TCGATTCAG	TGTTGTCGA.TCGATTCAG
TTAACGGAG.AGAGCGCGA	TTAACGGAG.AGAGCGCGA
TTAACGGAG.AGCTTGGTG	TTAACGGAG.AGCTTGGTG
TTAACGGAG.ATTAAGACC	TTAACGGAG.ATTAAGACC
TTAACGGAG.GCTACAATG	TTAACGGAG.GCTACAATG
TTAACGGAG.TGACGGTTG	TTAACGGAG.TGACGGTTG
TTAACGTTC.CTGTGGTGG	TTAACGTTC.CTGTGGTGG
TTAACGTTC.GTGCTCTTG	TTAACGTTC.GTGCTCTTG
TTAACGTTC.TCACTACGT	TTAACGTTC.TCACTACGT
TTAAGTGGT.CAGTCTAAC	TTAAGTGGT.CAGTCTAAC
TTAAGTGGT.GTACGCGAT	TTAAGTGGT.GTACGCGAT
TTAAGTGGT.GTCTCCAGG	TTAAGTGGT.GTCTCCAGG
TTAAGTGGT.TCACTCGCT	TTAAGTGGT.TCACTCGCT
TTACACCTT.ACCTAGCAC	TTACACCTT.ACCTAGCAC
TTACACCTT.CACCAAGAT	TTACACCTT.CACCAAGAT
TTACACCTT.GATCGCACT	TTACACCTT.GATCGCACT
TTACAGTGT.AGCCAGGAC	TTACAGTGT.AGCCAGGAC
TTACAGTGT.AGGTGTACA	TTACAGTGT.AGGTGTACA
TTACAGTGT.TTGTTAGAG	TTACAGTGT.TTGTTAGAG
TTACCTCTC.GAAGTGTGA	TTACCTCTC.GAAGTGTGA
TTACCTCTC.GTCAGTTGT	TTACCTCTC.GTCAGTTGT
TTACCTCTC.TCAATGGAC	TTACCTCTC.TCAATGGAC
TTACCTCTC.TTCCATACC	TTACCTCTC.TTCCATACC
TTACGCTCG.AGTGAACGG	TTACGCTCG.AGTGAACGG
TTACGCTCG.GGTAGACAT	TTACGCTCG.GGTAGACAT
TTACGCTCG.TACTACTGT	TTACGCTCG.TACTACTGT
TTACGGACC.AGTATGACG	TTACGGACC.AGTATGACG
TTACGGACC.CTCTGCAAG	TTACGGACC.CTCTGCAAG
TTACGGACC.GCGTGAGCT	TTACGGACC.GCGTGAGCT
TTACGGACC.TAATGTAGC	TTACGGACC.TAATGTAGC
TTACTAGTC.CGATTCGAG	TTACTAGTC.CGATTCGAG
TTACTAGTC.CTTGATCTA	TTACTAGTC.CTTGATCTA
TTACTAGTC.GGTGTTCAT	TTACTAGTC.GGTGTTCAT
TTACTAGTC.TAGTAACGG	TTACTAGTC.TAGTAACGG
TTACTTACG.AAGAGAACT	TTACTTACG.AAGAGAACT
TTACTTACG.CGCATAACT	TTACTTACG.CGCATAACT
TTACTTACG.GACCACTCG	TTACTTACG.GACCACTCG
TTAGATCGG.AGTATGACG	TTAGATCGG.AGTATGACG
TTAGATCGG.GGATCAATG	TTAGATCGG.GGATCAATG
TTAGATCGG.GTGGTTACC	TTAGATCGG.GTGGTTACC
TTAGATCGG.TCTGATGAA	TTAGATCGG.TCTGATGAA
TTAGCGTCT.ACGTCTATG	TTAGCGTCT.ACGTCTATG
TTAGCGTCT.CAGCTTCGA	TTAGCGTCT.CAGCTTCGA
TTAGCGTCT.CCATACGAT	TTAGCGTCT.CCATACGAT
TTAGCGTCT.TGCCAATGG	TTAGCGTCT.TGCCAATGG
TTAGCGTCT.TTGCAGTCA	TTAGCGTCT.TTGCAGTCA
TTAGGAAGG.ACCGTACGC	TTAGGAAGG.ACCGTACGC
TTAGGAAGG.ATCAGGATG	TTAGGAAGG.ATCAGGATG
TTAGGAAGG.ATGTGAGAC	TTAGGAAGG.ATGTGAGAC
TTAGGAAGG.CTTCGTGCA	TTAGGAAGG.CTTCGTGCA
TTAGGAAGG.GCTACCGAG	TTAGGAAGG.GCTACCGAG
TTAGGAAGG.TAGAGCCAG	TTAGGAAGG.TAGAGCCAG
TTAGGAAGG.TCTACGCAA	TTAGGAAGG.TCTACGCAA
TTAGGAAGG.TTCTGAATG	TTAGGAAGG.TTCTGAATG
TTAGTCGGA.AACAACTGG	TTAGTCGGA.AACAACTGG
TTAGTCGGA.ACTGCTAGT	TTAGTCGGA.ACTGCTAGT
TTAGTCGGA.ATTCCGTAC	TTAGTCGGA.ATTCCGTAC
TTAGTCGGA.CAGATCATT	TTAGTCGGA.CAGATCATT
TTAGTCGGA.GAACATGAC	TTAGTCGGA.GAACATGAC
TTAGTCGGA.GAGCCATCC	TTAGTCGGA.GAGCCATCC
TTAGTCGGA.GGACTCCTT	TTAGTCGGA.GGACTCCTT
TTAGTCGGA.GTAGCCTTG	TTAGTCGGA.GTAGCCTTG
TTATCCAAG.GGTAAGTGA	TTATCCAAG.GGTAAGTGA
TTATCCAAG.GTTGCTCAG	TTATCCAAG.GTTGCTCAG
TTATCCAAG.TAAGTACAC	TTATCCAAG.TAAGTACAC
TTATCCAAG.TATCCTCAG	TTATCCAAG.TATCCTCAG
TTATCCAAG.TTCCAGATT	TTATCCAAG.TTCCAGATT
TTATCGCAC.AATATCGCT	TTATCGCAC.AATATCGCT
TTATCGCAC.AGTTGAGCG	TTATCGCAC.AGTTGAGCG
TTATCGCAC.ATGGAGAGT	TTATCGCAC.ATGGAGAGT
TTATCGCAC.CCAACAACA	TTATCGCAC.CCAACAACA
TTATCGCAC.CCACTACCA	TTATCGCAC.CCACTACCA
TTATCGCAC.TACTTACCA	TTATCGCAC.TACTTACCA
TTATTCGAC.AACGGTAGC	TTATTCGAC.AACGGTAGC
TTATTCGAC.CTTCCGTGG	TTATTCGAC.CTTCCGTGG
TTCAACTAC.ACAATTCGG	TTCAACTAC.ACAATTCGG
TTCAACTAC.AGGATTACT	TTCAACTAC.AGGATTACT
TTCAACTAC.ATCTGCGTA	TTCAACTAC.ATCTGCGTA
TTCAACTAC.CAGAGCACC	TTCAACTAC.CAGAGCACC
TTCAACTAC.CATAGGTGT	TTCAACTAC.CATAGGTGT
TTCAACTAC.TTATCCAAG	TTCAACTAC.TTATCCAAG
TTCACCTTG.ATCAGAAGC	TTCACCTTG.ATCAGAAGC
TTCACCTTG.CAACGTCTT	TTCACCTTG.CAACGTCTT
TTCACCTTG.GTAACGCGA	TTCACCTTG.GTAACGCGA
TTCACCTTG.TGACAAGTT	TTCACCTTG.TGACAAGTT
TTCACTCCT.ACTCCAACT	TTCACTCCT.ACTCCAACT
TTCACTCCT.AGATGAAGA	TTCACTCCT.AGATGAAGA
TTCACTCCT.GCAGGAGAA	TTCACTCCT.GCAGGAGAA
TTCACTCCT.GCCGTCTTC	TTCACTCCT.GCCGTCTTC
TTCACTCCT.GCTGAGCAG	TTCACTCCT.GCTGAGCAG
TTCACTCCT.GTCTTATGC	TTCACTCCT.GTCTTATGC
TTCACTCCT.TCGGAACGA	TTCACTCCT.TCGGAACGA
TTCAGTGCC.GCGTTCAGA	TTCAGTGCC.GCGTTCAGA
TTCAGTGCC.GCTACAATG	TTCAGTGCC.GCTACAATG
TTCATCCAA.ATAAGTTCG	TTCATCCAA.ATAAGTTCG
TTCATCCAA.ATCCACAGT	TTCATCCAA.ATCCACAGT
TTCATCCAA.CCTGTCGAC	TTCATCCAA.CCTGTCGAC
TTCATCCAA.GGTAGCATC	TTCATCCAA.GGTAGCATC
TTCATTCGC.CGAACAATC	TTCATTCGC.CGAACAATC
TTCATTCGC.GGACGAGCA	TTCATTCGC.GGACGAGCA
TTCCAATTC.AACCATGGT	TTCCAATTC.AACCATGGT
TTCCAATTC.TCCAAGTAA	TTCCAATTC.TCCAAGTAA
TTCCAATTC.TGATACCGT	TTCCAATTC.TGATACCGT
TTCCAGATT.AAGTAGGAC	TTCCAGATT.AAGTAGGAC
TTCCAGATT.ATCTCTGCT	TTCCAGATT.ATCTCTGCT
TTCCAGATT.GATTGGAAG	TTCCAGATT.GATTGGAAG
TTCCAGATT.TTCAACTAC	TTCCAGATT.TTCAACTAC
TTCCAGGAG.AGCTTCGAT	TTCCAGGAG.AGCTTCGAT
TTCCAGGAG.AGTCATACT	TTCCAGGAG.AGTCATACT
TTCCAGGAG.GCTTCTGAA	TTCCAGGAG.GCTTCTGAA
TTCCAGGAG.GGATTCGTC	TTCCAGGAG.GGATTCGTC
TTCCAGGAG.GTGGAGGTC	TTCCAGGAG.GTGGAGGTC
TTCCATACC.CCTAGCAAT	TTCCATACC.CCTAGCAAT
TTCCATACC.TAGCGCAGC	TTCCATACC.TAGCGCAGC
TTCCATACC.TCCAGAACG	TTCCATACC.TCCAGAACG
TTCCGAGCG.ACGACTGCG	TTCCGAGCG.ACGACTGCG
TTCCGAGCG.CTCGTTCAC	TTCCGAGCG.CTCGTTCAC
TTCCGCCAG.AGTACTCTC	TTCCGCCAG.AGTACTCTC
TTCCGCCAG.CACGCGTAA	TTCCGCCAG.CACGCGTAA
TTCCGCCAG.CTGGTACAT	TTCCGCCAG.CTGGTACAT
TTCCGCCAG.GTAGGACGC	TTCCGCCAG.GTAGGACGC
TTCCGCCAG.GTCCGCTCA	TTCCGCCAG.GTCCGCTCA
TTCCGCCAG.TGCTCAGCG	TTCCGCCAG.TGCTCAGCG
TTCCTAAGG.AACGGAGAT	TTCCTAAGG.AACGGAGAT
TTCCTAAGG.CCTCGCGTT	TTCCTAAGG.CCTCGCGTT
TTCCTAAGG.GGATTCGTC	TTCCTAAGG.GGATTCGTC
TTCCTCGGT.ATGGTTCGA	TTCCTCGGT.ATGGTTCGA
TTCCTCGGT.CATGTCCTG	TTCCTCGGT.CATGTCCTG
TTCCTCGGT.GTTAATTCG	TTCCTCGGT.GTTAATTCG
TTCCTCGGT.TCGCTGATT	TTCCTCGGT.TCGCTGATT
TTCCTGCTA.ACGCTCTTA	TTCCTGCTA.ACGCTCTTA
TTCCTGCTA.AGGTGTACA	TTCCTGCTA.AGGTGTACA
TTCCTGCTA.ATATTCGCA	TTCCTGCTA.ATATTCGCA
TTCCTGCTA.CAACACCTA	TTCCTGCTA.CAACACCTA
TTCCTGCTA.CGTCTGCTG	TTCCTGCTA.CGTCTGCTG
TTCCTTGAC.ATGATAGCT	TTCCTTGAC.ATGATAGCT
TTCCTTGAC.CACGTAGAC	TTCCTTGAC.CACGTAGAC
TTCCTTGAC.CAGTATGAT	TTCCTTGAC.CAGTATGAT
TTCCTTGAC.CCATATGCC	TTCCTTGAC.CCATATGCC
TTCCTTGAC.CTATAGCTC	TTCCTTGAC.CTATAGCTC
TTCCTTGAC.CTTGCGACC	TTCCTTGAC.CTTGCGACC
TTCCTTGAC.GTGCTAAGC	TTCCTTGAC.GTGCTAAGC
TTCCTTGAC.TCAAGGAGT	TTCCTTGAC.TCAAGGAGT
TTCGCATCC.ACATTGACA	TTCGCATCC.ACATTGACA
TTCGCATCC.ACGCGTGAC	TTCGCATCC.ACGCGTGAC
TTCGCATCC.AGTATGACG	TTCGCATCC.AGTATGACG
TTCGCATCC.ATCCAGCTG	TTCGCATCC.ATCCAGCTG
TTCGCATCC.CATCGAAGC	TTCGCATCC.CATCGAAGC
TTCGCATCC.CATTGCAGA	TTCGCATCC.CATTGCAGA
TTCGCATCC.CCACGAAGG	TTCGCATCC.CCACGAAGG
TTCGCATCC.GACTGCGCA	TTCGCATCC.GACTGCGCA
TTCGCATCC.GTCTACCAA	TTCGCATCC.GTCTACCAA
TTCGCATCC.TAGACCATG	TTCGCATCC.TAGACCATG
TTCGCATCC.TTCCAGGAG	TTCGCATCC.TTCCAGGAG
TTCGGAGTC.AACAACTGG	TTCGGAGTC.AACAACTGG
TTCGGAGTC.ATGAGTGTG	TTCGGAGTC.ATGAGTGTG
TTCGGAGTC.CGTGGTACC	TTCGGAGTC.CGTGGTACC
TTCGTGATG.AACACACTC	TTCGTGATG.AACACACTC
TTCGTGATG.CGGATTCTC	TTCGTGATG.CGGATTCTC
TTCTCCACA.ACTGGACCA	TTCTCCACA.ACTGGACCA
TTCTCCACA.GTTACTACT	TTCTCCACA.GTTACTACT
TTCTGAATG.AGCCTCTAG	TTCTGAATG.AGCCTCTAG
TTCTGAATG.ATGGAGAGT	TTCTGAATG.ATGGAGAGT
TTCTGAATG.ATTCATGTG	TTCTGAATG.ATTCATGTG
TTCTGAATG.TAGATAGCC	TTCTGAATG.TAGATAGCC
TTCTGAATG.TCCTGTGGA	TTCTGAATG.TCCTGTGGA
TTCTGCCGA.ACTGTGTCA	TTCTGCCGA.ACTGTGTCA
TTCTGCCGA.ATAAGACAG	TTCTGCCGA.ATAAGACAG
TTCTGCCGA.CTCAGTGAT	TTCTGCCGA.CTCAGTGAT
TTCTGCCGA.TGCTCCTCC	TTCTGCCGA.TGCTCCTCC
TTCTGCCGA.TTGAGCTCT	TTCTGCCGA.TTGAGCTCT
TTCTGGTGC.AGCAAGTCC	TTCTGGTGC.AGCAAGTCC
TTCTGGTGC.CTCGCTACG	TTCTGGTGC.CTCGCTACG
TTCTGGTGC.GGTAGCATC	TTCTGGTGC.GGTAGCATC
TTCTGGTGC.GTGTCACAC	TTCTGGTGC.GTGTCACAC
TTCTGGTGC.TCTCGATGC	TTCTGGTGC.TCTCGATGC
TTGACCTGA.ACTCTGCTC	TTGACCTGA.ACTCTGCTC
TTGACCTGA.CGAGCTTAC	TTGACCTGA.CGAGCTTAC
TTGACCTGA.CGCATAACT	TTGACCTGA.CGCATAACT
TTGACCTGA.TAACGGATA	TTGACCTGA.TAACGGATA
TTGAGACGG.GTCACTATG	TTGAGACGG.GTCACTATG
TTGAGCTCT.ATATGCAGC	TTGAGCTCT.ATATGCAGC
TTGAGCTCT.ATGGAGGAA	TTGAGCTCT.ATGGAGGAA
TTGAGCTCT.CAGCTAGTT	TTGAGCTCT.CAGCTAGTT
TTGAGCTCT.CCGCACTCA	TTGAGCTCT.CCGCACTCA
TTGAGCTCT.GATACCGGA	TTGAGCTCT.GATACCGGA
TTGATCGTA.ACGCGTGAC	TTGATCGTA.ACGCGTGAC
TTGATCGTA.AGCTATATG	TTGATCGTA.AGCTATATG
TTGATCGTA.CACCTACGC	TTGATCGTA.CACCTACGC
TTGATCGTA.CCATACGAT	TTGATCGTA.CCATACGAT
TTGATCGTA.CTGAGGTTA	TTGATCGTA.CTGAGGTTA
TTGATCGTA.GTAGCTACA	TTGATCGTA.GTAGCTACA
TTGATGAGT.AATACTCCG	TTGATGAGT.AATACTCCG
TTGATGAGT.ATGCGTGGA	TTGATGAGT.ATGCGTGGA
TTGATGAGT.CCGTCCACT	TTGATGAGT.CCGTCCACT
TTGATGAGT.CTAGGTACT	TTGATGAGT.CTAGGTACT
TTGATGAGT.CTCCTGACG	TTGATGAGT.CTCCTGACG
TTGATGAGT.GGTTGCTAT	TTGATGAGT.GGTTGCTAT
TTGATGAGT.TAGACACGT	TTGATGAGT.TAGACACGT
TTGATGCTG.AACCGCTGA	TTGATGCTG.AACCGCTGA
TTGATGCTG.AGCAAGTCC	TTGATGCTG.AGCAAGTCC
TTGATGCTG.AGTGTTCTG	TTGATGCTG.AGTGTTCTG
TTGATGCTG.ATAGCACGG	TTGATGCTG.ATAGCACGG
TTGCAGTCA.AAGCATTGC	TTGCAGTCA.AAGCATTGC
TTGCAGTCA.ACAGAAGAG	TTGCAGTCA.ACAGAAGAG
TTGCAGTCA.GCCGTCTTC	TTGCAGTCA.GCCGTCTTC
TTGCCAGAT.ACCACGCTA	TTGCCAGAT.ACCACGCTA
TTGCCAGAT.CAACGATCG	TTGCCAGAT.CAACGATCG
TTGCCAGAT.CCAGGAGTT	TTGCCAGAT.CCAGGAGTT
TTGCCAGAT.GTGCTGACT	TTGCCAGAT.GTGCTGACT
TTGCCAGAT.TAGCCAGTG	TTGCCAGAT.TAGCCAGTG
TTGCCAGAT.TATTGACTG	TTGCCAGAT.TATTGACTG
TTGCCGTAG.CCACTTCGC	TTGCCGTAG.CCACTTCGC
TTGCCGTAG.CCTATTGGT	TTGCCGTAG.CCTATTGGT
TTGCCGTAG.GAGTATCGC	TTGCCGTAG.GAGTATCGC
TTGCGAACA.CAGCGTAAG	TTGCGAACA.CAGCGTAAG
TTGCGAACA.CTACTGTCA	TTGCGAACA.CTACTGTCA
TTGCGAACA.CTGGTCGGT	TTGCGAACA.CTGGTCGGT
TTGCGAACA.GCCTGCATC	TTGCGAACA.GCCTGCATC
TTGCGAACA.GTCAATACA	TTGCGAACA.GTCAATACA
TTGGACTTC.CACTGGTCC	TTGGACTTC.CACTGGTCC
TTGGACTTC.CATCGCTGG	TTGGACTTC.CATCGCTGG
TTGGACTTC.GTCTACCAA	TTGGACTTC.GTCTACCAA
TTGGACTTC.TAGGTTAGT	TTGGACTTC.TAGGTTAGT
TTGGAGAAC.ACGGACCAT	TTGGAGAAC.ACGGACCAT
TTGGAGAAC.GCATGTAAG	TTGGAGAAC.GCATGTAAG
TTGGAGAAC.GCCATTAAG	TTGGAGAAC.GCCATTAAG
TTGGAGAAC.GGAGTACAG	TTGGAGAAC.GGAGTACAG
TTGGAGAAC.TACAACACC	TTGGAGAAC.TACAACACC
TTGGAGAAC.TGATTATCG	TTGGAGAAC.TGATTATCG
TTGGTAACT.ACCATACTT	TTGGTAACT.ACCATACTT
TTGGTAACT.ATATTCGCA	TTGGTAACT.ATATTCGCA
TTGGTAACT.CACCAGAAG	TTGGTAACT.CACCAGAAG
TTGGTAACT.GACACCGAT	TTGGTAACT.GACACCGAT
TTGGTAACT.TGGAACTAA	TTGGTAACT.TGGAACTAA
TTGTAATGC.AATTGGTGA	TTGTAATGC.AATTGGTGA
TTGTAATGC.CTTGTAACG	TTGTAATGC.CTTGTAACG
TTGTAATGC.TGATTCACC	TTGTAATGC.TGATTCACC
TTGTATCAC.AGTAGAGGA	TTGTATCAC.AGTAGAGGA
TTGTATCAC.CCACACAGA	TTGTATCAC.CCACACAGA
TTGTATCAC.CCTATTCAA	TTGTATCAC.CCTATTCAA
TTGTCAACC.CCAATATAC	TTGTCAACC.CCAATATAC
TTGTCAACC.CGAGCCGTT	TTGTCAACC.CGAGCCGTT
TTGTCAACC.TGAACTTGC	TTGTCAACC.TGAACTTGC
TTGTTAGAG.ATCGATCCT	TTGTTAGAG.ATCGATCCT
TTGTTAGAG.GTAACTCAT	TTGTTAGAG.GTAACTCAT
TTGTTAGAG.GTGAGGACG	TTGTTAGAG.GTGAGGACG
TTGTTAGAG.GTTGATGCA	TTGTTAGAG.GTTGATGCA
TTGTTAGAG.TCCAGCAGC	TTGTTAGAG.TCCAGCAGC
