ATGATAGCT.TACTAGTAG	ATGATAGCT.TACTAGTAG
ATGATAGCT.TTGATGAGT	ATGATAGCT.TTGATGAGT
ATGCAGTTC.CAGAAGTGA	ATGCAGTTC.CAGAAGTGA
ATGCAGTTC.GAAGGATCA	ATGCAGTTC.GAAGGATCA
ATGCAGTTC.GCGGACGAA	ATGCAGTTC.GCGGACGAA
ATGCAGTTC.TTACGGACC	ATGCAGTTC.TTACGGACC
ATGCCTGTC.ACTTAGCTT	ATGCCTGTC.ACTTAGCTT
ATGCCTGTC.CGTGCCTAT	ATGCCTGTC.CGTGCCTAT
ATGCCTTCA.AAGTACAGA	ATGCCTTCA.AAGTACAGA
ATGCCTTCA.ATATAGCGT	ATGCCTTCA.ATATAGCGT
ATGCCTTCA.CAAGAACCG	ATGCCTTCA.CAAGAACCG
ATGCCTTCA.GTCAGACCG	ATGCCTTCA.GTCAGACCG
ATGCGCCGT.CATGGTCGA	ATGCGCCGT.CATGGTCGA
ATGCGCCGT.CTCTAAGAG	ATGCGCCGT.CTCTAAGAG
ATGCGCCGT.GGTACGAGC	ATGCGCCGT.GGTACGAGC
ATGCGCCGT.GTACGAACG	ATGCGCCGT.GTACGAACG
ATGCGCTAC.ATGAGGTAT	ATGCGCTAC.ATGAGGTAT
ATGCGCTAC.CAAGAGGAG	ATGCGCTAC.CAAGAGGAG
ATGCGCTAC.CCGTTCCAA	ATGCGCTAC.CCGTTCCAA
ATGCGCTAC.CGTGCTTGA	ATGCGCTAC.CGTGCTTGA
ATGCGCTAC.GCAACCAAC	ATGCGCTAC.GCAACCAAC
ATGCGCTAC.TTCTGAATG	ATGCGCTAC.TTCTGAATG
ATGCGGATT.TCTATGACA	ATGCGGATT.TCTATGACA
ATGCGGATT.TGTATGTAG	ATGCGGATT.TGTATGTAG
ATGCGTGGA.AAGCTGGTC	ATGCGTGGA.AAGCTGGTC
ATGCGTGGA.AATGCGTGC	ATGCGTGGA.AATGCGTGC
ATGCGTGGA.AGACTTCGT	ATGCGTGGA.AGACTTCGT
ATGCGTGGA.ATTATGCAG	ATGCGTGGA.ATTATGCAG
ATGCGTGGA.CCGACTGTT	ATGCGTGGA.CCGACTGTT
ATGCGTGGA.CCTAAGTCT	ATGCGTGGA.CCTAAGTCT
ATGCGTGGA.GTCAAGATC	ATGCGTGGA.GTCAAGATC
ATGCGTGGA.TAGAGACTA	ATGCGTGGA.TAGAGACTA
ATGCGTGGA.TCAATGGAC	ATGCGTGGA.TCAATGGAC
ATGCGTGGA.TCAGGACTG	ATGCGTGGA.TCAGGACTG
ATGCGTGGA.TCGTCCGAT	ATGCGTGGA.TCGTCCGAT
ATGCGTGGA.TGTCAACCT	ATGCGTGGA.TGTCAACCT
ATGCTCACC.CTAGTTCCA	ATGCTCACC.CTAGTTCCA
ATGCTCACC.TCGTAATAG	ATGCTCACC.TCGTAATAG
ATGCTGTCG.ACCAGCGTT	ATGCTGTCG.ACCAGCGTT
ATGCTTCAG.CCACGAAGG	ATGCTTCAG.CCACGAAGG
ATGCTTCAG.CGTATCGAA	ATGCTTCAG.CGTATCGAA
ATGCTTCAG.TGCCGAACT	ATGCTTCAG.TGCCGAACT
ATGGACGTT.AACGATGAC	ATGGACGTT.AACGATGAC
ATGGACGTT.AGAGCGCGA	ATGGACGTT.AGAGCGCGA
ATGGAGAGT.ACCGAGACA	ATGGAGAGT.ACCGAGACA
ATGGAGAGT.AGATCGAGT	ATGGAGAGT.AGATCGAGT
ATGGAGAGT.ATTATGCAG	ATGGAGAGT.ATTATGCAG
ATGGAGAGT.CGGAACGAG	ATGGAGAGT.CGGAACGAG
ATGGAGAGT.CTGAGGTTA	ATGGAGAGT.CTGAGGTTA
ATGGAGAGT.GCACATGTT	ATGGAGAGT.GCACATGTT
ATGGAGAGT.GCACGCATT	ATGGAGAGT.GCACGCATT
ATGGAGAGT.TTAGCGTCT	ATGGAGAGT.TTAGCGTCT
ATGGAGGAA.AAGGATACG	ATGGAGGAA.AAGGATACG
ATGGAGGAA.ACGAATCGC	ATGGAGGAA.ACGAATCGC
ATGGAGGAA.CCTAGTCTC	ATGGAGGAA.CCTAGTCTC
ATGGAGGAA.CGCAACCTC	ATGGAGGAA.CGCAACCTC
ATGGAGGAA.CGGTCGACA	ATGGAGGAA.CGGTCGACA
ATGGAGGAA.GTTCAGAAG	ATGGAGGAA.GTTCAGAAG
ATGGATATC.CGCTTCACG	ATGGATATC.CGCTTCACG
ATGGATATC.CGTCAGCAC	ATGGATATC.CGTCAGCAC
ATGGATATC.GAACGCTGT	ATGGATATC.GAACGCTGT
ATGGATATC.GCAGATCCG	ATGGATATC.GCAGATCCG
ATGGATATC.GTACGAACG	ATGGATATC.GTACGAACG
ATGGATATC.GTAGACTCT	ATGGATATC.GTAGACTCT
ATGGATATC.TGGTAACCA	ATGGATATC.TGGTAACCA
ATGGTTCGA.CGATACTCT	ATGGTTCGA.CGATACTCT
ATGGTTCGA.CTCGACGAT	ATGGTTCGA.CTCGACGAT
ATGGTTCGA.GCAGATCCG	ATGGTTCGA.GCAGATCCG
ATGGTTCGA.TCTAGGATG	ATGGTTCGA.TCTAGGATG
ATGGTTCGA.TGGTCGCTA	ATGGTTCGA.TGGTCGCTA
ATGTCCTCC.AGTCAGTTG	ATGTCCTCC.AGTCAGTTG
ATGTCCTCC.GGATACCTA	ATGTCCTCC.GGATACCTA
ATGTCCTCC.TATCGGAAC	ATGTCCTCC.TATCGGAAC
ATGTCCTCC.TTCTCCACA	ATGTCCTCC.TTCTCCACA
ATGTCCTCC.TTCTGCCGA	ATGTCCTCC.TTCTGCCGA
ATGTCGCCT.CTGTAGAAG	ATGTCGCCT.CTGTAGAAG
ATGTCGCCT.TTCTGAATG	ATGTCGCCT.TTCTGAATG
ATGTGACGA.ATTCTCTGG	ATGTGACGA.ATTCTCTGG
ATGTGACGA.CACGACTCA	ATGTGACGA.CACGACTCA
ATGTGACGA.GAGGTCCTT	ATGTGACGA.GAGGTCCTT
ATGTGACGA.GATCTTCGC	ATGTGACGA.GATCTTCGC
ATGTGAGAC.CCGCAGCTA	ATGTGAGAC.CCGCAGCTA
ATGTGAGAC.GATAACGTC	ATGTGAGAC.GATAACGTC
ATGTGAGAC.GGAGCATCT	ATGTGAGAC.GGAGCATCT
ATTAAGACC.CACCTACGC	ATTAAGACC.CACCTACGC
ATTAAGACC.CGGATTCTC	ATTAAGACC.CGGATTCTC
ATTAAGACC.GAGTCAAGG	ATTAAGACC.GAGTCAAGG
ATTAAGACC.TGAGAATCC	ATTAAGACC.TGAGAATCC
ATTAGCACA.CCGGTTGAG	ATTAGCACA.CCGGTTGAG
ATTAGCACA.CTATCCATC	ATTAGCACA.CTATCCATC
ATTAGCACA.CTCTGTCAA	ATTAGCACA.CTCTGTCAA
ATTAGCACA.GATTCCTCT	ATTAGCACA.GATTCCTCT
ATTAGCACA.GGTGAGCGT	ATTAGCACA.GGTGAGCGT
ATTAGCACA.TGCTATGAA	ATTAGCACA.TGCTATGAA
ATTAGCACA.TGTGCTAAC	ATTAGCACA.TGTGCTAAC
ATTAGCCAC.CTGTCTAGT	ATTAGCCAC.CTGTCTAGT
ATTAGCCAC.GCACGCATT	ATTAGCCAC.GCACGCATT
ATTAGCCAC.GTAAGGTCC	ATTAGCCAC.GTAAGGTCC
ATTAGCGGT.ACAAGGTAC	ATTAGCGGT.ACAAGGTAC
ATTAGCGGT.TCTATTAGG	ATTAGCGGT.TCTATTAGG
ATTAGCGGT.TGTAACAGT	ATTAGCGGT.TGTAACAGT
ATTATGCAG.AAGTACAGA	ATTATGCAG.AAGTACAGA
ATTATGCAG.TTGCGAACA	ATTATGCAG.TTGCGAACA
ATTCACCTC.AATCCTCGT	ATTCACCTC.AATCCTCGT
ATTCACCTC.AGATCTTCA	ATTCACCTC.AGATCTTCA
ATTCACCTC.ATCAAGCAT	ATTCACCTC.ATCAAGCAT
ATTCACCTC.ATGGTTCGA	ATTCACCTC.ATGGTTCGA
ATTCACCTC.CACGACTCA	ATTCACCTC.CACGACTCA
ATTCACCTC.CTCTAAGAG	ATTCACCTC.CTCTAAGAG
ATTCACCTC.GTTGCTCAG	ATTCACCTC.GTTGCTCAG
ATTCATGTG.AGTCGATCA	ATTCATGTG.AGTCGATCA
ATTCATGTG.CGGAACGAG	ATTCATGTG.CGGAACGAG
ATTCATGTG.GAGAATCAG	ATTCATGTG.GAGAATCAG
ATTCATGTG.GGAATTCAC	ATTCATGTG.GGAATTCAC
ATTCATGTG.TAGTAGTCT	ATTCATGTG.TAGTAGTCT
ATTCCGTAC.AGAAGCTGC	ATTCCGTAC.AGAAGCTGC
ATTCCGTAC.ATACCGCTT	ATTCCGTAC.ATACCGCTT
ATTCCGTAC.TGTGCAGTA	ATTCCGTAC.TGTGCAGTA
ATTCCTACG.AAGACTGGT	ATTCCTACG.AAGACTGGT
ATTCCTACG.CGAGCTTAC	ATTCCTACG.CGAGCTTAC
ATTCCTACG.GAATCGAGA	ATTCCTACG.GAATCGAGA
ATTCCTACG.GACCGGTAG	ATTCCTACG.GACCGGTAG
ATTCCTACG.TGCGCACTG	ATTCCTACG.TGCGCACTG
ATTCGAAGA.AGCTCGTCT	ATTCGAAGA.AGCTCGTCT
ATTCGAAGA.CACAACCAG	ATTCGAAGA.CACAACCAG
ATTCGAAGA.CCTGTCGAC	ATTCGAAGA.CCTGTCGAC
ATTCGAAGA.CGTATTCCT	ATTCGAAGA.CGTATTCCT
ATTCGAAGA.GTGCTCGGA	ATTCGAAGA.GTGCTCGGA
ATTCGCTTA.CCTGCGTTA	ATTCGCTTA.CCTGCGTTA
ATTCGCTTA.CGCCTGCAA	ATTCGCTTA.CGCCTGCAA
ATTCGCTTA.GTATGTATC	ATTCGCTTA.GTATGTATC
ATTCTCTGG.ATGACACAA	ATTCTCTGG.ATGACACAA
ATTCTCTGG.CGAAGAGGT	ATTCTCTGG.CGAAGAGGT
ATTGACACG.ACCATGTCT	ATTGACACG.ACCATGTCT
ATTGACACG.CTTAGGACT	ATTGACACG.CTTAGGACT
ATTGACACG.TGAAGACCA	ATTGACACG.TGAAGACCA
ATTGACACG.TGATTATCG	ATTGACACG.TGATTATCG
ATTGACACG.TGTACACGA	ATTGACACG.TGTACACGA
ATTGACACG.TTGACCTGA	ATTGACACG.TTGACCTGA
ATTGATCAC.ACGACAGTC	ATTGATCAC.ACGACAGTC
ATTGATTGG.CGCGATGTA	ATTGATTGG.CGCGATGTA
ATTGATTGG.TATGTATGC	ATTGATTGG.TATGTATGC
ATTGCCGAC.AACGATGAC	ATTGCCGAC.AACGATGAC
ATTGCCGAC.AGTGTCTCT	ATTGCCGAC.AGTGTCTCT
ATTGCCGAC.CGTGTATTC	ATTGCCGAC.CGTGTATTC
ATTGCCGAC.CTTCCGTGG	ATTGCCGAC.CTTCCGTGG
ATTGCCGAC.TGCATACAT	ATTGCCGAC.TGCATACAT
ATTGCGCTA.CCACGGATC	ATTGCGCTA.CCACGGATC
ATTGCGCTA.CCTTGTTGC	ATTGCGCTA.CCTTGTTGC
ATTGCGCTA.GCCATTAAG	ATTGCGCTA.GCCATTAAG
ATTGCGCTA.GCGGACGAA	ATTGCGCTA.GCGGACGAA
ATTGGTTCC.ACTATTGTC	ATTGGTTCC.ACTATTGTC
ATTGGTTCC.AGTCCAGTG	ATTGGTTCC.AGTCCAGTG
ATTGGTTCC.ATCAGTCGA	ATTGGTTCC.ATCAGTCGA
CAACACCTA.ACTGGTGCT	CAACACCTA.ACTGGTGCT
CAACACCTA.CATTGACAA	CAACACCTA.CATTGACAA
CAACACCTA.GACGGTGCT	CAACACCTA.GACGGTGCT
CAACACCTA.GATGCTCCT	CAACACCTA.GATGCTCCT
CAACACCTA.GCACGCATT	CAACACCTA.GCACGCATT
CAACACCTA.GTCAGCGTC	CAACACCTA.GTCAGCGTC
CAACACCTA.TCGGACAGT	CAACACCTA.TCGGACAGT
CAACACTCC.TATGGTTGG	CAACACTCC.TATGGTTGG
CAACCGGTC.ACAATTCGG	CAACCGGTC.ACAATTCGG
CAACCGGTC.ACATTGACA	CAACCGGTC.ACATTGACA
CAACCTGGT.AACTTCTGC	CAACCTGGT.AACTTCTGC
CAACCTGGT.AGTAAGCCA	CAACCTGGT.AGTAAGCCA
CAACCTGGT.CGCTTATGA	CAACCTGGT.CGCTTATGA
CAACGATCG.ACGACAGTC	CAACGATCG.ACGACAGTC
CAACGATCG.CATCCGACA	CAACGATCG.CATCCGACA
CAACGATCG.CTGACGGAT	CAACGATCG.CTGACGGAT
CAACGATCG.GGTAACTAC	CAACGATCG.GGTAACTAC
CAACGATCG.GTCAGTTGT	CAACGATCG.GTCAGTTGT
CAACGATCG.TGGTGGATC	CAACGATCG.TGGTGGATC
CAACGCACA.CGCTTCACG	CAACGCACA.CGCTTCACG
CAACGCACA.GGAATTCAC	CAACGCACA.GGAATTCAC
CAACGCACA.GTAGTGGAG	CAACGCACA.GTAGTGGAG
CAACGCACA.TACAACACC	CAACGCACA.TACAACACC
CAACGCACA.TGCATACAT	CAACGCACA.TGCATACAT
CAACGTCTT.ATCATTACG	CAACGTCTT.ATCATTACG
CAACGTCTT.TCACATACT	CAACGTCTT.TCACATACT
CAACGTCTT.TGGTAGCAG	CAACGTCTT.TGGTAGCAG
CAACTAATC.CATACGCAG	CAACTAATC.CATACGCAG
CAACTAATC.GGATCGTTC	CAACTAATC.GGATCGTTC
CAACTCCAG.ACGTGAATC	CAACTCCAG.ACGTGAATC
CAACTCCAG.ACTCTCACA	CAACTCCAG.ACTCTCACA
CAACTCCAG.CCATTACAG	CAACTCCAG.CCATTACAG
CAACTCCAG.CCGCTCATG	CAACTCCAG.CCGCTCATG
CAACTCCAG.CTAATACGC	CAACTCCAG.CTAATACGC
CAACTCCAG.CTGTGCTCA	CAACTCCAG.CTGTGCTCA
CAACTCCAG.GCACCATCG	CAACTCCAG.GCACCATCG
CAAGAACCG.ACTCTGCTC	CAAGAACCG.ACTCTGCTC
CAAGAACCG.ATATTCGCA	CAAGAACCG.ATATTCGCA
CAAGAACCG.CTCAGTGAT	CAAGAACCG.CTCAGTGAT
CAAGAACCG.GTCGACATT	CAAGAACCG.GTCGACATT
CAAGAACCG.TAACCGTGA	CAAGAACCG.TAACCGTGA
CAAGAGAGT.AAGGTGCTG	CAAGAGAGT.AAGGTGCTG
CAAGAGAGT.ACTCGTAGG	CAAGAGAGT.ACTCGTAGG
CAAGAGAGT.ATCTCTGCT	CAAGAGAGT.ATCTCTGCT
CAAGAGAGT.GAGAATCAG	CAAGAGAGT.GAGAATCAG
CAAGAGAGT.TGACCTATG	CAAGAGAGT.TGACCTATG
CAAGAGGAG.ACAGCGTAT	CAAGAGGAG.ACAGCGTAT
CAAGAGGAG.CATATGCGA	CAAGAGGAG.CATATGCGA
CAAGAGGAG.CATCCAGGA	CAAGAGGAG.CATCCAGGA
CAAGAGGAG.CTGCGTCAC	CAAGAGGAG.CTGCGTCAC
CAAGAGGAG.CTTGCACAA	CAAGAGGAG.CTTGCACAA
CAAGAGGAG.TATCTAGGT	CAAGAGGAG.TATCTAGGT
CAAGCCTCG.ACTATCCTG	CAAGCCTCG.ACTATCCTG
CAAGCCTCG.AGTGAACGG	CAAGCCTCG.AGTGAACGG
CAAGCCTCG.CATCCTCTC	CAAGCCTCG.CATCCTCTC
CAAGCCTCG.GTATACAGA	CAAGCCTCG.GTATACAGA
CAAGCCTCG.GTTAGATTG	CAAGCCTCG.GTTAGATTG
CAAGCCTCG.TATCGAGCC	CAAGCCTCG.TATCGAGCC
CAAGCCTCG.TGCATACAT	CAAGCCTCG.TGCATACAT
CAAGCGCAT.ACACATCTG	CAAGCGCAT.ACACATCTG
CAAGCGCAT.ACTCCGGTT	CAAGCGCAT.ACTCCGGTT
CAAGCGCAT.AGTCTGGAA	CAAGCGCAT.AGTCTGGAA
CAAGCGCAT.AGTGGAATG	CAAGCGCAT.AGTGGAATG
CAAGCGCAT.ATTAGCGGT	CAAGCGCAT.ATTAGCGGT
CAAGCGCAT.CAAGAGGAG	CAAGCGCAT.CAAGAGGAG
CAAGCGCAT.CAGTCGGTA	CAAGCGCAT.CAGTCGGTA
CAAGCGCAT.CCTCCTTGT	CAAGCGCAT.CCTCCTTGT
CAAGCGCAT.GATTGGAAG	CAAGCGCAT.GATTGGAAG
CAAGCTGCA.AACAGCAGT	CAAGCTGCA.AACAGCAGT
CAAGCTGCA.ATCACTTCC	CAAGCTGCA.ATCACTTCC
CAAGCTGCA.ATCTACATC	CAAGCTGCA.ATCTACATC
CAAGCTGCA.CTATCCATC	CAAGCTGCA.CTATCCATC
CAAGCTGCA.GAACGCTGT	CAAGCTGCA.GAACGCTGT
CAAGCTGCA.GTCCTAGTT	CAAGCTGCA.GTCCTAGTT
CAAGCTGCA.TAAGCCATT	CAAGCTGCA.TAAGCCATT
CAAGCTGCA.TGAGCAGAT	CAAGCTGCA.TGAGCAGAT
CAAGCTGCA.TGATAGAGG	CAAGCTGCA.TGATAGAGG
CAAGCTGCA.TTCTGAATG	CAAGCTGCA.TTCTGAATG
CAAGTACGA.CGTGGTACC	CAAGTACGA.CGTGGTACC
CAAGTACGA.GGTAGACAT	CAAGTACGA.GGTAGACAT
CAAGTACGA.TCTAGCTGG	CAAGTACGA.TCTAGCTGG
CAAGTACGA.TGTCACATA	CAAGTACGA.TGTCACATA
CAAGTCACT.AAGGAAGTC	CAAGTCACT.AAGGAAGTC
CAAGTCACT.ATGGTTCGA	CAAGTCACT.ATGGTTCGA
CAAGTCACT.CAATGTGCT	CAAGTCACT.CAATGTGCT
CAAGTCACT.GTCCTAGTT	CAAGTCACT.GTCCTAGTT
CAAGTCACT.TCGTGACGT	CAAGTCACT.TCGTGACGT
CAAGTCGAA.ATGTCGCCT	CAAGTCGAA.ATGTCGCCT
CAAGTCGAA.CAGGTATCG	CAAGTCGAA.CAGGTATCG
CAAGTCGAA.GGAATTCAC	CAAGTCGAA.GGAATTCAC
CAAGTCGAA.GTTGCATGG	CAAGTCGAA.GTTGCATGG
CAAGTCGAA.TATCTAGGT	CAAGTCGAA.TATCTAGGT
CAATACCAC.ACAATTCGG	CAATACCAC.ACAATTCGG
CAATACCAC.AGCCACTTC	CAATACCAC.AGCCACTTC
CAATACCAC.CAGTGCTGC	CAATACCAC.CAGTGCTGC
CAATACCAC.CGTGCCTAT	CAATACCAC.CGTGCCTAT
CAATACCAC.GCAACACCT	CAATACCAC.GCAACACCT
CAATACCAC.GTGGAGGTC	CAATACCAC.GTGGAGGTC
CAATACCAC.TTGCCGTAG	CAATACCAC.TTGCCGTAG
CAATCAAGT.CAGCTTACC	CAATCAAGT.CAGCTTACC
CAATCAAGT.CTAGAGGTA	CAATCAAGT.CTAGAGGTA
CAATCAAGT.TCGGATGTT	CAATCAAGT.TCGGATGTT
CAATCAAGT.TTCCTCGGT	CAATCAAGT.TTCCTCGGT
CAATCATAC.GCCTGGAAT	CAATCATAC.GCCTGGAAT
CAATCATAC.TCGCGTCAT	CAATCATAC.TCGCGTCAT
CAATCTCCG.GACCTTGTG	CAATCTCCG.GACCTTGTG
CAATCTCCG.GCATACATG	CAATCTCCG.GCATACATG
CAATCTCCG.GCTTAGAAC	CAATCTCCG.GCTTAGAAC
CAATCTCCG.TAGCCAGTG	CAATCTCCG.TAGCCAGTG
CAATGCATT.AGTATGACG	CAATGCATT.AGTATGACG
CAATGCATT.ATGCTTCAG	CAATGCATT.ATGCTTCAG
CAATGCATT.CGTCAGCAC	CAATGCATT.CGTCAGCAC
CAATGCATT.GTGCGAGTA	CAATGCATT.GTGCGAGTA
CAATGTGCT.CTGGACACT	CAATGTGCT.CTGGACACT
CAATGTGCT.TCTAATACC	CAATGTGCT.TCTAATACC
CAATGTGCT.TCTCATCGG	CAATGTGCT.TCTCATCGG
CAATGTGCT.TGAACTTGC	CAATGTGCT.TGAACTTGC
CAATTGTCT.ACTTCGCAG	CAATTGTCT.ACTTCGCAG
CAATTGTCT.GCGTAACAA	CAATTGTCT.GCGTAACAA
CAATTGTCT.GGACACTGG	CAATTGTCT.GGACACTGG
CAATTGTCT.GGTCTTGCA	CAATTGTCT.GGTCTTGCA
CACAACCAG.GGATCAATG	CACAACCAG.GGATCAATG
CACAACGCT.AAGAGAACT	CACAACGCT.AAGAGAACT
CACAACGCT.AGTAAGCCA	CACAACGCT.AGTAAGCCA
CACAACGCT.AGTTCAACC	CACAACGCT.AGTTCAACC
CACAACGCT.CCACGTTCT	CACAACGCT.CCACGTTCT
CACAACGCT.TGACCTATG	CACAACGCT.TGACCTATG
CACAATAAC.CGATACTCT	CACAATAAC.CGATACTCT
CACAATAAC.GTCGCAGGT	CACAATAAC.GTCGCAGGT
CACAATAAC.TAGTAGTCT	CACAATAAC.TAGTAGTCT
CACACCACA.AAGTTCTCT	CACACCACA.AAGTTCTCT
CACACCACA.AATATCAGC	CACACCACA.AATATCAGC
CACACCACA.ACGTGCTCG	CACACCACA.ACGTGCTCG
CACACCACA.ACTCCGGTT	CACACCACA.ACTCCGGTT
CACACCACA.CCTAGTTAG	CACACCACA.CCTAGTTAG
CACACCACA.GATTCCTCT	CACACCACA.GATTCCTCT
CACACCACA.GGACAGATT	CACACCACA.GGACAGATT
CACACCACA.GGATGCGAA	CACACCACA.GGATGCGAA
CACACCACA.GGTAACTAC	CACACCACA.GGTAACTAC
CACACCACA.TCGTGCCAC	CACACCACA.TCGTGCCAC
CACACCTGT.AGCAGACAA	CACACCTGT.AGCAGACAA
CACACCTGT.ATCTTACAG	CACACCTGT.ATCTTACAG
CACACCTGT.CAGCAGTAC	CACACCTGT.CAGCAGTAC
CACACCTGT.CCGCTCATG	CACACCTGT.CCGCTCATG
CACACCTGT.CTAACACTG	CACACCTGT.CTAACACTG
CACACCTGT.CTGCAGAGC	CACACCTGT.CTGCAGAGC
CACACCTGT.GGTACGAGC	CACACCTGT.GGTACGAGC
CACACTGCC.ACACACGTC	CACACTGCC.ACACACGTC
CACACTGCC.ATCCGGTCC	CACACTGCC.ATCCGGTCC
CACACTGCC.CAGGTTGTC	CACACTGCC.CAGGTTGTC
CACACTGCC.CAGTTGAGT	CACACTGCC.CAGTTGAGT
CACACTGCC.GATCGATAC	CACACTGCC.GATCGATAC
CACACTGCC.TCGTAATAG	CACACTGCC.TCGTAATAG
CACAGCGAA.ATGGTTCGA	CACAGCGAA.ATGGTTCGA
CACAGCGAA.CGATTGAAC	CACAGCGAA.CGATTGAAC
CACAGCGAA.TACGGTCGT	CACAGCGAA.TACGGTCGT
CACATATCA.CTGGACTAA	CACATATCA.CTGGACTAA
CACATATCA.TCGGTATCA	CACATATCA.TCGGTATCA
CACATGTGC.ACCGATCGA	CACATGTGC.ACCGATCGA
CACATGTGC.CCTATTGGT	CACATGTGC.CCTATTGGT
CACATGTGC.TATCATGCT	CACATGTGC.TATCATGCT
CACATTCTG.AACAGATCG	CACATTCTG.AACAGATCG
CACATTCTG.CCAACAACA	CACATTCTG.CCAACAACA
CACATTCTG.CTTCCGTGG	CACATTCTG.CTTCCGTGG
CACATTCTG.GGTAAGGAT	CACATTCTG.GGTAAGGAT
CACCAAGAT.ACCGAGTAG	CACCAAGAT.ACCGAGTAG
CACCAAGAT.ACTCCGGTT	CACCAAGAT.ACTCCGGTT
CACCAAGAT.ATATAGCGT	CACCAAGAT.ATATAGCGT
CACCAAGAT.CCAAGCGAG	CACCAAGAT.CCAAGCGAG
CACCAAGAT.CTGTCACTT	CACCAAGAT.CTGTCACTT
CACCAAGAT.GTCGCAGGT	CACCAAGAT.GTCGCAGGT
CACCAAGAT.TGATCGGAA	CACCAAGAT.TGATCGGAA
CACCAAGAT.TGCGTCTTA	CACCAAGAT.TGCGTCTTA
CACCAGAAG.AACGCTCAA	CACCAGAAG.AACGCTCAA
CACCAGAAG.GGATAGTCA	CACCAGAAG.GGATAGTCA
CACCAGAAG.TCTTAAGTG	CACCAGAAG.TCTTAAGTG
CACCTACGC.GTTGACCAT	CACCTACGC.GTTGACCAT
CACCTAGCG.CAGCTTCGA	CACCTAGCG.CAGCTTCGA
CACCTCAAC.ATATAGCGT	CACCTCAAC.ATATAGCGT
CACCTCAAC.ATGATAGCT	CACCTCAAC.ATGATAGCT
CACCTCAAC.CGTGACCAG	CACCTCAAC.CGTGACCAG
CACCTCAAC.CTTGCACAA	CACCTCAAC.CTTGCACAA
CACCTCAAC.GAATTGTTG	CACCTCAAC.GAATTGTTG
CACCTCAAC.TCGTGACGT	CACCTCAAC.TCGTGACGT
CACCTCGGA.ATGAGTGTG	CACCTCGGA.ATGAGTGTG
CACCTCGGA.TATTACAGC	CACCTCGGA.TATTACAGC
CACCTCGGA.TGATGTGTG	CACCTCGGA.TGATGTGTG
CACCTTCCT.ACTCGCTGT	CACCTTCCT.ACTCGCTGT
CACCTTCCT.CCGCATCCT	CACCTTCCT.CCGCATCCT
CACCTTCCT.CGATTGAAC	CACCTTCCT.CGATTGAAC
CACCTTCCT.GATATATCC	CACCTTCCT.GATATATCC
CACCTTCCT.GGAAGTATG	CACCTTCCT.GGAAGTATG
CACGACTCA.AATCCTCGT	CACGACTCA.AATCCTCGT
CACGACTCA.CCGAGCTGA	CACGACTCA.CCGAGCTGA
CACGATAGA.CAGGTTGTC	CACGATAGA.CAGGTTGTC
CACGATAGA.GATTAGTGT	CACGATAGA.GATTAGTGT
CACGATAGA.TCGTCATTC	CACGATAGA.TCGTCATTC
CACGATAGA.TGTAGGTTA	CACGATAGA.TGTAGGTTA
CACGCGTAA.AGAGGTGAA	CACGCGTAA.AGAGGTGAA
CACGCGTAA.CCACCATGC	CACGCGTAA.CCACCATGC
CACGCGTAA.CTACGGTAT	CACGCGTAA.CTACGGTAT
CACGCGTAA.GATTATGCG	CACGCGTAA.GATTATGCG
CACGCGTAA.TAGCACACG	CACGCGTAA.TAGCACACG
CACGCGTAA.TCCTGAGAC	CACGCGTAA.TCCTGAGAC
CACGCGTAA.TGAGCAGAT	CACGCGTAA.TGAGCAGAT
CACGGAAGT.AACGTCGAG	CACGGAAGT.AACGTCGAG
CACGGAAGT.AGCCACTTC	CACGGAAGT.AGCCACTTC
CACGGAAGT.GCGCTTCTC	CACGGAAGT.GCGCTTCTC
CACGGATAG.CTATAGCTC	CACGGATAG.CTATAGCTC
CACGGATAG.GGATCAATG	CACGGATAG.GGATCAATG
CACGGATAG.TGTGCAGTA	CACGGATAG.TGTGCAGTA
CACGTAGAC.ACATTCCAC	CACGTAGAC.ACATTCCAC
CACGTAGAC.CAATACCAC	CACGTAGAC.CAATACCAC
CACGTAGAC.TAATTCGTG	CACGTAGAC.TAATTCGTG
CACGTAGAC.TCAATCTAG	CACGTAGAC.TCAATCTAG
CACGTCATA.ACCGATCGA	CACGTCATA.ACCGATCGA
CACGTCATA.TTATCGCAC	CACGTCATA.TTATCGCAC
CACGTCATA.TTGAGACGG	CACGTCATA.TTGAGACGG
CACTACAGG.AGTACTACA	CACTACAGG.AGTACTACA
CACTACAGG.ATCTGCGTA	CACTACAGG.ATCTGCGTA
CACTACAGG.GAATCGAGA	CACTACAGG.GAATCGAGA
CACTACAGG.GCTATGTAA	CACTACAGG.GCTATGTAA
CACTAGACT.ACTATTGTC	CACTAGACT.ACTATTGTC
CACTAGACT.CCTGTCATT	CACTAGACT.CCTGTCATT
CACTCACTA.ACACTAACG	CACTCACTA.ACACTAACG
CACTCACTA.AGCCAGGAC	CACTCACTA.AGCCAGGAC
CACTCACTA.CACTTCCTT	CACTCACTA.CACTTCCTT
CACTCACTA.CTCTACGCA	CACTCACTA.CTCTACGCA
CACTCACTA.GGAGTACAG	CACTCACTA.GGAGTACAG
CACTCACTA.TCAATGGAC	CACTCACTA.TCAATGGAC
CACTGCTTA.ACGAGCTTC	CACTGCTTA.ACGAGCTTC
CACTGCTTA.CAAGGTGTG	CACTGCTTA.CAAGGTGTG
CACTGCTTA.CACAGCGAA	CACTGCTTA.CACAGCGAA
CACTGCTTA.CAGTATGAT	CACTGCTTA.CAGTATGAT
CACTGCTTA.GTGCACGAG	CACTGCTTA.GTGCACGAG
CACTGCTTA.GTGGAGGTC	CACTGCTTA.GTGGAGGTC
CACTGCTTA.TATTACAGC	CACTGCTTA.TATTACAGC
CACTGGTCC.CTAACCGGT	CACTGGTCC.CTAACCGGT
CACTGGTCC.TGATTCACC	CACTGGTCC.TGATTCACC
CACTGTATC.AATACCTTG	CACTGTATC.AATACCTTG
CACTGTATC.CGCATAACT	CACTGTATC.CGCATAACT
CACTGTATC.GTAGAAGTT	CACTGTATC.GTAGAAGTT
CACTTCCTT.ATACCGCTT	CACTTCCTT.ATACCGCTT
CACTTCCTT.ATTCGCTTA	CACTTCCTT.ATTCGCTTA
CACTTGGAT.ACCTGCAGA	CACTTGGAT.ACCTGCAGA
CACTTGGAT.CACGACTCA	CACTTGGAT.CACGACTCA
CACTTGGAT.TACCAGCCA	CACTTGGAT.TACCAGCCA
CACTTGGAT.TCGTCCGAT	CACTTGGAT.TCGTCCGAT
CACTTGGAT.TGACCTCCT	CACTTGGAT.TGACCTCCT
CAGAAGTGA.ACGTCGCTC	CAGAAGTGA.ACGTCGCTC
CAGAAGTGA.AGCTCGTCT	CAGAAGTGA.AGCTCGTCT
CAGAAGTGA.ATAAGACAG	CAGAAGTGA.ATAAGACAG
CAGAAGTGA.ATTAGCGGT	CAGAAGTGA.ATTAGCGGT
CAGAAGTGA.CACCAGAAG	CAGAAGTGA.CACCAGAAG
CAGAAGTGA.GCCGTGAAC	CAGAAGTGA.GCCGTGAAC
CAGAAGTGA.TTAACGGAG	CAGAAGTGA.TTAACGGAG
CAGAAGTGA.TTCTGAATG	CAGAAGTGA.TTCTGAATG
CAGAGCACC.CCTTGACGG	CAGAGCACC.CCTTGACGG
CAGAGCACC.CTATAGCTC	CAGAGCACC.CTATAGCTC
CAGAGCACC.CTGCAGAGC	CAGAGCACC.CTGCAGAGC
CAGAGCACC.TAACATTGG	CAGAGCACC.TAACATTGG
CAGATCATT.AGAATCAGA	CAGATCATT.AGAATCAGA
CAGATCATT.AGATGTTGG	CAGATCATT.AGATGTTGG
CAGATCATT.ATTCATGTG	CAGATCATT.ATTCATGTG
CAGATCATT.GGTAACTAC	CAGATCATT.GGTAACTAC
CAGATCGAC.CGTCTGCTG	CAGATCGAC.CGTCTGCTG
CAGCACGTG.AGTTCAACC	CAGCACGTG.AGTTCAACC
CAGCAGTAC.AACAACTGG	CAGCAGTAC.AACAACTGG
CAGCAGTAC.ACAGAAGAG	CAGCAGTAC.ACAGAAGAG
CAGCAGTAC.AGTATGACG	CAGCAGTAC.AGTATGACG
CAGCAGTAC.ATTAAGACC	CAGCAGTAC.ATTAAGACC
CAGCAGTAC.GTGACGTAA	CAGCAGTAC.GTGACGTAA
CAGCAGTAC.GTTAGAGAC	CAGCAGTAC.GTTAGAGAC
CAGCAGTAC.TAACTCCGA	CAGCAGTAC.TAACTCCGA
CAGCAGTAC.TGTGAGTAT	CAGCAGTAC.TGTGAGTAT
CAGCCGCAA.AGTTGCCTT	CAGCCGCAA.AGTTGCCTT
CAGCCGCAA.GATCGCACT	CAGCCGCAA.GATCGCACT
CAGCCGCAA.GGTTGCTAT	CAGCCGCAA.GGTTGCTAT
CAGCCGCAA.GTAGACTCT	CAGCCGCAA.GTAGACTCT
CAGCGACGT.ATTGACACG	CAGCGACGT.ATTGACACG
CAGCGACGT.GCTGGTTCG	CAGCGACGT.GCTGGTTCG
CAGCGACGT.GTGCCATGA	CAGCGACGT.GTGCCATGA
CAGCGACGT.TATGCCTTC	CAGCGACGT.TATGCCTTC
CAGCGTAAG.AGTCTAAGC	CAGCGTAAG.AGTCTAAGC
CAGCGTAAG.CCATTCTGC	CAGCGTAAG.CCATTCTGC
CAGCGTAAG.CGTTGATCC	CAGCGTAAG.CGTTGATCC
CAGCGTAAG.GGTGTTCAT	CAGCGTAAG.GGTGTTCAT
CAGCGTAAG.TAGAGCGTC	CAGCGTAAG.TAGAGCGTC
CAGCTAGTT.CGAACAGAG	CAGCTAGTT.CGAACAGAG
CAGCTAGTT.TATCACCTG	CAGCTAGTT.TATCACCTG
CAGCTAGTT.TGATGGACA	CAGCTAGTT.TGATGGACA
CAGCTCTTC.ACACATCTG	CAGCTCTTC.ACACATCTG
CAGCTCTTC.GCCTTCCAT	CAGCTCTTC.GCCTTCCAT
CAGCTCTTC.TCTTAAGTG	CAGCTCTTC.TCTTAAGTG
CAGCTCTTC.TTCCGCCAG	CAGCTCTTC.TTCCGCCAG
CAGCTGGAG.CAGGATCAA	CAGCTGGAG.CAGGATCAA
CAGCTGGAG.GCAACACCT	CAGCTGGAG.GCAACACCT
CAGCTTACC.AATCAGGAG	CAGCTTACC.AATCAGGAG
CAGCTTACC.GGATTACGC	CAGCTTACC.GGATTACGC
CAGCTTACC.GGTCGGATA	CAGCTTACC.GGTCGGATA
CAGCTTACC.TACTGATGA	CAGCTTACC.TACTGATGA
CAGCTTACC.TAGGTCAAC	CAGCTTACC.TAGGTCAAC
CAGCTTACC.TTAGCGTCT	CAGCTTACC.TTAGCGTCT
CAGCTTCGA.TACCGATTG	CAGCTTCGA.TACCGATTG
CAGCTTCGA.TATCATGCT	CAGCTTCGA.TATCATGCT
CAGCTTCGA.TGACTGAGA	CAGCTTCGA.TGACTGAGA
CAGGAGCCT.AGTTATCGC	CAGGAGCCT.AGTTATCGC
CAGGAGCCT.GATCTACTT	CAGGAGCCT.GATCTACTT
CAGGAGCCT.TCTGCAACA	CAGGAGCCT.TCTGCAACA
CAGGATCAA.ACCTAGTTA	CAGGATCAA.ACCTAGTTA
CAGGATCAA.GGTCCTGGT	CAGGATCAA.GGTCCTGGT
CAGGATCAA.GTGTCTGGA	CAGGATCAA.GTGTCTGGA
CAGGATCAA.TACAGGACT	CAGGATCAA.TACAGGACT
CAGGTATCG.CTATTAAGG	CAGGTATCG.CTATTAAGG
CAGGTATCG.GACGGACTA	CAGGTATCG.GACGGACTA
CAGGTTGTC.AGGATTACT	CAGGTTGTC.AGGATTACT
CAGGTTGTC.GTCGTTAGA	CAGGTTGTC.GTCGTTAGA
CAGGTTGTC.TCGGTATCA	CAGGTTGTC.TCGGTATCA
CAGTAATGT.CTTAATCGT	CAGTAATGT.CTTAATCGT
CAGTACATC.ACCGTCCTA	CAGTACATC.ACCGTCCTA
CAGTACATC.CGACGTACG	CAGTACATC.CGACGTACG
CAGTACATC.GATCTGAAT	CAGTACATC.GATCTGAAT
CAGTACATC.TCAGGTGCA	CAGTACATC.TCAGGTGCA
CAGTACATC.TCGAATAGA	CAGTACATC.TCGAATAGA
CAGTATGAT.AATCCTCGT	CAGTATGAT.AATCCTCGT
CAGTATGAT.GCTTGTCCT	CAGTATGAT.GCTTGTCCT
CAGTCCTAA.AGTGATGCG	CAGTCCTAA.AGTGATGCG
CAGTCCTAA.CCTCCAATC	CAGTCCTAA.CCTCCAATC
CAGTCCTAA.GTGTTCCAG	CAGTCCTAA.GTGTTCCAG
CAGTCCTAA.GTTAATTCG	CAGTCCTAA.GTTAATTCG
CAGTCCTAA.TCCTCTAGT	CAGTCCTAA.TCCTCTAGT
CAGTCGGTA.ACACAGAAC	CAGTCGGTA.ACACAGAAC
CAGTCGGTA.GTGCTCTTG	CAGTCGGTA.GTGCTCTTG
CAGTCGGTA.TGGAAGATT	CAGTCGGTA.TGGAAGATT
CAGTCTAAC.ACATTGACA	CAGTCTAAC.ACATTGACA
CAGTCTAAC.TCACGACAA	CAGTCTAAC.TCACGACAA
CAGTGAGGA.AGCATTGTT	CAGTGAGGA.AGCATTGTT
CAGTGAGGA.AGCCTCGCA	CAGTGAGGA.AGCCTCGCA
CAGTGAGGA.AGCTTGGTG	CAGTGAGGA.AGCTTGGTG
CAGTGAGGA.CTAGTATAG	CAGTGAGGA.CTAGTATAG
CAGTGAGGA.TCGAATAGA	CAGTGAGGA.TCGAATAGA
CAGTGAGGA.TTATCGCAC	CAGTGAGGA.TTATCGCAC
CAGTGCCAT.AACAACTGG	CAGTGCCAT.AACAACTGG
CAGTGCCAT.ACACCACAT	CAGTGCCAT.ACACCACAT
CAGTGCCAT.CGAAGAGGT	CAGTGCCAT.CGAAGAGGT
CAGTGCCAT.GACGTTCAG	CAGTGCCAT.GACGTTCAG
