CAGTGCCAT.GATCTAGAG	CAGTGCCAT.GATCTAGAG
CAGTGCCAT.GTAGGACGC	CAGTGCCAT.GTAGGACGC
CAGTGCCAT.GTCACTATG	CAGTGCCAT.GTCACTATG
CAGTGCCAT.TATCGGAAC	CAGTGCCAT.TATCGGAAC
CAGTGCCAT.TGAGCTAGA	CAGTGCCAT.TGAGCTAGA
CAGTGCTGC.ACGCACACT	CAGTGCTGC.ACGCACACT
CAGTGCTGC.ACGTGCTCG	CAGTGCTGC.ACGTGCTCG
CAGTGCTGC.AGCTATATG	CAGTGCTGC.AGCTATATG
CAGTGCTGC.GACTAGCAT	CAGTGCTGC.GACTAGCAT
CAGTTGAGT.AATACTCCG	CAGTTGAGT.AATACTCCG
CAGTTGAGT.AGTGAGAGA	CAGTTGAGT.AGTGAGAGA
CAGTTGAGT.CCAATATAC	CAGTTGAGT.CCAATATAC
CAGTTGAGT.CTTATCTCA	CAGTTGAGT.CTTATCTCA
CAGTTGAGT.GTCTTCATA	CAGTTGAGT.GTCTTCATA
CAGTTGAGT.TGTTACTGA	CAGTTGAGT.TGTTACTGA
CAGTTGAGT.TTCCGCCAG	CAGTTGAGT.TTCCGCCAG
CAGTTGAGT.TTCTGAATG	CAGTTGAGT.TTCTGAATG
CATAATTGG.ACCGGAGTA	CATAATTGG.ACCGGAGTA
CATAATTGG.ACTACCATC	CATAATTGG.ACTACCATC
CATAATTGG.ATCACCGCA	CATAATTGG.ATCACCGCA
CATAATTGG.CCGTACGGA	CATAATTGG.CCGTACGGA
CATAATTGG.CGCTTGTAG	CATAATTGG.CGCTTGTAG
CATAATTGG.CTGAGATAG	CATAATTGG.CTGAGATAG
CATAATTGG.GGTGAGTTC	CATAATTGG.GGTGAGTTC
CATAATTGG.TGATGGACA	CATAATTGG.TGATGGACA
CATACAACC.AGTTACAAG	CATACAACC.AGTTACAAG
CATACAACC.GTGGAGGTC	CATACAACC.GTGGAGGTC
CATACAACC.TCAGTGTTC	CATACAACC.TCAGTGTTC
CATACAACC.TCGCTGTAA	CATACAACC.TCGCTGTAA
CATACGCAG.CCGTCCACT	CATACGCAG.CCGTCCACT
CATACGCAG.GCGACCTGT	CATACGCAG.GCGACCTGT
CATACGCAG.TAGACCGCA	CATACGCAG.TAGACCGCA
CATAGGTGT.ATGCGCTAC	CATAGGTGT.ATGCGCTAC
CATAGGTGT.CAAGAGGAG	CATAGGTGT.CAAGAGGAG
CATAGGTGT.TGCTGCGTC	CATAGGTGT.TGCTGCGTC
CATAGGTGT.TGGACGAGA	CATAGGTGT.TGGACGAGA
CATAGTATG.CTTAACAGC	CATAGTATG.CTTAACAGC
CATAGTATG.GCTCCTAGC	CATAGTATG.GCTCCTAGC
CATAGTATG.GGAAGGTAT	CATAGTATG.GGAAGGTAT
CATAGTATG.TGCTCACAC	CATAGTATG.TGCTCACAC
CATATGCGA.AGACTTCGT	CATATGCGA.AGACTTCGT
CATATGCGA.GAGACATTG	CATATGCGA.GAGACATTG
CATATGCGA.TACCGCGTT	CATATGCGA.TACCGCGTT
CATATGTCG.AGTAAGCCA	CATATGTCG.AGTAAGCCA
CATATGTCG.ATCTGCGTA	CATATGTCG.ATCTGCGTA
CATATGTCG.CCGATCTCT	CATATGTCG.CCGATCTCT
CATATGTCG.GAAGAGCAC	CATATGTCG.GAAGAGCAC
CATATGTCG.GCGACACAG	CATATGTCG.GCGACACAG
CATCAATAG.CGCTGTAGT	CATCAATAG.CGCTGTAGT
CATCAATAG.GACCGCTTC	CATCAATAG.GACCGCTTC
CATCAATAG.GTCGCAGGT	CATCAATAG.GTCGCAGGT
CATCAATAG.TTGCAGTCA	CATCAATAG.TTGCAGTCA
CATCCACCG.CCTGCAGAT	CATCCACCG.CCTGCAGAT
CATCCACCG.GAGGTCACG	CATCCACCG.GAGGTCACG
CATCCACCG.GGAGTACAG	CATCCACCG.GGAGTACAG
CATCCACCG.TCCTGAGAC	CATCCACCG.TCCTGAGAC
CATCCAGGA.ACCTAGTTA	CATCCAGGA.ACCTAGTTA
CATCCAGGA.AGCGGTCTA	CATCCAGGA.AGCGGTCTA
CATCCAGGA.ATGTCGCCT	CATCCAGGA.ATGTCGCCT
CATCCAGGA.CAGTTACTG	CATCCAGGA.CAGTTACTG
CATCCAGGA.CTGTAGAAG	CATCCAGGA.CTGTAGAAG
CATCCAGGA.GTGATGTGC	CATCCAGGA.GTGATGTGC
CATCCGACA.TGCCGAACT	CATCCGACA.TGCCGAACT
CATCCTCTC.ATTATGCAG	CATCCTCTC.ATTATGCAG
CATCCTCTC.CTCTTCAGC	CATCCTCTC.CTCTTCAGC
CATCCTCTC.GACTTGATT	CATCCTCTC.GACTTGATT
CATCCTCTC.TAATGTAGC	CATCCTCTC.TAATGTAGC
CATCGAAGC.ATCGCCTCT	CATCGAAGC.ATCGCCTCT
CATCGAAGC.CTAACTAAG	CATCGAAGC.CTAACTAAG
CATCGAAGC.CTCAGTGAT	CATCGAAGC.CTCAGTGAT
CATCGAAGC.CTGTCTAGT	CATCGAAGC.CTGTCTAGT
CATCGAAGC.GAGATGTAT	CATCGAAGC.GAGATGTAT
CATCGAAGC.GCTTCTGAA	CATCGAAGC.GCTTCTGAA
CATCGAAGC.TGCATCGGA	CATCGAAGC.TGCATCGGA
CATCGCTGG.AACGAGAAT	CATCGCTGG.AACGAGAAT
CATCGCTGG.CAAGCTGCA	CATCGCTGG.CAAGCTGCA
CATCGCTGG.TACAACACC	CATCGCTGG.TACAACACC
CATCTCACG.CTATCCATC	CATCTCACG.CTATCCATC
CATCTCGAT.CCGATCAGC	CATCTCGAT.CCGATCAGC
CATCTCGAT.CCGGTGGTT	CATCTCGAT.CCGGTGGTT
CATCTCGAT.CGAGCTTAC	CATCTCGAT.CGAGCTTAC
CATCTCGAT.GCTGAGCAG	CATCTCGAT.GCTGAGCAG
CATCTCGAT.GTCGTCGAC	CATCTCGAT.GTCGTCGAC
CATCTCGAT.GTCTGAGCC	CATCTCGAT.GTCTGAGCC
CATCTCGAT.TGCTCCTCC	CATCTCGAT.TGCTCCTCC
CATCTCGAT.TTCCATACC	CATCTCGAT.TTCCATACC
CATGACGTT.TACAAGAGG	CATGACGTT.TACAAGAGG
CATGCCAGT.ACCACTAGG	CATGCCAGT.ACCACTAGG
CATGCCAGT.GAGCACATT	CATGCCAGT.GAGCACATT
CATGCCAGT.GCCATTAAG	CATGCCAGT.GCCATTAAG
CATGCCAGT.GGTTGCTAT	CATGCCAGT.GGTTGCTAT
CATGGACTC.ACTATCCTG	CATGGACTC.ACTATCCTG
CATGGACTC.CACCAAGAT	CATGGACTC.CACCAAGAT
CATGGACTC.CCTTAACAT	CATGGACTC.CCTTAACAT
CATGGACTC.GAGACTCGA	CATGGACTC.GAGACTCGA
CATGGACTC.GCGTCGTCT	CATGGACTC.GCGTCGTCT
CATGGACTC.GTCCTAGTT	CATGGACTC.GTCCTAGTT
CATGGTCGA.CATTGACAA	CATGGTCGA.CATTGACAA
CATGGTCGA.GCTGAGCAG	CATGGTCGA.GCTGAGCAG
CATGGTCGA.GGAGATGAG	CATGGTCGA.GGAGATGAG
CATGGTCGA.GGATGCGAA	CATGGTCGA.GGATGCGAA
CATGGTCGA.TTCTGAATG	CATGGTCGA.TTCTGAATG
CATGGTTAC.ACGATGGAA	CATGGTTAC.ACGATGGAA
CATGGTTAC.ATCAAGAGA	CATGGTTAC.ATCAAGAGA
CATGGTTAC.CACTGCTTA	CATGGTTAC.CACTGCTTA
CATGGTTAC.CTACGTTGG	CATGGTTAC.CTACGTTGG
CATGGTTAC.GGTTCAGAC	CATGGTTAC.GGTTCAGAC
CATGGTTAC.TATCTGTCA	CATGGTTAC.TATCTGTCA
CATGTCCTG.AACGCATTG	CATGTCCTG.AACGCATTG
CATGTCCTG.GAGCAGGAA	CATGTCCTG.GAGCAGGAA
CATGTCCTG.GGATGCGAA	CATGTCCTG.GGATGCGAA
CATGTCCTG.GGTAAGGAT	CATGTCCTG.GGTAAGGAT
CATGTGAAC.ATAGCACGG	CATGTGAAC.ATAGCACGG
CATGTGAAC.ATGCTCACC	CATGTGAAC.ATGCTCACC
CATGTGAAC.CAGCAGTAC	CATGTGAAC.CAGCAGTAC
CATGTGAAC.CTTAATCGT	CATGTGAAC.CTTAATCGT
CATTATGTC.GAACAACCA	CATTATGTC.GAACAACCA
CATTATGTC.TACAGGACT	CATTATGTC.TACAGGACT
CATTCAGTT.CTTCCTGAT	CATTCAGTT.CTTCCTGAT
CATTCAGTT.GGAGTTAGC	CATTCAGTT.GGAGTTAGC
CATTCAGTT.GTATACAGA	CATTCAGTT.GTATACAGA
CATTCAGTT.TGCCAATGG	CATTCAGTT.TGCCAATGG
CATTCCGAG.AGCGGTCTA	CATTCCGAG.AGCGGTCTA
CATTCCGAG.ATGCTTCAG	CATTCCGAG.ATGCTTCAG
CATTCCGAG.ATGGACGTT	CATTCCGAG.ATGGACGTT
CATTCCGAG.CCAATATAC	CATTCCGAG.CCAATATAC
CATTCCGAG.CCGCTCATG	CATTCCGAG.CCGCTCATG
CATTCCGAG.GGTCTTGCA	CATTCCGAG.GGTCTTGCA
CATTCGAAT.AGTATGACG	CATTCGAAT.AGTATGACG
CATTCGAAT.CGTCATGGA	CATTCGAAT.CGTCATGGA
CATTCGAAT.GCTGATGTC	CATTCGAAT.GCTGATGTC
CATTCGAAT.GTCACAGAG	CATTCGAAT.GTCACAGAG
CATTGACAA.ACGGTGCCT	CATTGACAA.ACGGTGCCT
CATTGACAA.CACCTACGC	CATTGACAA.CACCTACGC
CATTGACAA.CGTATCGAA	CATTGACAA.CGTATCGAA
CATTGACAA.GAAGAGCAC	CATTGACAA.GAAGAGCAC
CATTGACAA.GAGACGATC	CATTGACAA.GAGACGATC
CATTGACAA.GAGTGCATA	CATTGACAA.GAGTGCATA
CATTGACAA.GCGGACGAA	CATTGACAA.GCGGACGAA
CATTGACAA.GTCATTCTA	CATTGACAA.GTCATTCTA
CATTGCAGA.ATCCAGCTG	CATTGCAGA.ATCCAGCTG
CATTGCAGA.CTCTTCAGC	CATTGCAGA.CTCTTCAGC
CATTGTTCA.AATACGTCT	CATTGTTCA.AATACGTCT
CATTGTTCA.GTGGAGGTC	CATTGTTCA.GTGGAGGTC
CATTGTTCA.TAGTAGTCT	CATTGTTCA.TAGTAGTCT
CATTGTTCA.TGTCAACCT	CATTGTTCA.TGTCAACCT
CCAACAACA.CGGTGTTAC	CCAACAACA.CGGTGTTAC
CCAACAACA.CTGATCCGA	CCAACAACA.CTGATCCGA
CCAACAACA.TAGCGCAGC	CCAACAACA.TAGCGCAGC
CCAACGGAA.ATAACGACA	CCAACGGAA.ATAACGACA
CCAACGGAA.ATCAAGAGA	CCAACGGAA.ATCAAGAGA
CCAAGCGAG.AAGAGAGAG	CCAAGCGAG.AAGAGAGAG
CCAAGCGAG.AGTCAGTTG	CCAAGCGAG.AGTCAGTTG
CCAAGCGAG.TTGGTAACT	CCAAGCGAG.TTGGTAACT
CCAAGTCGA.ACCTAGTTA	CCAAGTCGA.ACCTAGTTA
CCAAGTCGA.ACTGTAATC	CCAAGTCGA.ACTGTAATC
CCAAGTCGA.GCGAAGACA	CCAAGTCGA.GCGAAGACA
CCAATATAC.ACTGGTCAG	CCAATATAC.ACTGGTCAG
CCAATATAC.CAGTCCTAA	CCAATATAC.CAGTCCTAA
CCAATATAC.CCACACAGA	CCAATATAC.CCACACAGA
CCAATATAC.GTACAATGC	CCAATATAC.GTACAATGC
CCAATATAC.TAAGTACAC	CCAATATAC.TAAGTACAC
CCAATATAC.TACTTCCAG	CCAATATAC.TACTTCCAG
CCAATATAC.TGCAGTTCA	CCAATATAC.TGCAGTTCA
CCAATGCCT.ACGACGATT	CCAATGCCT.ACGACGATT
CCAATGCCT.ACTCCTGAG	CCAATGCCT.ACTCCTGAG
CCAATGCCT.ATCTCGTGA	CCAATGCCT.ATCTCGTGA
CCAATGCCT.CAATACCAC	CCAATGCCT.CAATACCAC
CCAATGCCT.CCATGATGT	CCAATGCCT.CCATGATGT
CCAATGCCT.GAACTGCAA	CCAATGCCT.GAACTGCAA
CCAATGCCT.GCGAAGACA	CCAATGCCT.GCGAAGACA
CCAATGCCT.GGTTGCTAT	CCAATGCCT.GGTTGCTAT
CCAATGCCT.TAATGTAGC	CCAATGCCT.TAATGTAGC
CCACAAGGT.ATATAGCGT	CCACAAGGT.ATATAGCGT
CCACAAGGT.CAGCAGTAC	CCACAAGGT.CAGCAGTAC
CCACAAGGT.GACCAGAGA	CCACAAGGT.GACCAGAGA
CCACAAGGT.TGCGTCTTA	CCACAAGGT.TGCGTCTTA
CCACACAGA.GTGTTGGAA	CCACACAGA.GTGTTGGAA
CCACACAGA.TTCAACTAC	CCACACAGA.TTCAACTAC
CCACATTAG.CAACGATCG	CCACATTAG.CAACGATCG
CCACATTAG.TAGTGCACT	CCACATTAG.TAGTGCACT
CCACATTAG.TGTGGTCCT	CCACATTAG.TGTGGTCCT
CCACCATGC.ACGACAGTC	CCACCATGC.ACGACAGTC
CCACCATGC.AGTTCAACC	CCACCATGC.AGTTCAACC
CCACCATGC.GCACGTAGA	CCACCATGC.GCACGTAGA
CCACCATGC.GGATGCGAA	CCACCATGC.GGATGCGAA
CCACGAAGG.AGCGGTCTA	CCACGAAGG.AGCGGTCTA
CCACGAAGG.ATCAAGCAT	CCACGAAGG.ATCAAGCAT
CCACGAAGG.GTGGAGGTC	CCACGAAGG.GTGGAGGTC
CCACGAAGG.TGCAGTCGG	CCACGAAGG.TGCAGTCGG
CCACGCCAT.CTGCTTAGG	CCACGCCAT.CTGCTTAGG
CCACGCCAT.TGAGAATCC	CCACGCCAT.TGAGAATCC
CCACGGATC.CCGTAGTTG	CCACGGATC.CCGTAGTTG
CCACGGATC.CGAACAATC	CCACGGATC.CGAACAATC
CCACGGATC.CTAGAGGTA	CCACGGATC.CTAGAGGTA
CCACGGATC.CTAGGTACT	CCACGGATC.CTAGGTACT
CCACGGATC.CTCTAAGAG	CCACGGATC.CTCTAAGAG
CCACGTTCT.GACTGCGCA	CCACGTTCT.GACTGCGCA
CCACGTTCT.GGAGCTCAA	CCACGTTCT.GGAGCTCAA
CCACTACCA.CCTAGTTAG	CCACTACCA.CCTAGTTAG
CCACTACCA.CTCATGCCA	CCACTACCA.CTCATGCCA
CCACTACCA.GTGCGAGTA	CCACTACCA.GTGCGAGTA
CCACTACCA.TAGCGCAGC	CCACTACCA.TAGCGCAGC
CCACTACCA.TGATTGCTG	CCACTACCA.TGATTGCTG
CCACTGAAG.CCATACGAT	CCACTGAAG.CCATACGAT
CCACTGAAG.CCTCATAAC	CCACTGAAG.CCTCATAAC
CCACTGAAG.TATAGTGCG	CCACTGAAG.TATAGTGCG
CCACTTCGC.AATCTCCTA	CCACTTCGC.AATCTCCTA
CCACTTCGC.CCAAGTCGA	CCACTTCGC.CCAAGTCGA
CCACTTCGC.CGGTCGACA	CCACTTCGC.CGGTCGACA
CCACTTCGC.GCACTGGAT	CCACTTCGC.GCACTGGAT
CCACTTCGC.TGGTGGATC	CCACTTCGC.TGGTGGATC
CCAGATCAC.AGTACGAAT	CCAGATCAC.AGTACGAAT
CCAGATCAC.AGTGAACGG	CCAGATCAC.AGTGAACGG
CCAGATCAC.ATGCGTGGA	CCAGATCAC.ATGCGTGGA
CCAGATCAC.CCACGGATC	CCAGATCAC.CCACGGATC
CCAGATCAC.CTGTCACTT	CCAGATCAC.CTGTCACTT
CCAGATCAC.TGGAATCGT	CCAGATCAC.TGGAATCGT
CCAGCCAAT.AACGCCTAC	CCAGCCAAT.AACGCCTAC
CCAGCCAAT.TATAATCGC	CCAGCCAAT.TATAATCGC
CCAGCCAAT.TCCTTCAAC	CCAGCCAAT.TCCTTCAAC
CCAGCCAAT.TGTAGATCG	CCAGCCAAT.TGTAGATCG
CCAGGAGTT.CCGGTTCTA	CCAGGAGTT.CCGGTTCTA
CCAGGAGTT.CGTGGTACC	CCAGGAGTT.CGTGGTACC
CCAGGAGTT.TACGAACTC	CCAGGAGTT.TACGAACTC
CCAGGAGTT.TGCTCAGCG	CCAGGAGTT.TGCTCAGCG
CCAGTACTC.ATATAGCGT	CCAGTACTC.ATATAGCGT
CCAGTACTC.ATGCCTGTC	CCAGTACTC.ATGCCTGTC
CCAGTACTC.CGAATGAGT	CCAGTACTC.CGAATGAGT
CCAGTACTC.GCGCATTAC	CCAGTACTC.GCGCATTAC
CCAGTACTC.TCCTCGTCG	CCAGTACTC.TCCTCGTCG
CCAGTCTCA.CCTTGCTTG	CCAGTCTCA.CCTTGCTTG
CCAGTCTCA.GTGATGTGC	CCAGTCTCA.GTGATGTGC
CCATAATCG.AACGATGAC	CCATAATCG.AACGATGAC
CCATAATCG.GCTAGTGGA	CCATAATCG.GCTAGTGGA
CCATAATCG.GTCGCAGGT	CCATAATCG.GTCGCAGGT
CCATACGAT.ACCACGGAT	CCATACGAT.ACCACGGAT
CCATACGAT.CCTTCCTCA	CCATACGAT.CCTTCCTCA
CCATACGAT.CTAACCGGT	CCATACGAT.CTAACCGGT
CCATAGCCA.CCATAGCCA	CCATAGCCA.CCATAGCCA
CCATAGCCA.CGCTGTAGT	CCATAGCCA.CGCTGTAGT
CCATAGCCA.CGTCAGCAC	CCATAGCCA.CGTCAGCAC
CCATAGCCA.GCTCAGCCA	CCATAGCCA.GCTCAGCCA
CCATAGCCA.TGGATAGGT	CCATAGCCA.TGGATAGGT
CCATATCTT.ACGTCGCTC	CCATATCTT.ACGTCGCTC
CCATATCTT.ATCACCGCA	CCATATCTT.ATCACCGCA
CCATATCTT.ATGCTGTCG	CCATATCTT.ATGCTGTCG
CCATATCTT.TGGAACTAA	CCATATCTT.TGGAACTAA
CCATATGCC.CCGGTTCTA	CCATATGCC.CCGGTTCTA
CCATATGCC.CCTCTTGTA	CCATATGCC.CCTCTTGTA
CCATATGCC.CCTGTCATT	CCATATGCC.CCTGTCATT
CCATATGCC.CGCGATGTA	CCATATGCC.CGCGATGTA
CCATATGCC.CGCTTATGA	CCATATGCC.CGCTTATGA
CCATATGCC.GTGCTGACT	CCATATGCC.GTGCTGACT
CCATATGCC.GTGTTGGAA	CCATATGCC.GTGTTGGAA
CCATATGCC.TAGCCAGTG	CCATATGCC.TAGCCAGTG
CCATCACGA.ACGGACCAT	CCATCACGA.ACGGACCAT
CCATCTAGG.AGCTCGTCT	CCATCTAGG.AGCTCGTCT
CCATCTAGG.ATGAGATCC	CCATCTAGG.ATGAGATCC
CCATCTAGG.GAGGTCCTT	CCATCTAGG.GAGGTCCTT
CCATCTAGG.TGAGACAGC	CCATCTAGG.TGAGACAGC
CCATCTAGG.TGCCACCGA	CCATCTAGG.TGCCACCGA
CCATGATGT.ACTACCATC	CCATGATGT.ACTACCATC
CCATGATGT.ATAGACCGA	CCATGATGT.ATAGACCGA
CCATGATGT.CTCTAAGAG	CCATGATGT.CTCTAAGAG
CCATGATGT.GTGCACGAG	CCATGATGT.GTGCACGAG
CCATGCGTC.AGCCGTTCT	CCATGCGTC.AGCCGTTCT
CCATGCGTC.GGTAGACAT	CCATGCGTC.GGTAGACAT
CCATGCGTC.TCGCATTCG	CCATGCGTC.TCGCATTCG
CCATGCGTC.TCTTAAGTG	CCATGCGTC.TCTTAAGTG
CCATGCGTC.TTCCAGATT	CCATGCGTC.TTCCAGATT
CCATGCGTC.TTCTGAATG	CCATGCGTC.TTCTGAATG
CCATTACAG.AACAGATCG	CCATTACAG.AACAGATCG
CCATTACAG.ACGCGTGAC	CCATTACAG.ACGCGTGAC
CCATTACAG.CACATGTGC	CCATTACAG.CACATGTGC
CCATTACAG.CATCCAGGA	CCATTACAG.CATCCAGGA
CCATTACAG.CGTGTGTGG	CCATTACAG.CGTGTGTGG
CCATTACAG.GAATCAACC	CCATTACAG.GAATCAACC
CCATTACAG.GTCTTATGC	CCATTACAG.GTCTTATGC
CCATTACAG.TACGGTCGT	CCATTACAG.TACGGTCGT
CCATTACAG.TCGCTGATT	CCATTACAG.TCGCTGATT
CCATTCTGC.AGACGCCTG	CCATTCTGC.AGACGCCTG
CCGAAGCGT.ATAGCTTGC	CCGAAGCGT.ATAGCTTGC
CCGAAGCGT.GAGCCGTTA	CCGAAGCGT.GAGCCGTTA
CCGAATATG.ATCGTAGTG	CCGAATATG.ATCGTAGTG
CCGAATATG.CCTCGCGTT	CCGAATATG.CCTCGCGTT
CCGAATATG.CTTATTGAG	CCGAATATG.CTTATTGAG
CCGAATATG.GCGAAGCTC	CCGAATATG.GCGAAGCTC
CCGAATATG.GGATTCGTC	CCGAATATG.GGATTCGTC
CCGAATATG.TATACCACT	CCGAATATG.TATACCACT
CCGAATATG.TGTTAAGCC	CCGAATATG.TGTTAAGCC
CCGACGTCA.AGGATCTCA	CCGACGTCA.AGGATCTCA
CCGACGTCA.GCAGCTCTT	CCGACGTCA.GCAGCTCTT
CCGACTGTT.AACGTCGAG	CCGACTGTT.AACGTCGAG
CCGACTGTT.AAGCCAAGT	CCGACTGTT.AAGCCAAGT
CCGACTGTT.AATGCTATC	CCGACTGTT.AATGCTATC
CCGACTGTT.ATCCAATGA	CCGACTGTT.ATCCAATGA
CCGACTGTT.TCGCAAGCA	CCGACTGTT.TCGCAAGCA
CCGACTTGG.AGTATGACG	CCGACTTGG.AGTATGACG
CCGACTTGG.GACTCAGTG	CCGACTTGG.GACTCAGTG
CCGAGCTGA.AGCGTCGTC	CCGAGCTGA.AGCGTCGTC
CCGAGCTGA.CGACCATCA	CCGAGCTGA.CGACCATCA
CCGAGCTGA.TATGGTTGG	CCGAGCTGA.TATGGTTGG
CCGAGTACT.ACGCGTGAC	CCGAGTACT.ACGCGTGAC
CCGAGTACT.TAAGGTGAT	CCGAGTACT.TAAGGTGAT
CCGAGTACT.TCCTTCAAC	CCGAGTACT.TCCTTCAAC
CCGAGTACT.TGATGTGTG	CCGAGTACT.TGATGTGTG
CCGATACCG.CCTATTGGT	CCGATACCG.CCTATTGGT
CCGATACCG.TATCAGTGC	CCGATACCG.TATCAGTGC
CCGATCAGC.CAGATCGAC	CCGATCAGC.CAGATCGAC
CCGATCAGC.GCGTATAGG	CCGATCAGC.GCGTATAGG
CCGATCAGC.TAGATCTGT	CCGATCAGC.TAGATCTGT
CCGATCTCT.GACCAACAG	CCGATCTCT.GACCAACAG
CCGATCTCT.GCATTGATC	CCGATCTCT.GCATTGATC
CCGATCTCT.TAGCGAGAA	CCGATCTCT.TAGCGAGAA
CCGATCTCT.TGGAACTAA	CCGATCTCT.TGGAACTAA
CCGATCTCT.TGTTACTGA	CCGATCTCT.TGTTACTGA
CCGATCTCT.TTCCTGCTA	CCGATCTCT.TTCCTGCTA
CCGATGTTC.ACTACCATC	CCGATGTTC.ACTACCATC
CCGATGTTC.CATTCAGTT	CCGATGTTC.CATTCAGTT
CCGATGTTC.CCTATTGGT	CCGATGTTC.CCTATTGGT
CCGATGTTC.TTGCCGTAG	CCGATGTTC.TTGCCGTAG
CCGCAACAC.ACATGACTA	CCGCAACAC.ACATGACTA
CCGCAACAC.ATGTCCTCC	CCGCAACAC.ATGTCCTCC
CCGCAACAC.CCAACAACA	CCGCAACAC.CCAACAACA
CCGCAACAC.GTAGCCTTG	CCGCAACAC.GTAGCCTTG
CCGCAATGG.CTGGACTAA	CCGCAATGG.CTGGACTAA
CCGCAATGG.CTTGCGACC	CCGCAATGG.CTTGCGACC
CCGCAATGG.TAGTCGCAT	CCGCAATGG.TAGTCGCAT
CCGCACTCA.AACGAGAAT	CCGCACTCA.AACGAGAAT
CCGCACTCA.AGCCTCTAG	CCGCACTCA.AGCCTCTAG
CCGCACTCA.CCTGTATCT	CCGCACTCA.CCTGTATCT
CCGCACTCA.CGACAGACC	CCGCACTCA.CGACAGACC
CCGCACTCA.TATTCAACG	CCGCACTCA.TATTCAACG
CCGCACTCA.TCATCTGTC	CCGCACTCA.TCATCTGTC
CCGCACTCA.TGACGATGA	CCGCACTCA.TGACGATGA
CCGCAGAAT.AACTCCATG	CCGCAGAAT.AACTCCATG
CCGCAGAAT.ATGAGTGTG	CCGCAGAAT.ATGAGTGTG
CCGCAGAAT.GATCTACTT	CCGCAGAAT.GATCTACTT
CCGCAGAAT.TGTCATAGC	CCGCAGAAT.TGTCATAGC
CCGCAGCTA.ACAGCATCA	CCGCAGCTA.ACAGCATCA
CCGCAGCTA.TAGAGACTA	CCGCAGCTA.TAGAGACTA
CCGCAGCTA.TAGAGCCAG	CCGCAGCTA.TAGAGCCAG
CCGCAGCTA.TCTTAAGTG	CCGCAGCTA.TCTTAAGTG
CCGCAGCTA.TGCCGAACT	CCGCAGCTA.TGCCGAACT
CCGCATCCT.AAGCTGGTC	CCGCATCCT.AAGCTGGTC
CCGCATCCT.AGATGAGAT	CCGCATCCT.AGATGAGAT
CCGCATCCT.ATGCTCACC	CCGCATCCT.ATGCTCACC
CCGCATCCT.TCATCATCT	CCGCATCCT.TCATCATCT
CCGCATCCT.TCGCAAGCA	CCGCATCCT.TCGCAAGCA
CCGCTATCC.AACTTGTCG	CCGCTATCC.AACTTGTCG
CCGCTATCC.GTGCTGACT	CCGCTATCC.GTGCTGACT
CCGCTCATG.ACCATCTAA	CCGCTCATG.ACCATCTAA
CCGCTCATG.AGTCGCGAC	CCGCTCATG.AGTCGCGAC
CCGCTCATG.CAGATCGAC	CCGCTCATG.CAGATCGAC
CCGCTCATG.CAGGTATCG	CCGCTCATG.CAGGTATCG
CCGCTCATG.CTCAGTGAT	CCGCTCATG.CTCAGTGAT
CCGCTCATG.TCCAGAACG	CCGCTCATG.TCCAGAACG
CCGCTCATG.TTCATCCAA	CCGCTCATG.TTCATCCAA
CCGGATTGC.AGCACCGTG	CCGGATTGC.AGCACCGTG
CCGGATTGC.CATTCCGAG	CCGGATTGC.CATTCCGAG
CCGGATTGC.CGCACTCTT	CCGGATTGC.CGCACTCTT
CCGGATTGC.TAACTCCGA	CCGGATTGC.TAACTCCGA
CCGGATTGC.TCCACGTGC	CCGGATTGC.TCCACGTGC
CCGGATTGC.TGACAAGTT	CCGGATTGC.TGACAAGTT
CCGGTGGTT.CCAATGCCT	CCGGTGGTT.CCAATGCCT
CCGGTGGTT.CCAGTTACG	CCGGTGGTT.CCAGTTACG
CCGGTGGTT.GTTAGTCAA	CCGGTGGTT.GTTAGTCAA
CCGGTGGTT.TGACAAGTT	CCGGTGGTT.TGACAAGTT
CCGGTTCTA.AAGGATACG	CCGGTTCTA.AAGGATACG
CCGGTTCTA.AGTTCGATA	CCGGTTCTA.AGTTCGATA
CCGGTTCTA.ATCTCGAAC	CCGGTTCTA.ATCTCGAAC
CCGGTTCTA.CGCCTGCAA	CCGGTTCTA.CGCCTGCAA
CCGGTTCTA.GACAATGTT	CCGGTTCTA.GACAATGTT
CCGGTTCTA.GATTGGAAG	CCGGTTCTA.GATTGGAAG
CCGGTTCTA.GCAGATCCG	CCGGTTCTA.GCAGATCCG
CCGGTTCTA.GCCGTGAAC	CCGGTTCTA.GCCGTGAAC
CCGGTTCTA.GTAGGACGC	CCGGTTCTA.GTAGGACGC
CCGGTTCTA.TTCACCTTG	CCGGTTCTA.TTCACCTTG
CCGGTTGAG.ACTCGTAGG	CCGGTTGAG.ACTCGTAGG
CCGGTTGAG.CCAACGGAA	CCGGTTGAG.CCAACGGAA
CCGGTTGAG.CCTTAACAT	CCGGTTGAG.CCTTAACAT
CCGGTTGAG.CGGATTCTC	CCGGTTGAG.CGGATTCTC
CCGGTTGAG.GACTCTCAC	CCGGTTGAG.GACTCTCAC
CCGGTTGAG.TATCACCTG	CCGGTTGAG.TATCACCTG
CCGGTTGAG.TTCCAGGAG	CCGGTTGAG.TTCCAGGAG
CCGTACGGA.GTGACTCTC	CCGTACGGA.GTGACTCTC
CCGTACGGA.TGCAGTTCA	CCGTACGGA.TGCAGTTCA
CCGTAGTTG.ACCGAGTAG	CCGTAGTTG.ACCGAGTAG
CCGTAGTTG.ATATAGCGT	CCGTAGTTG.ATATAGCGT
CCGTAGTTG.TCATGCAGG	CCGTAGTTG.TCATGCAGG
CCGTAGTTG.TGCGTCTTA	CCGTAGTTG.TGCGTCTTA
CCGTCAGGT.CGACCTAGC	CCGTCAGGT.CGACCTAGC
CCGTCAGGT.CTCGTCTTG	CCGTCAGGT.CTCGTCTTG
CCGTCAGGT.TTAACGGAG	CCGTCAGGT.TTAACGGAG
CCGTCCACT.AGGTATTCC	CCGTCCACT.AGGTATTCC
CCGTCCACT.CTTAGAAGG	CCGTCCACT.CTTAGAAGG
CCGTCCACT.GGATCAGGT	CCGTCCACT.GGATCAGGT
CCGTCCACT.GGTCTCATG	CCGTCCACT.GGTCTCATG
CCGTTAGAC.CATTCGAAT	CCGTTAGAC.CATTCGAAT
CCGTTCCAA.ATCGTAGTG	CCGTTCCAA.ATCGTAGTG
CCTAAGAAG.AATCCTCGT	CCTAAGAAG.AATCCTCGT
CCTAAGAAG.AGATCTTCA	CCTAAGAAG.AGATCTTCA
CCTAAGAAG.AGTACGAAT	CCTAAGAAG.AGTACGAAT
CCTAAGAAG.ATACCGCTT	CCTAAGAAG.ATACCGCTT
CCTAAGAAG.CATTGACAA	CCTAAGAAG.CATTGACAA
CCTAAGAAG.CCTCATAAC	CCTAAGAAG.CCTCATAAC
CCTAAGAAG.CTCGTTCAC	CCTAAGAAG.CTCGTTCAC
CCTAAGAAG.GCGCTTCTC	CCTAAGAAG.GCGCTTCTC
CCTAAGAAG.GTCCGCTCA	CCTAAGAAG.GTCCGCTCA
CCTAAGAAG.TTACGGACC	CCTAAGAAG.TTACGGACC
CCTAAGTCT.AGCAGACAA	CCTAAGTCT.AGCAGACAA
CCTAAGTCT.CTCTCAGTC	CCTAAGTCT.CTCTCAGTC
CCTAAGTCT.TGCTTACGG	CCTAAGTCT.TGCTTACGG
CCTACTAGA.CCATGCGTC	CCTACTAGA.CCATGCGTC
CCTACTAGA.TACGAGTGA	CCTACTAGA.TACGAGTGA
CCTACTAGA.TCACAGGTA	CCTACTAGA.TCACAGGTA
CCTACTAGA.TGAGGTCTC	CCTACTAGA.TGAGGTCTC
CCTAGAGTA.CGCTTATGA	CCTAGAGTA.CGCTTATGA
CCTAGAGTA.CTCCTGACG	CCTAGAGTA.CTCCTGACG
CCTAGAGTA.TCGTCCGAT	CCTAGAGTA.TCGTCCGAT
CCTAGCAAT.ACAAGTACA	CCTAGCAAT.ACAAGTACA
CCTAGCAAT.ATTGATCAC	CCTAGCAAT.ATTGATCAC
CCTAGCAAT.GCAACACCT	CCTAGCAAT.GCAACACCT
CCTAGCAAT.TAACGGATA	CCTAGCAAT.TAACGGATA
CCTAGCAAT.TATCACCTG	CCTAGCAAT.TATCACCTG
CCTAGCAAT.TCAAGCGTA	CCTAGCAAT.TCAAGCGTA
CCTAGTCTC.CCGCAACAC	CCTAGTCTC.CCGCAACAC
CCTAGTCTC.GTGACTCTC	CCTAGTCTC.GTGACTCTC
CCTAGTCTC.TTCAGTGCC	CCTAGTCTC.TTCAGTGCC
CCTAGTTAG.AGCGGTAAG	CCTAGTTAG.AGCGGTAAG
CCTAGTTAG.TCCACGTGC	CCTAGTTAG.TCCACGTGC
CCTATTCAA.ACGTTCAAT	CCTATTCAA.ACGTTCAAT
CCTATTCAA.CAGCTGGAG	CCTATTCAA.CAGCTGGAG
CCTATTCAA.CGTCAGCAC	CCTATTCAA.CGTCAGCAC
CCTATTCAA.GTGCTAAGC	CCTATTCAA.GTGCTAAGC
CCTATTCAA.TACAACACC	CCTATTCAA.TACAACACC
CCTATTCAA.TGGATAGGT	CCTATTCAA.TGGATAGGT
CCTATTGGT.ACGCGTGAC	CCTATTGGT.ACGCGTGAC
CCTATTGGT.AGGTATTCC	CCTATTGGT.AGGTATTCC
CCTATTGGT.CTGAGGTTA	CCTATTGGT.CTGAGGTTA
CCTATTGGT.TGGAACTAA	CCTATTGGT.TGGAACTAA
CCTCATAAC.AGTGAACGG	CCTCATAAC.AGTGAACGG
CCTCATAAC.CCGGTTCTA	CCTCATAAC.CCGGTTCTA
CCTCATAAC.CTATTAAGG	CCTCATAAC.CTATTAAGG
CCTCATAAC.CTGTACGAC	CCTCATAAC.CTGTACGAC
CCTCATAAC.CTGTTACCA	CCTCATAAC.CTGTTACCA
CCTCCAATC.AATACCTTG	CCTCCAATC.AATACCTTG
CCTCCAATC.CCTAAGTCT	CCTCCAATC.CCTAAGTCT
CCTCCAATC.TAGAGACTA	CCTCCAATC.TAGAGACTA
CCTCCTTGT.AATGCTATC	CCTCCTTGT.AATGCTATC
CCTCCTTGT.AGTGTGCAC	CCTCCTTGT.AGTGTGCAC
CCTCCTTGT.GCCTTCCAT	CCTCCTTGT.GCCTTCCAT
CCTCCTTGT.GGATGCTCG	CCTCCTTGT.GGATGCTCG
CCTCCTTGT.GTATGCCTT	CCTCCTTGT.GTATGCCTT
CCTCGACCT.AACAGCAGT	CCTCGACCT.AACAGCAGT
CCTCGACCT.CACACCACA	CCTCGACCT.CACACCACA
CCTCGACCT.CGTGTGTGG	CCTCGACCT.CGTGTGTGG
CCTCGACCT.CTAACCGGT	CCTCGACCT.CTAACCGGT
CCTCGACCT.CTGAGATAG	CCTCGACCT.CTGAGATAG
CCTCGACCT.CTGATGCAC	CCTCGACCT.CTGATGCAC
CCTCGACCT.TAGCTAAGA	CCTCGACCT.TAGCTAAGA
CCTCGACCT.TCCGATCTG	CCTCGACCT.TCCGATCTG
CCTCGACCT.TGGTCTACG	CCTCGACCT.TGGTCTACG
CCTCGAGAG.AATTCGGAA	CCTCGAGAG.AATTCGGAA
CCTCGAGAG.ACAGCATCA	CCTCGAGAG.ACAGCATCA
CCTCGAGAG.AGGATTACT	CCTCGAGAG.AGGATTACT
CCTCGAGAG.GCTACAATG	CCTCGAGAG.GCTACAATG
CCTCGAGAG.GTAAGTGAG	CCTCGAGAG.GTAAGTGAG
CCTCGAGAG.TACCTCCTC	CCTCGAGAG.TACCTCCTC
CCTCGCGTT.ACACACCGT	CCTCGCGTT.ACACACCGT
CCTCGCGTT.TGTTAAGCC	CCTCGCGTT.TGTTAAGCC
CCTCGGTCA.GCTCTGTGT	CCTCGGTCA.GCTCTGTGT
CCTCTCTAG.ACGGTGTAC	CCTCTCTAG.ACGGTGTAC
CCTCTCTAG.CCGTAGTTG	CCTCTCTAG.CCGTAGTTG
CCTCTCTAG.GGTGTGACC	CCTCTCTAG.GGTGTGACC
CCTCTCTAG.GTCGAGTAC	CCTCTCTAG.GTCGAGTAC
CCTCTCTAG.TGCGCTGCA	CCTCTCTAG.TGCGCTGCA
CCTCTGCAT.AGCCGTTCT	CCTCTGCAT.AGCCGTTCT
CCTCTGCAT.CGACGTGAT	CCTCTGCAT.CGACGTGAT
CCTCTGCAT.CTTAACAGC	CCTCTGCAT.CTTAACAGC
CCTCTGCAT.GCTCTGTGT	CCTCTGCAT.GCTCTGTGT
CCTCTTGTA.CTTCTGAGT	CCTCTTGTA.CTTCTGAGT
CCTGACCTC.AGGATCTCA	CCTGACCTC.AGGATCTCA
CCTGACCTC.GTGTACCGT	CCTGACCTC.GTGTACCGT
CCTGACCTC.TGCCAGACG	CCTGACCTC.TGCCAGACG
CCTGCAGAT.ACTCACGAA	CCTGCAGAT.ACTCACGAA
CCTGCAGAT.TACGAACTC	CCTGCAGAT.TACGAACTC
CCTGCGTTA.AAGACTACC	CCTGCGTTA.AAGACTACC
CCTGCGTTA.CTTAAGTTG	CCTGCGTTA.CTTAAGTTG
CCTGCGTTA.GATCGATAC	CCTGCGTTA.GATCGATAC
CCTGCGTTA.GGTCTCATG	CCTGCGTTA.GGTCTCATG
CCTGCGTTA.TCTACAGTT	CCTGCGTTA.TCTACAGTT
CCTGCTCCA.ATAGCACGG	CCTGCTCCA.ATAGCACGG
CCTGCTCCA.CAGGATCAA	CCTGCTCCA.CAGGATCAA
CCTGCTCCA.GGAACCTAG	CCTGCTCCA.GGAACCTAG
CCTGCTCCA.GTGCCATGA	CCTGCTCCA.GTGCCATGA
CCTGCTCCA.TTAGTCGGA	CCTGCTCCA.TTAGTCGGA
CCTGTATCT.ATCCACAGT	CCTGTATCT.ATCCACAGT
CCTGTATCT.ATTCTCTGG	CCTGTATCT.ATTCTCTGG
