ACCGTCCTA.ATGGAGAGT	ACCGTCCTA.ATGGAGAGT
ACCGTCCTA.CTTCACTGT	ACCGTCCTA.CTTCACTGT
ACCGTCCTA.GCTGGTAAC	ACCGTCCTA.GCTGGTAAC
ACCGTCCTA.TGTGTAGAG	ACCGTCCTA.TGTGTAGAG
ACCTAGTTA.AGTCGTCCG	ACCTAGTTA.AGTCGTCCG
ACCTAGTTA.CCGTCAGGT	ACCTAGTTA.CCGTCAGGT
ACCTAGTTA.GCGAACTCG	ACCTAGTTA.GCGAACTCG
ACCTAGTTA.GCGATGGTG	ACCTAGTTA.GCGATGGTG
ACCTAGTTA.GTCGTTAGA	ACCTAGTTA.GTCGTTAGA
ACCTAGTTA.TCTTGGTAG	ACCTAGTTA.TCTTGGTAG
ACCTCCTAG.CCGCAGCTA	ACCTCCTAG.CCGCAGCTA
ACCTGCAGA.AATACCTTG	ACCTGCAGA.AATACCTTG
ACCTGCAGA.ACGCGACAG	ACCTGCAGA.ACGCGACAG
ACCTGCAGA.ATAGTCTCC	ACCTGCAGA.ATAGTCTCC
ACCTGCAGA.CAACGCACA	ACCTGCAGA.CAACGCACA
ACCTGCAGA.GGATAGTCA	ACCTGCAGA.GGATAGTCA
ACCTGTACC.AACGCTCAA	ACCTGTACC.AACGCTCAA
ACCTGTACC.AGACGGAGG	ACCTGTACC.AGACGGAGG
ACCTGTACC.CAACTAATC	ACCTGTACC.CAACTAATC
ACCTGTACC.CAGCTTACC	ACCTGTACC.CAGCTTACC
ACCTGTACC.CTAGGTACT	ACCTGTACC.CTAGGTACT
ACCTGTACC.TTCATTCGC	ACCTGTACC.TTCATTCGC
ACCTTGAAG.ATATGTCCA	ACCTTGAAG.ATATGTCCA
ACCTTGAAG.CGCATAACT	ACCTTGAAG.CGCATAACT
ACCTTGAAG.CTATAGCTC	ACCTTGAAG.CTATAGCTC
ACCTTGAAG.GGATAGTCA	ACCTTGAAG.GGATAGTCA
ACGAATCGC.GGACTATTC	ACGAATCGC.GGACTATTC
ACGACAGTC.ACACATCTG	ACGACAGTC.ACACATCTG
ACGACAGTC.CCGATGTTC	ACGACAGTC.CCGATGTTC
ACGACATCT.CAACACTCC	ACGACATCT.CAACACTCC
ACGACATCT.CAGCTGGAG	ACGACATCT.CAGCTGGAG
ACGACATCT.CCAGTCTCA	ACGACATCT.CCAGTCTCA
ACGACATCT.TGACCTATG	ACGACATCT.TGACCTATG
ACGACATCT.TTCCGAGCG	ACGACATCT.TTCCGAGCG
ACGACGATT.ATTAGCCAC	ACGACGATT.ATTAGCCAC
ACGACGATT.CAATACCAC	ACGACGATT.CAATACCAC
ACGACGATT.CGCCATTAC	ACGACGATT.CGCCATTAC
ACGACGATT.GAGATACAC	ACGACGATT.GAGATACAC
ACGACGATT.GTAACAGTC	ACGACGATT.GTAACAGTC
ACGAGAGCA.AGTGACGAT	ACGAGAGCA.AGTGACGAT
ACGAGAGCA.CCATATGCC	ACGAGAGCA.CCATATGCC
ACGAGAGCA.CCGACGTCA	ACGAGAGCA.CCGACGTCA
ACGAGAGCA.CCTATTCAA	ACGAGAGCA.CCTATTCAA
ACGAGAGCA.TGACGGTTG	ACGAGAGCA.TGACGGTTG
ACGAGAGCA.TTCCTGCTA	ACGAGAGCA.TTCCTGCTA
ACGAGCTTC.AGCGCATGA	ACGAGCTTC.AGCGCATGA
ACGAGCTTC.AGCGGTAAG	ACGAGCTTC.AGCGGTAAG
ACGAGCTTC.ATATAGCGT	ACGAGCTTC.ATATAGCGT
ACGAGCTTC.CGTGACCAG	ACGAGCTTC.CGTGACCAG
ACGATGACC.GCATGTAAG	ACGATGACC.GCATGTAAG
ACGATGACC.TACGAACTC	ACGATGACC.TACGAACTC
ACGATGACC.TAGTCAGAC	ACGATGACC.TAGTCAGAC
ACGATGACC.TCCTGAGAC	ACGATGACC.TCCTGAGAC
ACGATGACC.TGAGGTCTC	ACGATGACC.TGAGGTCTC
ACGATGGAA.AGATATGGA	ACGATGGAA.AGATATGGA
ACGATGGAA.ATTCCGTAC	ACGATGGAA.ATTCCGTAC
ACGATGGAA.CGAAGAGGT	ACGATGGAA.CGAAGAGGT
ACGATGGAA.GCCACATGG	ACGATGGAA.GCCACATGG
ACGCAAGAT.CTGTGGTGG	ACGCAAGAT.CTGTGGTGG
ACGCAAGAT.GAGAATCAG	ACGCAAGAT.GAGAATCAG
ACGCAAGAT.TACTCGACC	ACGCAAGAT.TACTCGACC
ACGCAAGAT.TGCGACGTT	ACGCAAGAT.TGCGACGTT
ACGCACACT.ATAATCGAG	ACGCACACT.ATAATCGAG
ACGCACACT.CTTAACAGC	ACGCACACT.CTTAACAGC
ACGCACACT.GCTGGTTCG	ACGCACACT.GCTGGTTCG
ACGCACACT.GGTACGAGC	ACGCACACT.GGTACGAGC
ACGCACACT.TCTAGTGAC	ACGCACACT.TCTAGTGAC
ACGCACACT.TGGTCTACG	ACGCACACT.TGGTCTACG
ACGCACACT.TTAGCGTCT	ACGCACACT.TTAGCGTCT
ACGCGACAG.GGTACGAGC	ACGCGACAG.GGTACGAGC
ACGCGACAG.TCATCTGTC	ACGCGACAG.TCATCTGTC
ACGCGTGAC.ACGTAGTAT	ACGCGTGAC.ACGTAGTAT
ACGCGTGAC.CCGATCAGC	ACGCGTGAC.CCGATCAGC
ACGCGTGAC.CTTAGGACT	ACGCGTGAC.CTTAGGACT
ACGCGTGAC.TAAGGTCCG	ACGCGTGAC.TAAGGTCCG
ACGCGTGAC.TACATGCAC	ACGCGTGAC.TACATGCAC
ACGCGTGAC.TTACCTCTC	ACGCGTGAC.TTACCTCTC
ACGCGTGAC.TTAGGAAGG	ACGCGTGAC.TTAGGAAGG
ACGCTAGTG.AATTAGAGG	ACGCTAGTG.AATTAGAGG
ACGCTAGTG.AGCATATGG	ACGCTAGTG.AGCATATGG
ACGCTAGTG.ATAGTGGTT	ACGCTAGTG.ATAGTGGTT
ACGCTAGTG.CGTCAGCAC	ACGCTAGTG.CGTCAGCAC
ACGCTAGTG.GTGCTCGGA	ACGCTAGTG.GTGCTCGGA
ACGCTAGTG.TAACGTGTC	ACGCTAGTG.TAACGTGTC
ACGCTATGT.AATAACTCC	ACGCTATGT.AATAACTCC
ACGCTATGT.ACTCGTCTA	ACGCTATGT.ACTCGTCTA
ACGCTATGT.ATAGACCGA	ACGCTATGT.ATAGACCGA
ACGCTATGT.CATTGACAA	ACGCTATGT.CATTGACAA
ACGCTATGT.CCACGCCAT	ACGCTATGT.CCACGCCAT
ACGCTATGT.CTCCTATCT	ACGCTATGT.CTCCTATCT
ACGCTATGT.GAAGGATCA	ACGCTATGT.GAAGGATCA
ACGCTATGT.TGACCAAGT	ACGCTATGT.TGACCAAGT
ACGCTATGT.TTCACCTTG	ACGCTATGT.TTCACCTTG
ACGCTATGT.TTCCGCCAG	ACGCTATGT.TTCCGCCAG
ACGCTCTTA.AGGAGCAAT	ACGCTCTTA.AGGAGCAAT
ACGGACCAT.CACCTACGC	ACGGACCAT.CACCTACGC
ACGGACCAT.CCGGTTCTA	ACGGACCAT.CCGGTTCTA
ACGGACCAT.CGTCTGTCC	ACGGACCAT.CGTCTGTCC
ACGGTGCCT.ACACAGAAC	ACGGTGCCT.ACACAGAAC
ACGGTGCCT.AGTTGCCTT	ACGGTGCCT.AGTTGCCTT
ACGGTGCCT.CACCTACGC	ACGGTGCCT.CACCTACGC
ACGGTGCCT.CCACTACCA	ACGGTGCCT.CCACTACCA
ACGGTGCCT.TAGATAGCC	ACGGTGCCT.TAGATAGCC
ACGGTGTAC.TGATGACAG	ACGGTGTAC.TGATGACAG
ACGTACTGC.ATTCACCTC	ACGTACTGC.ATTCACCTC
ACGTACTGC.CAAGAGAGT	ACGTACTGC.CAAGAGAGT
ACGTACTGC.TTGTAATGC	ACGTACTGC.TTGTAATGC
ACGTAGTAT.CCGAGCTGA	ACGTAGTAT.CCGAGCTGA
ACGTATGTC.AACGCCTAC	ACGTATGTC.AACGCCTAC
ACGTATGTC.GTGCGTTCC	ACGTATGTC.GTGCGTTCC
ACGTATGTC.TGGTGCCTG	ACGTATGTC.TGGTGCCTG
ACGTATGTC.TTGACCTGA	ACGTATGTC.TTGACCTGA
ACGTCGCTC.AATCTGACC	ACGTCGCTC.AATCTGACC
ACGTCGCTC.ACAAGTACA	ACGTCGCTC.ACAAGTACA
ACGTCGCTC.AGCTATATG	ACGTCGCTC.AGCTATATG
ACGTCGCTC.ATCGGTGGT	ACGTCGCTC.ATCGGTGGT
ACGTCGCTC.CAAGTCGAA	ACGTCGCTC.CAAGTCGAA
ACGTCTATG.ACCAGCGTT	ACGTCTATG.ACCAGCGTT
ACGTCTATG.AGAATCAGA	ACGTCTATG.AGAATCAGA
ACGTCTATG.ATCGGTGGT	ACGTCTATG.ATCGGTGGT
ACGTGAATC.ACCTAGTTA	ACGTGAATC.ACCTAGTTA
ACGTGAATC.ACTCGAGTC	ACGTGAATC.ACTCGAGTC
ACGTGAATC.CCAATGCCT	ACGTGAATC.CCAATGCCT
ACGTGAATC.GCGATATGA	ACGTGAATC.GCGATATGA
ACGTGCTCG.AACTTGTCG	ACGTGCTCG.AACTTGTCG
ACGTGCTCG.TGTGTCTAC	ACGTGCTCG.TGTGTCTAC
ACGTGTAGT.GAGGTCACG	ACGTGTAGT.GAGGTCACG
ACGTGTAGT.TAGGAGCTA	ACGTGTAGT.TAGGAGCTA
ACGTTCAAT.ACCATCTAA	ACGTTCAAT.ACCATCTAA
ACGTTCAAT.ACGTGTAGT	ACGTTCAAT.ACGTGTAGT
ACGTTCAAT.ATACTTGCT	ACGTTCAAT.ATACTTGCT
ACGTTCAAT.CCATTACAG	ACGTTCAAT.CCATTACAG
ACGTTCAAT.GTTAGTCAA	ACGTTCAAT.GTTAGTCAA
ACTAACCGA.ACAAGAATG	ACTAACCGA.ACAAGAATG
ACTAACCGA.TGATTCACC	ACTAACCGA.TGATTCACC
ACTAAGTTC.ACCACTAGG	ACTAAGTTC.ACCACTAGG
ACTAAGTTC.AGTGTGCAC	ACTAAGTTC.AGTGTGCAC
ACTAAGTTC.CCACGCCAT	ACTAAGTTC.CCACGCCAT
ACTAAGTTC.CCTCGGTCA	ACTAAGTTC.CCTCGGTCA
ACTAAGTTC.GATTCCTCT	ACTAAGTTC.GATTCCTCT
ACTACCATC.AAGTTCTCT	ACTACCATC.AAGTTCTCT
ACTACCATC.CAATCTCCG	ACTACCATC.CAATCTCCG
ACTACCATC.CAATGTGCT	ACTACCATC.CAATGTGCT
ACTACCATC.CTCCGCATT	ACTACCATC.CTCCGCATT
ACTACCATC.GGAATTCAC	ACTACCATC.GGAATTCAC
ACTACTCAT.CACCTCAAC	ACTACTCAT.CACCTCAAC
ACTACTCAT.CCATACGAT	ACTACTCAT.CCATACGAT
ACTACTCAT.GAATAAGAG	ACTACTCAT.GAATAAGAG
ACTATCCTG.CTCTGTCAA	ACTATCCTG.CTCTGTCAA
ACTATCCTG.GAATCACAT	ACTATCCTG.GAATCACAT
ACTATCCTG.TAGACCGCA	ACTATCCTG.TAGACCGCA
ACTATTGTC.CGGTTCTAT	ACTATTGTC.CGGTTCTAT
ACTATTGTC.GGAGATGAG	ACTATTGTC.GGAGATGAG
ACTATTGTC.GGTGTGACC	ACTATTGTC.GGTGTGACC
ACTATTGTC.TAGAGCCAG	ACTATTGTC.TAGAGCCAG
ACTATTGTC.TATGTACCT	ACTATTGTC.TATGTACCT
ACTCACGAA.AACAACCTA	ACTCACGAA.AACAACCTA
ACTCACGAA.AGTCGATCA	ACTCACGAA.AGTCGATCA
ACTCATTCA.AATTAGAGG	ACTCATTCA.AATTAGAGG
ACTCATTCA.ACGTTCAAT	ACTCATTCA.ACGTTCAAT
ACTCATTCA.GGAGTTAGC	ACTCATTCA.GGAGTTAGC
ACTCATTCA.GGATTACGC	ACTCATTCA.GGATTACGC
ACTCATTCA.GTATGTATC	ACTCATTCA.GTATGTATC
ACTCCAACT.AACTAACTG	ACTCCAACT.AACTAACTG
ACTCCAACT.AGAATCAGA	ACTCCAACT.AGAATCAGA
ACTCCAACT.CCTCCAATC	ACTCCAACT.CCTCCAATC
ACTCCAACT.CCTGTTAGC	ACTCCAACT.CCTGTTAGC
ACTCCAACT.CTCGCAAGA	ACTCCAACT.CTCGCAAGA
ACTCCAACT.TACCATGTA	ACTCCAACT.TACCATGTA
ACTCCAACT.TGATGGACA	ACTCCAACT.TGATGGACA
ACTCCGGTT.CTGATGCAC	ACTCCGGTT.CTGATGCAC
ACTCCGGTT.GGTCCTGGT	ACTCCGGTT.GGTCCTGGT
ACTCCGTCG.ACAGGTATC	ACTCCGTCG.ACAGGTATC
ACTCCTGAG.AATGTGCGT	ACTCCTGAG.AATGTGCGT
ACTCCTGAG.CCGGTGGTT	ACTCCTGAG.CCGGTGGTT
ACTCCTGAG.GCATACTCC	ACTCCTGAG.GCATACTCC
ACTCCTGAG.GTATGCCTT	ACTCCTGAG.GTATGCCTT
ACTCGAGTC.CAGAAGTGA	ACTCGAGTC.CAGAAGTGA
ACTCGAGTC.CGAGTAGCA	ACTCGAGTC.CGAGTAGCA
ACTCGCTGT.AGACCACGC	ACTCGCTGT.AGACCACGC
ACTCGCTGT.CGTTGATCC	ACTCGCTGT.CGTTGATCC
ACTCGCTGT.GCCATCGCT	ACTCGCTGT.GCCATCGCT
ACTCGTAGG.ACGGACCAT	ACTCGTAGG.ACGGACCAT
ACTCGTAGG.CCGCAGAAT	ACTCGTAGG.CCGCAGAAT
ACTCGTAGG.CCTCGGTCA	ACTCGTAGG.CCTCGGTCA
ACTCGTCTA.GCTTCACTC	ACTCGTCTA.GCTTCACTC
ACTCGTCTA.GTATCCTGC	ACTCGTCTA.GTATCCTGC
ACTCGTCTA.GTCAAGATC	ACTCGTCTA.GTCAAGATC
ACTCGTCTA.TGTTAAGCC	ACTCGTCTA.TGTTAAGCC
ACTCTAGGA.AATGCTGAT	ACTCTAGGA.AATGCTGAT
ACTCTAGGA.CATACGCAG	ACTCTAGGA.CATACGCAG
ACTCTAGGA.GACCAGAGA	ACTCTAGGA.GACCAGAGA
ACTCTCACA.AGTGGAATG	ACTCTCACA.AGTGGAATG
ACTCTCACA.ATCCAATGA	ACTCTCACA.ATCCAATGA
ACTCTCACA.CAGTTGAGT	ACTCTCACA.CAGTTGAGT
ACTCTCACA.CCAACGGAA	ACTCTCACA.CCAACGGAA
ACTCTCACA.CCTGTCATT	ACTCTCACA.CCTGTCATT
ACTCTCACA.GCGGAGATT	ACTCTCACA.GCGGAGATT
ACTCTCACA.GTGGTACGG	ACTCTCACA.GTGGTACGG
ACTCTCACA.TAACATTGG	ACTCTCACA.TAACATTGG
ACTCTCACA.TGACCTCCT	ACTCTCACA.TGACCTCCT
ACTCTGCTC.CAGTACATC	ACTCTGCTC.CAGTACATC
ACTCTGCTC.CCTACTAGA	ACTCTGCTC.CCTACTAGA
ACTCTGCTC.GAACCAGTT	ACTCTGCTC.GAACCAGTT
ACTCTGCTC.GCTCAGCCA	ACTCTGCTC.GCTCAGCCA
ACTCTGCTC.TGTTAAGCC	ACTCTGCTC.TGTTAAGCC
ACTGACTAC.AAGCATTGC	ACTGACTAC.AAGCATTGC
ACTGACTAC.ACGCTATGT	ACTGACTAC.ACGCTATGT
ACTGACTAC.CCTCCTTGT	ACTGACTAC.CCTCCTTGT
ACTGACTAC.GCCTGGAAT	ACTGACTAC.GCCTGGAAT
ACTGACTAC.TAGCACACG	ACTGACTAC.TAGCACACG
ACTGACTAC.TCAGAGCGT	ACTGACTAC.TCAGAGCGT
ACTGCTAGT.ACATGGATT	ACTGCTAGT.ACATGGATT
ACTGCTAGT.CGTATCGAA	ACTGCTAGT.CGTATCGAA
ACTGCTAGT.GAATTCAGT	ACTGCTAGT.GAATTCAGT
ACTGCTAGT.GTATTACTG	ACTGCTAGT.GTATTACTG
ACTGCTAGT.TATAGTGCG	ACTGCTAGT.TATAGTGCG
ACTGGACCA.AAGTACAGA	ACTGGACCA.AAGTACAGA
ACTGGTCAG.TAGTACGTA	ACTGGTCAG.TAGTACGTA
ACTGGTCAG.TCAGCTCAG	ACTGGTCAG.TCAGCTCAG
ACTGGTCAG.TCGTCATTC	ACTGGTCAG.TCGTCATTC
ACTGGTGCT.ACCTCCTAG	ACTGGTGCT.ACCTCCTAG
ACTGGTGCT.TGCCAATGG	ACTGGTGCT.TGCCAATGG
ACTGTAATC.CACCTAGCG	ACTGTAATC.CACCTAGCG
ACTGTAATC.GGTGAGCGT	ACTGTAATC.GGTGAGCGT
ACTGTGTCA.AACGCCTAC	ACTGTGTCA.AACGCCTAC
ACTGTGTCA.CCTGACCTC	ACTGTGTCA.CCTGACCTC
ACTGTGTCA.CTCATTAGT	ACTGTGTCA.CTCATTAGT
ACTGTGTCA.GTTATCGAT	ACTGTGTCA.GTTATCGAT
ACTTAGCTT.AGAAGAGTC	ACTTAGCTT.AGAAGAGTC
ACTTAGCTT.ATCAAGAGA	ACTTAGCTT.ATCAAGAGA
ACTTAGCTT.CGAGCTTAC	ACTTAGCTT.CGAGCTTAC
ACTTAGCTT.CGGAACGAG	ACTTAGCTT.CGGAACGAG
ACTTAGCTT.CTTAGGACT	ACTTAGCTT.CTTAGGACT
ACTTAGCTT.GAGGTGAGC	ACTTAGCTT.GAGGTGAGC
ACTTAGCTT.GATGTAAGG	ACTTAGCTT.GATGTAAGG
ACTTAGCTT.GATTGGAAG	ACTTAGCTT.GATTGGAAG
ACTTAGCTT.GCCTGCATC	ACTTAGCTT.GCCTGCATC
ACTTAGCTT.GTACCACAA	ACTTAGCTT.GTACCACAA
ACTTCAGTA.ATATCAGCC	ACTTCAGTA.ATATCAGCC
ACTTCAGTA.CGGTGTTAC	ACTTCAGTA.CGGTGTTAC
ACTTCAGTA.CTATCCATC	ACTTCAGTA.CTATCCATC
ACTTCAGTA.CTCTGCAAG	ACTTCAGTA.CTCTGCAAG
ACTTCAGTA.GACTAGCAT	ACTTCAGTA.GACTAGCAT
ACTTCGCAG.ACGACAGTC	ACTTCGCAG.ACGACAGTC
ACTTCGCAG.CAATACCAC	ACTTCGCAG.CAATACCAC
ACTTCGCAG.GGATCGTTC	ACTTCGCAG.GGATCGTTC
ACTTCGCAG.TACCATGTA	ACTTCGCAG.TACCATGTA
ACTTCGCAG.TCCGTATAC	ACTTCGCAG.TCCGTATAC
ACTTCTAAC.ATACCGAAG	ACTTCTAAC.ATACCGAAG
ACTTCTAAC.GAACTATGG	ACTTCTAAC.GAACTATGG
ACTTCTAAC.TCGTACCTT	ACTTCTAAC.TCGTACCTT
ACTTCTAAC.TGGAAGATT	ACTTCTAAC.TGGAAGATT
ACTTCTTGG.CCGTACGGA	ACTTCTTGG.CCGTACGGA
ACTTCTTGG.GTTATCGAT	ACTTCTTGG.GTTATCGAT
ACTTGATCT.ACGGACCAT	ACTTGATCT.ACGGACCAT
ACTTGATCT.CGATTCGAG	ACTTGATCT.CGATTCGAG
ACTTGATCT.GGTTGCTAT	ACTTGATCT.GGTTGCTAT
ACTTGATCT.GTTGATGCA	ACTTGATCT.GTTGATGCA
ACTTGATCT.TCTATTAGG	ACTTGATCT.TCTATTAGG
AGAAGAGTC.CCAAGCGAG	AGAAGAGTC.CCAAGCGAG
AGAAGAGTC.CTGGTGACA	AGAAGAGTC.CTGGTGACA
AGAAGAGTC.GAGATTCCT	AGAAGAGTC.GAGATTCCT
AGAAGAGTC.TCAATCTAG	AGAAGAGTC.TCAATCTAG
AGAAGCTGC.CAGTGCCAT	AGAAGCTGC.CAGTGCCAT
AGAAGCTGC.TCGCTGATT	AGAAGCTGC.TCGCTGATT
AGAAGTAAC.AATTGGATC	AGAAGTAAC.AATTGGATC
AGAAGTAAC.CTGTGCTCA	AGAAGTAAC.CTGTGCTCA
AGAAGTAAC.GTACCACAA	AGAAGTAAC.GTACCACAA
AGAAGTCCT.CCATATCTT	AGAAGTCCT.CCATATCTT
AGAAGTCCT.CCTAGCAAT	AGAAGTCCT.CCTAGCAAT
AGAAGTCCT.TCGCCAAGC	AGAAGTCCT.TCGCCAAGC
AGAATCAGA.AGTTCAACC	AGAATCAGA.AGTTCAACC
AGAATCAGA.GCTACAATG	AGAATCAGA.GCTACAATG
AGAATCAGA.GGTGCGTAG	AGAATCAGA.GGTGCGTAG
AGACATATC.AGTCGATCA	AGACATATC.AGTCGATCA
AGACATATC.ATGAGATCC	AGACATATC.ATGAGATCC
AGACATATC.GACTCTCAC	AGACATATC.GACTCTCAC
AGACATCCA.AACGAGAAT	AGACATCCA.AACGAGAAT
AGACATCCA.ACGACAGTC	AGACATCCA.ACGACAGTC
AGACATCCA.ATTAGCACA	AGACATCCA.ATTAGCACA
AGACATCCA.CTCTAGTAA	AGACATCCA.CTCTAGTAA
AGACATCCA.GTATGCCTT	AGACATCCA.GTATGCCTT
AGACATCCA.TCAGCTCAG	AGACATCCA.TCAGCTCAG
AGACCACGC.AGTGTGCAC	AGACCACGC.AGTGTGCAC
AGACCACGC.ATCACTTCC	AGACCACGC.ATCACTTCC
AGACCAGCT.CCGGTTCTA	AGACCAGCT.CCGGTTCTA
AGACCAGCT.CGCTGTAGT	AGACCAGCT.CGCTGTAGT
AGACCAGCT.GGACTCCTT	AGACCAGCT.GGACTCCTT
AGACCAGCT.GTAGCCTTG	AGACCAGCT.GTAGCCTTG
AGACCAGCT.TTAACGTTC	AGACCAGCT.TTAACGTTC
AGACGCCTG.AGTATGACG	AGACGCCTG.AGTATGACG
AGACGCCTG.ATAGAGCAG	AGACGCCTG.ATAGAGCAG
AGACGCCTG.GATCGATAC	AGACGCCTG.GATCGATAC
AGACGCCTG.GCTCAGCCA	AGACGCCTG.GCTCAGCCA
AGACGCCTG.TACCATGTA	AGACGCCTG.TACCATGTA
AGACGCTAT.ACCGTACGC	AGACGCTAT.ACCGTACGC
AGACGCTAT.CTTGGTCAT	AGACGCTAT.CTTGGTCAT
AGACGCTAT.GTCGTTAGA	AGACGCTAT.GTCGTTAGA
AGACGCTAT.TGCCGACTA	AGACGCTAT.TGCCGACTA
AGACGGAGG.CATCCGACA	AGACGGAGG.CATCCGACA
AGACGGAGG.GAAGGATCA	AGACGGAGG.GAAGGATCA
AGACGGAGG.GCGACAACC	AGACGGAGG.GCGACAACC
AGACGGAGG.TGCGCACTG	AGACGGAGG.TGCGCACTG
AGACTAGTA.AACTCCATG	AGACTAGTA.AACTCCATG
AGACTAGTA.ATTAGCGGT	AGACTAGTA.ATTAGCGGT
AGACTAGTA.CTACGTTGG	AGACTAGTA.CTACGTTGG
AGACTAGTA.CTGTACGAC	AGACTAGTA.CTGTACGAC
AGACTAGTA.GTCTTATGC	AGACTAGTA.GTCTTATGC
AGACTAGTA.TGCATCGGA	AGACTAGTA.TGCATCGGA
AGACTTCGT.CAGTCTAAC	AGACTTCGT.CAGTCTAAC
AGAGAGTGG.CCACGGATC	AGAGAGTGG.CCACGGATC
AGAGAGTGG.CTTATTGAG	AGAGAGTGG.CTTATTGAG
AGAGCCGCA.CCTATTGGT	AGAGCCGCA.CCTATTGGT
AGAGCCGCA.GCATACTCC	AGAGCCGCA.GCATACTCC
AGAGCCGCA.GCGCTCTAT	AGAGCCGCA.GCGCTCTAT
AGAGCCGCA.GCTACAATG	AGAGCCGCA.GCTACAATG
AGAGCGCGA.ATATAGCGT	AGAGCGCGA.ATATAGCGT
AGAGCGCGA.CGCATAACT	AGAGCGCGA.CGCATAACT
AGAGCGCGA.CTTCTCATC	AGAGCGCGA.CTTCTCATC
AGAGCGCGA.GCGCATTAC	AGAGCGCGA.GCGCATTAC
AGAGCGCGA.GTGTCTGGA	AGAGCGCGA.GTGTCTGGA
AGAGCGCGA.TTCATCCAA	AGAGCGCGA.TTCATCCAA
AGAGCGCGA.TTGGTAACT	AGAGCGCGA.TTGGTAACT
AGAGCGGAG.ACTGACTAC	AGAGCGGAG.ACTGACTAC
AGAGCGGAG.CTGCGATTC	AGAGCGGAG.CTGCGATTC
AGAGCGGAG.GTCTTATGC	AGAGCGGAG.GTCTTATGC
AGAGCGGAG.TAGGTCAAC	AGAGCGGAG.TAGGTCAAC
AGAGCGGAG.TGTGGTCCT	AGAGCGGAG.TGTGGTCCT
AGAGGACGT.AGACATCCA	AGAGGACGT.AGACATCCA
AGAGGACGT.AGTGTGCAC	AGAGGACGT.AGTGTGCAC
AGAGGACGT.GTCCACAAC	AGAGGACGT.GTCCACAAC
AGAGGACGT.TGATACCGT	AGAGGACGT.TGATACCGT
AGAGGTGAA.AGTCGCCGA	AGAGGTGAA.AGTCGCCGA
AGATACGTT.CGTGACCAG	AGATACGTT.CGTGACCAG
AGATACGTT.CGTTGATCC	AGATACGTT.CGTTGATCC
AGATACGTT.CTGGTCGGT	AGATACGTT.CTGGTCGGT
AGATACGTT.GTCGACATT	AGATACGTT.GTCGACATT
AGATACGTT.TCAGTGCAA	AGATACGTT.TCAGTGCAA
AGATACGTT.TCCGATAAC	AGATACGTT.TCCGATAAC
AGATACGTT.TGTATGTAG	AGATACGTT.TGTATGTAG
AGATATGGA.AACGGAGAT	AGATATGGA.AACGGAGAT
AGATATGGA.ACCGACGGT	AGATATGGA.ACCGACGGT
AGATATGGA.ACTAAGTTC	AGATATGGA.ACTAAGTTC
AGATATGGA.ATCTACATC	AGATATGGA.ATCTACATC
AGATATGGA.CACACTGCC	AGATATGGA.CACACTGCC
AGATATGGA.CATCGAAGC	AGATATGGA.CATCGAAGC
AGATATGGA.CGCGAGTGT	AGATATGGA.CGCGAGTGT
AGATATGGA.GATCTGAAT	AGATATGGA.GATCTGAAT
AGATATGGA.GCTAGCTCC	AGATATGGA.GCTAGCTCC
AGATCGAGT.ACCGTACGC	AGATCGAGT.ACCGTACGC
AGATCGAGT.ATGGAGGAA	AGATCGAGT.ATGGAGGAA
AGATCGAGT.GTGACGTAA	AGATCGAGT.GTGACGTAA
AGATCGAGT.TTGCGAACA	AGATCGAGT.TTGCGAACA
AGATCTGAC.ACGACATCT	AGATCTGAC.ACGACATCT
AGATCTGAC.CATCAATAG	AGATCTGAC.CATCAATAG
AGATCTGAC.TAGTGATCC	AGATCTGAC.TAGTGATCC
AGATCTGAC.TGCCGCTAC	AGATCTGAC.TGCCGCTAC
AGATCTTCA.CCAGTCTCA	AGATCTTCA.CCAGTCTCA
AGATGAAGA.ACGTATGTC	AGATGAAGA.ACGTATGTC
AGATGAAGA.ATGCCTTCA	AGATGAAGA.ATGCCTTCA
AGATGAAGA.CACCAAGAT	AGATGAAGA.CACCAAGAT
AGATGAAGA.CAGTCTAAC	AGATGAAGA.CAGTCTAAC
AGATGAAGA.CTCTAAGAG	AGATGAAGA.CTCTAAGAG
AGATGAAGA.GAGTCAAGG	AGATGAAGA.GAGTCAAGG
AGATGAAGA.GCAGCTTGA	AGATGAAGA.GCAGCTTGA
AGATGAGAT.GTCGCAGGT	AGATGAGAT.GTCGCAGGT
AGATGTTGG.AACCATGGT	AGATGTTGG.AACCATGGT
AGATGTTGG.CACTTCCTT	AGATGTTGG.CACTTCCTT
AGATGTTGG.CGCGATGTA	AGATGTTGG.CGCGATGTA
AGATGTTGG.GCCTTGTGA	AGATGTTGG.GCCTTGTGA
AGATGTTGG.GTTCACTCC	AGATGTTGG.GTTCACTCC
AGATGTTGG.TATGTACCT	AGATGTTGG.TATGTACCT
AGCAACATT.ACTCCAACT	AGCAACATT.ACTCCAACT
AGCAACATT.CATAGTATG	AGCAACATT.CATAGTATG
AGCAACATT.CTGTACGAC	AGCAACATT.CTGTACGAC
AGCAACATT.GTAAGTGAG	AGCAACATT.GTAAGTGAG
AGCAACATT.GTCTGAGCC	AGCAACATT.GTCTGAGCC
AGCAACATT.TACATGCAC	AGCAACATT.TACATGCAC
AGCAAGTCC.GCTGACAGA	AGCAAGTCC.GCTGACAGA
AGCAAGTCC.GTCATTCTA	AGCAAGTCC.GTCATTCTA
AGCACACCT.AATACGTCT	AGCACACCT.AATACGTCT
AGCACACCT.AGGAAGGTG	AGCACACCT.AGGAAGGTG
AGCACACCT.CATCTCGAT	AGCACACCT.CATCTCGAT
AGCACCAGC.AATGCCTCA	AGCACCAGC.AATGCCTCA
AGCACCAGC.CCGATCAGC	AGCACCAGC.CCGATCAGC
AGCACCGTG.AGATGTTGG	AGCACCGTG.AGATGTTGG
AGCACCGTG.AGGATGCGT	AGCACCGTG.AGGATGCGT
AGCACCGTG.CAGAGCACC	AGCACCGTG.CAGAGCACC
AGCACCGTG.GGATAATAC	AGCACCGTG.GGATAATAC
AGCACCGTG.GTAACGCGA	AGCACCGTG.GTAACGCGA
AGCACCGTG.TCGACGTTG	AGCACCGTG.TCGACGTTG
AGCACCGTG.TTAGGAAGG	AGCACCGTG.TTAGGAAGG
AGCACCGTG.TTCCTTGAC	AGCACCGTG.TTCCTTGAC
AGCAGACAA.ACTCGTAGG	AGCAGACAA.ACTCGTAGG
AGCAGACAA.ATCTCTGCT	AGCAGACAA.ATCTCTGCT
AGCAGACAA.ATCTGCGTA	AGCAGACAA.ATCTGCGTA
AGCAGACAA.CCGACTGTT	AGCAGACAA.CCGACTGTT
AGCAGACAA.CTGTGGTGG	AGCAGACAA.CTGTGGTGG
AGCAGACAA.CTTGGATCA	AGCAGACAA.CTTGGATCA
AGCAGACAA.TATGGTTGG	AGCAGACAA.TATGGTTGG
AGCAGACAA.TTGGACTTC	AGCAGACAA.TTGGACTTC
AGCATATGG.AACGAGGTG	AGCATATGG.AACGAGGTG
AGCATATGG.AAGTACAGA	AGCATATGG.AAGTACAGA
AGCATATGG.AATACCTTG	AGCATATGG.AATACCTTG
AGCATATGG.TCTATGACA	AGCATATGG.TCTATGACA
AGCATTCCA.ACGTAGTAT	AGCATTCCA.ACGTAGTAT
AGCATTCCA.CACTTGGAT	AGCATTCCA.CACTTGGAT
AGCATTCCA.CTGTTACCA	AGCATTCCA.CTGTTACCA
AGCATTCCA.GGAGAATGA	AGCATTCCA.GGAGAATGA
AGCATTCCA.TCAAGGTCG	AGCATTCCA.TCAAGGTCG
AGCATTCCA.TCTATGACA	AGCATTCCA.TCTATGACA
AGCATTGTT.CAGTGAGGA	AGCATTGTT.CAGTGAGGA
AGCATTGTT.CCACTACCA	AGCATTGTT.CCACTACCA
AGCATTGTT.GTCTTCTCG	AGCATTGTT.GTCTTCTCG
AGCCACTTC.AGCGGTCTA	AGCCACTTC.AGCGGTCTA
AGCCACTTC.CATTGTTCA	AGCCACTTC.CATTGTTCA
AGCCACTTC.CCGCAGCTA	AGCCACTTC.CCGCAGCTA
AGCCACTTC.CGCTTGTAG	AGCCACTTC.CGCTTGTAG
AGCCACTTC.TCGTCCGAT	AGCCACTTC.TCGTCCGAT
AGCCACTTC.TGGTAACCA	AGCCACTTC.TGGTAACCA
AGCCACTTC.TTCCTGCTA	AGCCACTTC.TTCCTGCTA
AGCCAGGAC.AGAGCGCGA	AGCCAGGAC.AGAGCGCGA
AGCCAGGAC.CCAGCCAAT	AGCCAGGAC.CCAGCCAAT
AGCCAGGAC.TCCTTCGTA	AGCCAGGAC.TCCTTCGTA
AGCCGGATC.CACCTAGCG	AGCCGGATC.CACCTAGCG
AGCCGGATC.CCTAAGAAG	AGCCGGATC.CCTAAGAAG
AGCCGGATC.CGGTAGCTT	AGCCGGATC.CGGTAGCTT
AGCCGGATC.CGTACACAC	AGCCGGATC.CGTACACAC
AGCCGGATC.CTCCGCATT	AGCCGGATC.CTCCGCATT
AGCCGGATC.GGACAGATT	AGCCGGATC.GGACAGATT
AGCCGTTCT.AAGCAACTA	AGCCGTTCT.AAGCAACTA
AGCCGTTCT.AAGGAAGTC	AGCCGTTCT.AAGGAAGTC
AGCCGTTCT.ACGACATCT	AGCCGTTCT.ACGACATCT
AGCCGTTCT.CATTCCGAG	AGCCGTTCT.CATTCCGAG
AGCCGTTCT.CGGTTGCGA	AGCCGTTCT.CGGTTGCGA
AGCCGTTCT.GTTGCATGG	AGCCGTTCT.GTTGCATGG
AGCCGTTCT.TCGCCAAGC	AGCCGTTCT.TCGCCAAGC
AGCCTCGCA.AGGTCAGCA	AGCCTCGCA.AGGTCAGCA
AGCCTCGCA.CGTGTGTGG	AGCCTCGCA.CGTGTGTGG
AGCCTCGCA.CTCCGCATT	AGCCTCGCA.CTCCGCATT
AGCCTCGCA.CTGGTACAT	AGCCTCGCA.CTGGTACAT
AGCCTCGCA.GTCAGTTGT	AGCCTCGCA.GTCAGTTGT
AGCCTCTAG.CCATTCTGC	AGCCTCTAG.CCATTCTGC
AGCCTCTAG.CCTACTAGA	AGCCTCTAG.CCTACTAGA
AGCGACACC.ACACCGCCA	AGCGACACC.ACACCGCCA
AGCGACACC.ATTAAGACC	AGCGACACC.ATTAAGACC
AGCGACACC.CAGCGACGT	AGCGACACC.CAGCGACGT
AGCGACACC.CCATAATCG	AGCGACACC.CCATAATCG
AGCGCATGA.ACCGGAAGG	AGCGCATGA.ACCGGAAGG
AGCGCATGA.CATTATGTC	AGCGCATGA.CATTATGTC
AGCGCATGA.CGAACAGAG	AGCGCATGA.CGAACAGAG
AGCGGAACA.AATGAGTCG	AGCGGAACA.AATGAGTCG
AGCGGAACA.CAAGCCTCG	AGCGGAACA.CAAGCCTCG
AGCGGAACA.CAGTATGAT	AGCGGAACA.CAGTATGAT
AGCGGAACA.TGATTCACC	AGCGGAACA.TGATTCACC
AGCGGTAAG.AAGCACAAC	AGCGGTAAG.AAGCACAAC
AGCGGTAAG.CCTCGAGAG	AGCGGTAAG.CCTCGAGAG
AGCGGTAAG.CCTCTTGTA	AGCGGTAAG.CCTCTTGTA
AGCGGTAAG.TGCGACGTT	AGCGGTAAG.TGCGACGTT
AGCGGTAAG.TGTAGATCG	AGCGGTAAG.TGTAGATCG
AGCGGTAAG.TTCCAATTC	AGCGGTAAG.TTCCAATTC
AGCGGTCTA.AGTCCAGTG	AGCGGTCTA.AGTCCAGTG
AGCGGTCTA.CATCAATAG	AGCGGTCTA.CATCAATAG
AGCGGTCTA.CCACGCCAT	AGCGGTCTA.CCACGCCAT
AGCGGTCTA.CCGGTTCTA	AGCGGTCTA.CCGGTTCTA
AGCGGTCTA.CGGACAAGT	AGCGGTCTA.CGGACAAGT
AGCGGTCTA.CTTATTGAG	AGCGGTCTA.CTTATTGAG
AGCGGTCTA.GTAGCTACA	AGCGGTCTA.GTAGCTACA
AGCGGTCTA.TACCTCCTC	AGCGGTCTA.TACCTCCTC
AGCGGTCTA.TTCATTCGC	AGCGGTCTA.TTCATTCGC
AGCGTAGAA.AGTGAACGG	AGCGTAGAA.AGTGAACGG
AGCGTAGAA.ATCCGACCA	AGCGTAGAA.ATCCGACCA
AGCGTAGAA.CAATCATAC	AGCGTAGAA.CAATCATAC
AGCGTAGAA.TCTACAGTT	AGCGTAGAA.TCTACAGTT
AGCGTAGAA.TGCTCACAC	AGCGTAGAA.TGCTCACAC
AGCGTCGTC.CCTTGCTTG	AGCGTCGTC.CCTTGCTTG
AGCGTCGTC.CGTGAGACT	AGCGTCGTC.CGTGAGACT
AGCGTCGTC.GCGTCGTCT	AGCGTCGTC.GCGTCGTCT
AGCTACTCA.AGATCTGAC	AGCTACTCA.AGATCTGAC
AGCTACTCA.CGAAGAGGT	AGCTACTCA.CGAAGAGGT
AGCTACTCA.GACCGGTAG	AGCTACTCA.GACCGGTAG
AGCTACTCA.GCAGCTTGA	AGCTACTCA.GCAGCTTGA
AGCTACTCA.TAGACCATG	AGCTACTCA.TAGACCATG
AGCTACTCA.TCTTAAGTG	AGCTACTCA.TCTTAAGTG
AGCTATATG.AGCATATGG	AGCTATATG.AGCATATGG
AGCTCGTCT.CGACAGGAA	AGCTCGTCT.CGACAGGAA
AGCTCGTCT.CGATCCAGA	AGCTCGTCT.CGATCCAGA
AGCTCGTCT.GACACCGAT	AGCTCGTCT.GACACCGAT
AGCTCGTCT.GTCAAGATC	AGCTCGTCT.GTCAAGATC
AGCTCTCCG.GAATAAGAG	AGCTCTCCG.GAATAAGAG
AGCTCTCCG.GCATACTCC	AGCTCTCCG.GCATACTCC
AGCTCTCCG.GCCAATGAA	AGCTCTCCG.GCCAATGAA
AGCTCTCCG.GTGTTGGAA	AGCTCTCCG.GTGTTGGAA
AGCTCTCCG.TTCCAGATT	AGCTCTCCG.TTCCAGATT
AGCTGCACT.TAGATAGCC	AGCTGCACT.TAGATAGCC
AGCTGCACT.TTGTAATGC	AGCTGCACT.TTGTAATGC
AGCTTCGAT.ATCTACATC	AGCTTCGAT.ATCTACATC
AGCTTGGTG.CACGACTCA	AGCTTGGTG.CACGACTCA
AGCTTGGTG.CTGGACACT	AGCTTGGTG.CTGGACACT
