GCGGTAAGT.TTCAGTGCC	GCGGTAAGT.TTCAGTGCC
GCGGTAGTC.ACTGGACCA	GCGGTAGTC.ACTGGACCA
GCGGTAGTC.AGAGCGGAG	GCGGTAGTC.AGAGCGGAG
GCGGTAGTC.GATTCTCGG	GCGGTAGTC.GATTCTCGG
GCGTAACAA.GATCTGTTC	GCGTAACAA.GATCTGTTC
GCGTAACAA.GGTCGGATA	GCGTAACAA.GGTCGGATA
GCGTAACAA.GTGATGTGC	GCGTAACAA.GTGATGTGC
GCGTAACAA.TCAGCGACC	GCGTAACAA.TCAGCGACC
GCGTATAGG.ACGTGCTCG	GCGTATAGG.ACGTGCTCG
GCGTATAGG.CCAGGAGTT	GCGTATAGG.CCAGGAGTT
GCGTATAGG.GAAGTGTGA	GCGTATAGG.GAAGTGTGA
GCGTATAGG.GGATCGTTC	GCGTATAGG.GGATCGTTC
GCGTATAGG.TACAGGACT	GCGTATAGG.TACAGGACT
GCGTCGTCT.ACGACAGTC	GCGTCGTCT.ACGACAGTC
GCGTCGTCT.GGATTCGTC	GCGTCGTCT.GGATTCGTC
GCGTCGTCT.GTAACAGTC	GCGTCGTCT.GTAACAGTC
GCGTGAGCT.TATACGTGG	GCGTGAGCT.TATACGTGG
GCGTGAGCT.TCGTCATTC	GCGTGAGCT.TCGTCATTC
GCGTGAGCT.TTACGCTCG	GCGTGAGCT.TTACGCTCG
GCGTGAGCT.TTCACCTTG	GCGTGAGCT.TTCACCTTG
GCGTGATAC.AAGTTCTCT	GCGTGATAC.AAGTTCTCT
GCGTGATAC.AGCATATGG	GCGTGATAC.AGCATATGG
GCGTGATAC.ATACAACCG	GCGTGATAC.ATACAACCG
GCGTGATAC.CGGAAGACG	GCGTGATAC.CGGAAGACG
GCGTGATAC.GAGTCACCA	GCGTGATAC.GAGTCACCA
GCGTGATAC.GGATCAATG	GCGTGATAC.GGATCAATG
GCGTGATAC.TAGGATTAG	GCGTGATAC.TAGGATTAG
GCGTTCAGA.AAGACTACC	GCGTTCAGA.AAGACTACC
GCGTTCAGA.CATCAATAG	GCGTTCAGA.CATCAATAG
GCGTTCAGA.GCCTTCCAT	GCGTTCAGA.GCCTTCCAT
GCGTTCAGA.GTATGCCTT	GCGTTCAGA.GTATGCCTT
GCGTTCAGA.TCGCGTCAT	GCGTTCAGA.TCGCGTCAT
GCTACAATG.ACGTTCAAT	GCTACAATG.ACGTTCAAT
GCTACAATG.AGAGCGGAG	GCTACAATG.AGAGCGGAG
GCTACAATG.ATAAGACAG	GCTACAATG.ATAAGACAG
GCTACAATG.ATTAGCGGT	GCTACAATG.ATTAGCGGT
GCTACAATG.CATATGCGA	GCTACAATG.CATATGCGA
GCTACCGAG.ACACATCTG	GCTACCGAG.ACACATCTG
GCTACCGAG.ACTGGTGCT	GCTACCGAG.ACTGGTGCT
GCTACCTTA.ACGCTAGTG	GCTACCTTA.ACGCTAGTG
GCTAGCTCC.ACACCACAT	GCTAGCTCC.ACACCACAT
GCTAGCTCC.AGAATCAGA	GCTAGCTCC.AGAATCAGA
GCTAGCTCC.CTGCTTAGG	GCTAGCTCC.CTGCTTAGG
GCTAGCTCC.GATAAGCTG	GCTAGCTCC.GATAAGCTG
GCTAGCTCC.GATGCGACG	GCTAGCTCC.GATGCGACG
GCTAGCTCC.GATGTAAGG	GCTAGCTCC.GATGTAAGG
GCTAGCTCC.TACGACTTG	GCTAGCTCC.TACGACTTG
GCTAGCTCC.TACGGTCGT	GCTAGCTCC.TACGGTCGT
GCTAGCTCC.TCCATCATT	GCTAGCTCC.TCCATCATT
GCTAGCTCC.TTCATTCGC	GCTAGCTCC.TTCATTCGC
GCTAGTGGA.AGCATTGTT	GCTAGTGGA.AGCATTGTT
GCTAGTGGA.AGTGTTCTG	GCTAGTGGA.AGTGTTCTG
GCTAGTGGA.CACTGCTTA	GCTAGTGGA.CACTGCTTA
GCTAGTGGA.CTTAACAGC	GCTAGTGGA.CTTAACAGC
GCTATGTAA.AACGATGAC	GCTATGTAA.AACGATGAC
GCTATGTAA.AAGAGAGAG	GCTATGTAA.AAGAGAGAG
GCTATGTAA.ACAGAAGAG	GCTATGTAA.ACAGAAGAG
GCTATGTAA.GATTGGAAG	GCTATGTAA.GATTGGAAG
GCTATGTAA.GCAGCTCTT	GCTATGTAA.GCAGCTCTT
GCTATGTAA.GTAACCATA	GCTATGTAA.GTAACCATA
GCTATGTAA.TACTAGTAG	GCTATGTAA.TACTAGTAG
GCTATGTAA.TCGACGTTG	GCTATGTAA.TCGACGTTG
GCTCAATGA.AAGTTCTCT	GCTCAATGA.AAGTTCTCT
GCTCAATGA.TATCTGTCA	GCTCAATGA.TATCTGTCA
GCTCAATGA.TGGTGGATC	GCTCAATGA.TGGTGGATC
GCTCAGCCA.AACACACTC	GCTCAGCCA.AACACACTC
GCTCAGCCA.ATTGATCAC	GCTCAGCCA.ATTGATCAC
GCTCAGCCA.CAGCAGTAC	GCTCAGCCA.CAGCAGTAC
GCTCAGCCA.GATCCGCAC	GCTCAGCCA.GATCCGCAC
GCTCAGCCA.GCTATGTAA	GCTCAGCCA.GCTATGTAA
GCTCAGCCA.GCTCTGTGT	GCTCAGCCA.GCTCTGTGT
GCTCAGCCA.TCGTAGGAA	GCTCAGCCA.TCGTAGGAA
GCTCCTAGC.ACGTTCAAT	GCTCCTAGC.ACGTTCAAT
GCTCCTAGC.CTTATTGAG	GCTCCTAGC.CTTATTGAG
GCTCTCCAA.AACGGTAGC	GCTCTCCAA.AACGGTAGC
GCTCTCCAA.TCATGCAGG	GCTCTCCAA.TCATGCAGG
GCTCTGTGT.ATATAGCGT	GCTCTGTGT.ATATAGCGT
GCTCTGTGT.ATGACACAA	GCTCTGTGT.ATGACACAA
GCTCTGTGT.CATAAGATC	GCTCTGTGT.CATAAGATC
GCTCTGTGT.CCTCGGTCA	GCTCTGTGT.CCTCGGTCA
GCTCTGTGT.CGAAGAGGT	GCTCTGTGT.CGAAGAGGT
GCTCTGTGT.GTGACTCTC	GCTCTGTGT.GTGACTCTC
GCTCTGTGT.TAGACACGT	GCTCTGTGT.TAGACACGT
GCTGACAGA.AGACTAGTA	GCTGACAGA.AGACTAGTA
GCTGACAGA.ATTGACACG	GCTGACAGA.ATTGACACG
GCTGACAGA.ATTGGTTCC	GCTGACAGA.ATTGGTTCC
GCTGACAGA.CAGTGCCAT	GCTGACAGA.CAGTGCCAT
GCTGACAGA.TTGGAGAAC	GCTGACAGA.TTGGAGAAC
GCTGAGCAG.CTCTAGTAA	GCTGAGCAG.CTCTAGTAA
GCTGAGCAG.CTGACGGAT	GCTGAGCAG.CTGACGGAT
GCTGATGTC.GTTGCTCAG	GCTGATGTC.GTTGCTCAG
GCTGGTAAC.AACAACCTA	GCTGGTAAC.AACAACCTA
GCTGGTAAC.AATCTGACC	GCTGGTAAC.AATCTGACC
GCTGGTAAC.ATAGACCGA	GCTGGTAAC.ATAGACCGA
GCTGGTAAC.CGTTCCATT	GCTGGTAAC.CGTTCCATT
GCTGGTAAC.GCTTCTACG	GCTGGTAAC.GCTTCTACG
GCTGGTAAC.GTCAATACA	GCTGGTAAC.GTCAATACA
GCTGGTAAC.TGACCTCCT	GCTGGTAAC.TGACCTCCT
GCTGGTTCG.CCTTCCTCA	GCTGGTTCG.CCTTCCTCA
GCTGGTTCG.TAACTCCGA	GCTGGTTCG.TAACTCCGA
GCTGGTTCG.TATCGGAAC	GCTGGTTCG.TATCGGAAC
GCTGGTTCG.TGCCACCGA	GCTGGTTCG.TGCCACCGA
GCTGTTCGG.AAGGTCTGA	GCTGTTCGG.AAGGTCTGA
GCTGTTCGG.AGTTGAGCG	GCTGTTCGG.AGTTGAGCG
GCTGTTCGG.ATGTCCTCC	GCTGTTCGG.ATGTCCTCC
GCTGTTCGG.CTTGCACAA	GCTGTTCGG.CTTGCACAA
GCTGTTCGG.TTCAACTAC	GCTGTTCGG.TTCAACTAC
GCTTACGTT.ATTATGCAG	GCTTACGTT.ATTATGCAG
GCTTACGTT.CAGAGCACC	GCTTACGTT.CAGAGCACC
GCTTACGTT.CATTCGAAT	GCTTACGTT.CATTCGAAT
GCTTACGTT.CGCACTGAA	GCTTACGTT.CGCACTGAA
GCTTACGTT.GGTGATAGG	GCTTACGTT.GGTGATAGG
GCTTACTAG.CTCGACGAT	GCTTACTAG.CTCGACGAT
GCTTAGAAC.ACTAACCGA	GCTTAGAAC.ACTAACCGA
GCTTAGAAC.GACTCAGTG	GCTTAGAAC.GACTCAGTG
GCTTAGAAC.TCACCGAGG	GCTTAGAAC.TCACCGAGG
GCTTCACTC.ACGTGAATC	GCTTCACTC.ACGTGAATC
GCTTCACTC.ACTCTCACA	GCTTCACTC.ACTCTCACA
GCTTCACTC.AGCGGTAAG	GCTTCACTC.AGCGGTAAG
GCTTCACTC.ATGTCCTCC	GCTTCACTC.ATGTCCTCC
GCTTCACTC.CCGGTTCTA	GCTTCACTC.CCGGTTCTA
GCTTCACTC.CTAGAGGTA	GCTTCACTC.CTAGAGGTA
GCTTCACTC.GTTAATTCG	GCTTCACTC.GTTAATTCG
GCTTCACTC.TGCGTAATC	GCTTCACTC.TGCGTAATC
GCTTCTACG.AGGATTGAG	GCTTCTACG.AGGATTGAG
GCTTCTACG.ATCAGGATG	GCTTCTACG.ATCAGGATG
GCTTCTACG.CTGACGGAT	GCTTCTACG.CTGACGGAT
GCTTCTACG.GTTACTACT	GCTTCTACG.GTTACTACT
GCTTCTACG.TAGAGCGTC	GCTTCTACG.TAGAGCGTC
GCTTCTACG.TGGACGAGA	GCTTCTACG.TGGACGAGA
GCTTCTGAA.AATCGCCAT	GCTTCTGAA.AATCGCCAT
GCTTCTGAA.ACAGTATTG	GCTTCTGAA.ACAGTATTG
GCTTCTGAA.ACTTAGCTT	GCTTCTGAA.ACTTAGCTT
GCTTCTGAA.ATGAACTAG	GCTTCTGAA.ATGAACTAG
GCTTCTGAA.CTGAGGTTA	GCTTCTGAA.CTGAGGTTA
GCTTCTGAA.GTATGATCT	GCTTCTGAA.GTATGATCT
GCTTCTGAA.TGACCTCCT	GCTTCTGAA.TGACCTCCT
GCTTGGTTC.AGAGGTGAA	GCTTGGTTC.AGAGGTGAA
GCTTGGTTC.CCACTTCGC	GCTTGGTTC.CCACTTCGC
GCTTGGTTC.CCTCCAATC	GCTTGGTTC.CCTCCAATC
GCTTGGTTC.CGGATTCTC	GCTTGGTTC.CGGATTCTC
GCTTGGTTC.CTGCTTAGG	GCTTGGTTC.CTGCTTAGG
GCTTGGTTC.CTTGATCTA	GCTTGGTTC.CTTGATCTA
GCTTGGTTC.GTAGTGGAG	GCTTGGTTC.GTAGTGGAG
GCTTGGTTC.TGTCCATAG	GCTTGGTTC.TGTCCATAG
GCTTGTCCT.GAGCAGGAA	GCTTGTCCT.GAGCAGGAA
GCTTGTCCT.TCTCGATGC	GCTTGTCCT.TCTCGATGC
GCTTGTCCT.TGATGGACA	GCTTGTCCT.TGATGGACA
GCTTGTCCT.TGTAGGTTA	GCTTGTCCT.TGTAGGTTA
GCTTGTCCT.TTGGACTTC	GCTTGTCCT.TTGGACTTC
GGAACCTAG.TAACACGAG	GGAACCTAG.TAACACGAG
GGAACTGCT.GCCAACAAT	GGAACTGCT.GCCAACAAT
GGAACTGCT.TCTACATCC	GGAACTGCT.TCTACATCC
GGAACTGCT.TTACACCTT	GGAACTGCT.TTACACCTT
GGAACTGCT.TTGATGAGT	GGAACTGCT.TTGATGAGT
GGAAGAAGC.ATGTGACGA	GGAAGAAGC.ATGTGACGA
GGAAGAAGC.GCATACTCC	GGAAGAAGC.GCATACTCC
GGAAGAAGC.GGTACTTCC	GGAAGAAGC.GGTACTTCC
GGAAGAAGC.GGTTGCTAT	GGAAGAAGC.GGTTGCTAT
GGAAGAAGC.TCGCTTAAC	GGAAGAAGC.TCGCTTAAC
GGAAGGTAT.ATAGTCAGT	GGAAGGTAT.ATAGTCAGT
GGAAGTATG.GCACGCATT	GGAAGTATG.GCACGCATT
GGAAGTATG.GCCAATGAA	GGAAGTATG.GCCAATGAA
GGAAGTATG.TCGTTCTCC	GGAAGTATG.TCGTTCTCC
GGAATTCAC.ATCAAGCAT	GGAATTCAC.ATCAAGCAT
GGAATTCAC.CCTAGTCTC	GGAATTCAC.CCTAGTCTC
GGAATTCAC.GTAGGACGC	GGAATTCAC.GTAGGACGC
GGAATTCAC.TAATCACGC	GGAATTCAC.TAATCACGC
GGAATTCAC.TCTAATACC	GGAATTCAC.TCTAATACC
GGAATTGGA.ATGCCTGTC	GGAATTGGA.ATGCCTGTC
GGAATTGGA.GGAGATGAG	GGAATTGGA.GGAGATGAG
GGAATTGGA.TAAGCCATT	GGAATTGGA.TAAGCCATT
GGAATTGGA.TAGCCAGTG	GGAATTGGA.TAGCCAGTG
GGACACTGG.TAGAGCGTC	GGACACTGG.TAGAGCGTC
GGACACTGG.TCAAGCGTA	GGACACTGG.TCAAGCGTA
GGACAGATT.CATTATGTC	GGACAGATT.CATTATGTC
GGACAGATT.TCCAGAACG	GGACAGATT.TCCAGAACG
GGACAGATT.TCCAGCTAT	GGACAGATT.TCCAGCTAT
GGACGAGCA.ACCGAGACA	GGACGAGCA.ACCGAGACA
GGACGAGCA.CGTTCGTAC	GGACGAGCA.CGTTCGTAC
GGACGAGCA.CTCGAACTG	GGACGAGCA.CTCGAACTG
GGACGAGCA.TATTACAGC	GGACGAGCA.TATTACAGC
GGACGAGCA.TGACCTATG	GGACGAGCA.TGACCTATG
GGACTATTC.AGGATTACT	GGACTATTC.AGGATTACT
GGACTATTC.CTGGACACT	GGACTATTC.CTGGACACT
GGACTATTC.GCCTTAGAG	GGACTATTC.GCCTTAGAG
GGACTATTC.GCTGGTTCG	GGACTATTC.GCTGGTTCG
GGACTATTC.TCGTAGGAA	GGACTATTC.TCGTAGGAA
GGACTCCTT.AGTTCAACC	GGACTCCTT.AGTTCAACC
GGACTCCTT.ATAGTCAGT	GGACTCCTT.ATAGTCAGT
GGAGAATGA.ATAAGTTCG	GGAGAATGA.ATAAGTTCG
GGAGAATGA.ATTCATGTG	GGAGAATGA.ATTCATGTG
GGAGAATGA.GTGTTGGAA	GGAGAATGA.GTGTTGGAA
GGAGAATGA.TGCCACCGA	GGAGAATGA.TGCCACCGA
GGAGACACA.ATGACACAA	GGAGACACA.ATGACACAA
GGAGACACA.CACGATAGA	GGAGACACA.CACGATAGA
GGAGACACA.CGAAGAGGT	GGAGACACA.CGAAGAGGT
GGAGACACA.CTCGTCTTG	GGAGACACA.CTCGTCTTG
GGAGACACA.GTCCGTAAG	GGAGACACA.GTCCGTAAG
GGAGACACA.GTGCGTTCC	GGAGACACA.GTGCGTTCC
GGAGACACA.TCGCCAAGC	GGAGACACA.TCGCCAAGC
GGAGATGAG.ACACATCTG	GGAGATGAG.ACACATCTG
GGAGATGAG.AGACCACGC	GGAGATGAG.AGACCACGC
GGAGATGAG.ATAGAGCAG	GGAGATGAG.ATAGAGCAG
GGAGATGAG.ATTCGAAGA	GGAGATGAG.ATTCGAAGA
GGAGATGAG.CAGGTATCG	GGAGATGAG.CAGGTATCG
GGAGATGAG.CATCGAAGC	GGAGATGAG.CATCGAAGC
GGAGATGAG.CCTCTTGTA	GGAGATGAG.CCTCTTGTA
GGAGATGAG.GACTCAGTG	GGAGATGAG.GACTCAGTG
GGAGCATCT.AAGTACAGA	GGAGCATCT.AAGTACAGA
GGAGCATCT.CAACTAATC	GGAGCATCT.CAACTAATC
GGAGCATCT.CATAAGATC	GGAGCATCT.CATAAGATC
GGAGCATCT.CCGTCCACT	GGAGCATCT.CCGTCCACT
GGAGCATCT.CTTACATGC	GGAGCATCT.CTTACATGC
GGAGCATCT.GAGCCGTTA	GGAGCATCT.GAGCCGTTA
GGAGCATCT.GATTAGACA	GGAGCATCT.GATTAGACA
GGAGCATCT.TTAGATCGG	GGAGCATCT.TTAGATCGG
GGAGCTCAA.TCCACCGGT	GGAGCTCAA.TCCACCGGT
GGAGTACAG.AGCTCTCCG	GGAGTACAG.AGCTCTCCG
GGAGTACAG.GAGACATTG	GGAGTACAG.GAGACATTG
GGAGTTAGC.AAGACTGGT	GGAGTTAGC.AAGACTGGT
GGAGTTAGC.ACCTGTACC	GGAGTTAGC.ACCTGTACC
GGAGTTAGC.ATGGAGAGT	GGAGTTAGC.ATGGAGAGT
GGAGTTAGC.ATTGCGCTA	GGAGTTAGC.ATTGCGCTA
GGAGTTAGC.GGAGTACAG	GGAGTTAGC.GGAGTACAG
GGAGTTAGC.TGCCAGACG	GGAGTTAGC.TGCCAGACG
GGAGTTAGC.TTCACCTTG	GGAGTTAGC.TTCACCTTG
GGATAATAC.AGTCCGTGT	GGATAATAC.AGTCCGTGT
GGATAATAC.GCTCAGCCA	GGATAATAC.GCTCAGCCA
GGATAATAC.GTATGTATC	GGATAATAC.GTATGTATC
GGATAATAC.TCGCTTAAC	GGATAATAC.TCGCTTAAC
GGATAATAC.TGGAGAGTG	GGATAATAC.TGGAGAGTG
GGATAATAC.TTGAGCTCT	GGATAATAC.TTGAGCTCT
GGATACAAT.AGAGGTGAA	GGATACAAT.AGAGGTGAA
GGATACAAT.GACTGCCTG	GGATACAAT.GACTGCCTG
GGATACAAT.GCCGTCTTC	GGATACAAT.GCCGTCTTC
GGATACAAT.TTGATGCTG	GGATACAAT.TTGATGCTG
GGATACCTA.AGTTAGGTC	GGATACCTA.AGTTAGGTC
GGATACCTA.CTTGATCTA	GGATACCTA.CTTGATCTA
GGATACCTA.GATAGTTCT	GGATACCTA.GATAGTTCT
GGATACCTA.TCCAGAACG	GGATACCTA.TCCAGAACG
GGATAGTCA.ACAGCATCA	GGATAGTCA.ACAGCATCA
GGATAGTCA.ACCGTCACG	GGATAGTCA.ACCGTCACG
GGATAGTCA.CGATCCAGA	GGATAGTCA.CGATCCAGA
GGATAGTCA.GCATGTAAG	GGATAGTCA.GCATGTAAG
GGATAGTCA.GTCCGCTCA	GGATAGTCA.GTCCGCTCA
GGATAGTCA.GTGTTCCAG	GGATAGTCA.GTGTTCCAG
GGATAGTCA.TATAATCGC	GGATAGTCA.TATAATCGC
GGATAGTCA.TGTATGTAG	GGATAGTCA.TGTATGTAG
GGATCAATG.CACACCTGT	GGATCAATG.CACACCTGT
GGATCAATG.CAGTCTAAC	GGATCAATG.CAGTCTAAC
GGATCAATG.TCATGCAGG	GGATCAATG.TCATGCAGG
GGATCAATG.TTAACGTTC	GGATCAATG.TTAACGTTC
GGATCAGGT.CCTAAGAAG	GGATCAGGT.CCTAAGAAG
GGATCAGGT.CGGTTCGTA	GGATCAGGT.CGGTTCGTA
GGATCAGGT.CTGGAGCGA	GGATCAGGT.CTGGAGCGA
GGATCAGGT.GGAGACACA	GGATCAGGT.GGAGACACA
GGATCAGGT.TCTGAGATA	GGATCAGGT.TCTGAGATA
GGATCGTTC.AAGCAACTA	GGATCGTTC.AAGCAACTA
GGATCGTTC.ACACGTTGC	GGATCGTTC.ACACGTTGC
GGATCGTTC.CCAGTTACG	GGATCGTTC.CCAGTTACG
GGATCGTTC.CGTATCGAA	GGATCGTTC.CGTATCGAA
GGATCGTTC.TCACAGGTA	GGATCGTTC.TCACAGGTA
GGATCGTTC.TCGGAACGA	GGATCGTTC.TCGGAACGA
GGATGCGAA.AAGGATCGT	GGATGCGAA.AAGGATCGT
GGATGCGAA.ACGTCGCTC	GGATGCGAA.ACGTCGCTC
GGATGCGAA.GCACATGTT	GGATGCGAA.GCACATGTT
GGATGCTCG.CAGTATGAT	GGATGCTCG.CAGTATGAT
GGATGCTCG.TAGGAGGAT	GGATGCTCG.TAGGAGGAT
GGATTACGC.CCTTGTTGC	GGATTACGC.CCTTGTTGC
GGATTCGTC.AACGTTCTT	GGATTCGTC.AACGTTCTT
GGATTCGTC.AGTGAGAGA	GGATTCGTC.AGTGAGAGA
GGATTCGTC.GCTGACAGA	GGATTCGTC.GCTGACAGA
GGATTCGTC.GTTGATGCA	GGATTCGTC.GTTGATGCA
GGATTCGTC.TACGACCAT	GGATTCGTC.TACGACCAT
GGATTCGTC.TCTAGGATG	GGATTCGTC.TCTAGGATG
GGTAACTAC.AAGGAAGTC	GGTAACTAC.AAGGAAGTC
GGTAACTAC.GGATTCGTC	GGTAACTAC.GGATTCGTC
GGTAACTAC.TAGTGCACT	GGTAACTAC.TAGTGCACT
GGTAACTAC.TGGTGGATC	GGTAACTAC.TGGTGGATC
GGTAAGGAT.AGAGCGCGA	GGTAAGGAT.AGAGCGCGA
GGTAAGGAT.CGATCCAGA	GGTAAGGAT.CGATCCAGA
GGTAAGGAT.GACGGTGCT	GGTAAGGAT.GACGGTGCT
GGTAAGGAT.GGATGCTCG	GGTAAGGAT.GGATGCTCG
GGTAAGGAT.TATTGCTAC	GGTAAGGAT.TATTGCTAC
GGTAAGGAT.TTGCGAACA	GGTAAGGAT.TTGCGAACA
GGTAAGGAT.TTGGAGAAC	GGTAAGGAT.TTGGAGAAC
GGTAAGTGA.AGTTGTGTA	GGTAAGTGA.AGTTGTGTA
GGTAAGTGA.GAAGGATCA	GGTAAGTGA.GAAGGATCA
GGTAAGTGA.GGAAGTATG	GGTAAGTGA.GGAAGTATG
GGTAATCTA.AATGCCTCA	GGTAATCTA.AATGCCTCA
GGTAATCTA.CACATGTGC	GGTAATCTA.CACATGTGC
GGTAATCTA.CCTAAGTCT	GGTAATCTA.CCTAAGTCT
GGTAATCTA.TAGCTGTTG	GGTAATCTA.TAGCTGTTG
GGTACGAGC.ACGGTGTAC	GGTACGAGC.ACGGTGTAC
GGTACGAGC.ATCCTGCCT	GGTACGAGC.ATCCTGCCT
GGTACGAGC.CAAGGTGTG	GGTACGAGC.CAAGGTGTG
GGTACGAGC.GGTCCTGGT	GGTACGAGC.GGTCCTGGT
GGTACGAGC.TAATCACGC	GGTACGAGC.TAATCACGC
GGTACGAGC.TCGTAGGAA	GGTACGAGC.TCGTAGGAA
GGTACGAGC.TGGAGAACC	GGTACGAGC.TGGAGAACC
GGTACTTCC.AAGTCATGA	GGTACTTCC.AAGTCATGA
GGTACTTCC.ATATCCGAT	GGTACTTCC.ATATCCGAT
GGTACTTCC.CAACACCTA	GGTACTTCC.CAACACCTA
GGTACTTCC.CCAGTCTCA	GGTACTTCC.CCAGTCTCA
GGTACTTCC.TCAGACAAG	GGTACTTCC.TCAGACAAG
GGTAGACAT.CCATCACGA	GGTAGACAT.CCATCACGA
GGTAGACAT.GCCTAACGG	GGTAGACAT.GCCTAACGG
GGTAGACAT.TCGTGCCAC	GGTAGACAT.TCGTGCCAC
GGTAGCATC.AATAGACGC	GGTAGCATC.AATAGACGC
GGTAGCATC.ATAGTCTCC	GGTAGCATC.ATAGTCTCC
GGTAGCATC.CAGTCCTAA	GGTAGCATC.CAGTCCTAA
GGTAGCATC.CTCTGTCAA	GGTAGCATC.CTCTGTCAA
GGTAGCATC.GTCCGCTCA	GGTAGCATC.GTCCGCTCA
GGTAGCATC.TGTTACTGA	GGTAGCATC.TGTTACTGA
GGTAGTGTT.ACAGTATTG	GGTAGTGTT.ACAGTATTG
GGTAGTGTT.ATCACCGCA	GGTAGTGTT.ATCACCGCA
GGTAGTGTT.CAAGTCGAA	GGTAGTGTT.CAAGTCGAA
GGTAGTGTT.GGATACCTA	GGTAGTGTT.GGATACCTA
GGTAGTGTT.GTCACAGAG	GGTAGTGTT.GTCACAGAG
GGTCCTAAG.AACGAGGTG	GGTCCTAAG.AACGAGGTG
GGTCCTAAG.AATCCTCGT	GGTCCTAAG.AATCCTCGT
GGTCCTAAG.AGCCACTTC	GGTCCTAAG.AGCCACTTC
GGTCCTAAG.AGTTGTGTA	GGTCCTAAG.AGTTGTGTA
GGTCCTAAG.CGCTTCACG	GGTCCTAAG.CGCTTCACG
GGTCCTAAG.CGTACATCT	GGTCCTAAG.CGTACATCT
GGTCCTAAG.GCCGTGAAC	GGTCCTAAG.GCCGTGAAC
GGTCCTAAG.GGTAGACAT	GGTCCTAAG.GGTAGACAT
GGTCCTAAG.TAGTCAGAC	GGTCCTAAG.TAGTCAGAC
GGTCCTAAG.TCCATCATT	GGTCCTAAG.TCCATCATT
GGTCCTGGT.AAGAGAACT	GGTCCTGGT.AAGAGAACT
GGTCCTGGT.ACCACTAGG	GGTCCTGGT.ACCACTAGG
GGTCCTGGT.ACTAACCGA	GGTCCTGGT.ACTAACCGA
GGTCCTGGT.AGAGGACGT	GGTCCTGGT.AGAGGACGT
GGTCCTGGT.AGTAAGCCA	GGTCCTGGT.AGTAAGCCA
GGTCCTGGT.CAAGTACGA	GGTCCTGGT.CAAGTACGA
GGTCCTGGT.CAATGCATT	GGTCCTGGT.CAATGCATT
GGTCCTGGT.CTTAATCGT	GGTCCTGGT.CTTAATCGT
GGTCGGATA.AACGAGAAT	GGTCGGATA.AACGAGAAT
GGTCGGATA.ATTGCCGAC	GGTCGGATA.ATTGCCGAC
GGTCGGATA.TCGTTCTCC	GGTCGGATA.TCGTTCTCC
GGTCGGTCT.CCTGCTCCA	GGTCGGTCT.CCTGCTCCA
GGTCGGTCT.CGCAGTGTC	GGTCGGTCT.CGCAGTGTC
GGTCGGTCT.CGCGCACAT	GGTCGGTCT.CGCGCACAT
GGTCGGTCT.GATTCCTCT	GGTCGGTCT.GATTCCTCT
GGTCGGTCT.GTAATCAGC	GGTCGGTCT.GTAATCAGC
GGTCTCATG.CACGATAGA	GGTCTCATG.CACGATAGA
GGTCTCATG.CCTGTCATT	GGTCTCATG.CCTGTCATT
GGTCTCATG.GTCTCTTCA	GGTCTCATG.GTCTCTTCA
GGTCTCATG.TATTGACTG	GGTCTCATG.TATTGACTG
GGTCTCATG.TCTTAGCGA	GGTCTCATG.TCTTAGCGA
GGTCTTGCA.GAACTGCAA	GGTCTTGCA.GAACTGCAA
GGTCTTGCA.TCAGGTGCA	GGTCTTGCA.TCAGGTGCA
GGTCTTGCA.TGCCGACTA	GGTCTTGCA.TGCCGACTA
GGTCTTGCA.TTCATTCGC	GGTCTTGCA.TTCATTCGC
GGTGAGCGT.CAACGTCTT	GGTGAGCGT.CAACGTCTT
GGTGAGCGT.CCACATTAG	GGTGAGCGT.CCACATTAG
GGTGAGCGT.CCATACGAT	GGTGAGCGT.CCATACGAT
GGTGAGCGT.CCTCGGTCA	GGTGAGCGT.CCTCGGTCA
GGTGAGCGT.GACCTTGTG	GGTGAGCGT.GACCTTGTG
GGTGAGCGT.GCAGCGATA	GGTGAGCGT.GCAGCGATA
GGTGAGCGT.GCGACAACC	GGTGAGCGT.GCGACAACC
GGTGAGCGT.GTAAGTGAG	GGTGAGCGT.GTAAGTGAG
GGTGAGCGT.TAGCAGAGT	GGTGAGCGT.TAGCAGAGT
GGTGAGCGT.TCAAGGTCG	GGTGAGCGT.TCAAGGTCG
GGTGAGCGT.TCCTCGTCG	GGTGAGCGT.TCCTCGTCG
GGTGAGTTC.AATATCGCT	GGTGAGTTC.AATATCGCT
GGTGAGTTC.CTGGTGACA	GGTGAGTTC.CTGGTGACA
GGTGAGTTC.TGATGGACA	GGTGAGTTC.TGATGGACA
GGTGATAGG.CCATCTAGG	GGTGATAGG.CCATCTAGG
GGTGATAGG.GTACGCGAT	GGTGATAGG.GTACGCGAT
GGTGCGTAG.AGGATCATG	GGTGCGTAG.AGGATCATG
GGTGCGTAG.TGAGCTAGA	GGTGCGTAG.TGAGCTAGA
GGTGCGTAG.TGTGGACAA	GGTGCGTAG.TGTGGACAA
GGTGCGTAG.TTCCTTGAC	GGTGCGTAG.TTCCTTGAC
GGTGGAGCT.ACACCGCCA	GGTGGAGCT.ACACCGCCA
GGTGGAGCT.ACATTGACA	GGTGGAGCT.ACATTGACA
GGTGGAGCT.CAGCCGCAA	GGTGGAGCT.CAGCCGCAA
GGTGGAGCT.CAGGTATCG	GGTGGAGCT.CAGGTATCG
GGTGGAGCT.GGAGACACA	GGTGGAGCT.GGAGACACA
GGTGGAGCT.TGCGTAATC	GGTGGAGCT.TGCGTAATC
GGTGGAGCT.TTACTAGTC	GGTGGAGCT.TTACTAGTC
GGTGTGACC.GTAGCCTTG	GGTGTGACC.GTAGCCTTG
GGTGTTCAT.ATGAGTGTG	GGTGTTCAT.ATGAGTGTG
GGTGTTCAT.CAGAGCACC	GGTGTTCAT.CAGAGCACC
GGTGTTCAT.CAGCTAGTT	GGTGTTCAT.CAGCTAGTT
GGTGTTCAT.CCTGTCGAC	GGTGTTCAT.CCTGTCGAC
GGTGTTCAT.TGGTTATAC	GGTGTTCAT.TGGTTATAC
GGTTAACAG.AGCACCAGC	GGTTAACAG.AGCACCAGC
GGTTAACAG.CAGGTATCG	GGTTAACAG.CAGGTATCG
GGTTACGCA.CGTGCTTGA	GGTTACGCA.CGTGCTTGA
GGTTACGCA.GCTTACGTT	GGTTACGCA.GCTTACGTT
GGTTACGCA.TCGATTCAG	GGTTACGCA.TCGATTCAG
GGTTACGCA.TGCCTTCAG	GGTTACGCA.TGCCTTCAG
GGTTAGATG.AAGTAGGAC	GGTTAGATG.AAGTAGGAC
GGTTAGATG.ACGTCGCTC	GGTTAGATG.ACGTCGCTC
GGTTAGATG.ATATAGCGT	GGTTAGATG.ATATAGCGT
GGTTAGATG.GACTCTCAC	GGTTAGATG.GACTCTCAC
GGTTAGATG.TCGAACGCT	GGTTAGATG.TCGAACGCT
GGTTAGATG.TGCGTCTTA	GGTTAGATG.TGCGTCTTA
GGTTCAGAC.ACTCGTAGG	GGTTCAGAC.ACTCGTAGG
GGTTCAGAC.CCGCTATCC	GGTTCAGAC.CCGCTATCC
GGTTCAGAC.TACTAGTAG	GGTTCAGAC.TACTAGTAG
GGTTCAGAC.TCGTAGGAA	GGTTCAGAC.TCGTAGGAA
GGTTCGCAA.CAGCCGCAA	GGTTCGCAA.CAGCCGCAA
GGTTCGCAA.CGTACACAC	GGTTCGCAA.CGTACACAC
GGTTCGCAA.CTGATCCGA	GGTTCGCAA.CTGATCCGA
GGTTCGCAA.GCTTACGTT	GGTTCGCAA.GCTTACGTT
GGTTCGCAA.GGTTACGCA	GGTTCGCAA.GGTTACGCA
GGTTCGCAA.TTAAGTGGT	GGTTCGCAA.TTAAGTGGT
GGTTCTATC.AACTAACTG	GGTTCTATC.AACTAACTG
GGTTCTATC.AGCAAGTCC	GGTTCTATC.AGCAAGTCC
GGTTCTATC.ATCTACATC	GGTTCTATC.ATCTACATC
GGTTCTATC.CAACACCTA	GGTTCTATC.CAACACCTA
GGTTGAAGG.AGTTAGGTC	GGTTGAAGG.AGTTAGGTC
GGTTGAAGG.CATATGTCG	GGTTGAAGG.CATATGTCG
GGTTGAAGG.CTAACACTG	GGTTGAAGG.CTAACACTG
GGTTGAAGG.GCACGCATT	GGTTGAAGG.GCACGCATT
GGTTGAAGG.GCGCTAGAA	GGTTGAAGG.GCGCTAGAA
GGTTGAAGG.TACATGCAC	GGTTGAAGG.TACATGCAC
GGTTGAAGG.TCGAATAGA	GGTTGAAGG.TCGAATAGA
GGTTGCTAT.ACTAAGTTC	GGTTGCTAT.ACTAAGTTC
GGTTGCTAT.CTTAACAGC	GGTTGCTAT.CTTAACAGC
GGTTGCTAT.GAGTCCAAT	GGTTGCTAT.GAGTCCAAT
GGTTGCTAT.GAGTGCATA	GGTTGCTAT.GAGTGCATA
GGTTGCTAT.GATCTGTTC	GGTTGCTAT.GATCTGTTC
GGTTGCTAT.GCCGAGTCT	GGTTGCTAT.GCCGAGTCT
GGTTGCTAT.GTGTTCCAG	GGTTGCTAT.GTGTTCCAG
GGTTGCTAT.GTTCACTCC	GGTTGCTAT.GTTCACTCC
GTAACAGTC.CAACACCTA	GTAACAGTC.CAACACCTA
GTAACAGTC.CCATTCTGC	GTAACAGTC.CCATTCTGC
GTAACAGTC.CTATAGCTC	GTAACAGTC.CTATAGCTC
GTAACAGTC.GAGAACAGG	GTAACAGTC.GAGAACAGG
GTAACAGTC.GCTATGTAA	GTAACAGTC.GCTATGTAA
GTAACAGTC.TGGAGAACC	GTAACAGTC.TGGAGAACC
GTAACAGTC.TTGGAGAAC	GTAACAGTC.TTGGAGAAC
GTAACCATA.CTAGACATG	GTAACCATA.CTAGACATG
GTAACCATA.GAGGTGAGC	GTAACCATA.GAGGTGAGC
GTAACCATA.GATCGATAC	GTAACCATA.GATCGATAC
GTAACCATA.GGTCCTAAG	GTAACCATA.GGTCCTAAG
GTAACGCGA.AGGATGCGT	GTAACGCGA.AGGATGCGT
GTAACGCGA.TCTGATGAA	GTAACGCGA.TCTGATGAA
GTAACTCAT.AACAATGCA	GTAACTCAT.AACAATGCA
GTAACTCAT.ACTGGTGCT	GTAACTCAT.ACTGGTGCT
GTAACTCAT.AGTGGAATG	GTAACTCAT.AGTGGAATG
GTAACTCAT.CCGCAGCTA	GTAACTCAT.CCGCAGCTA
GTAACTCAT.CGTGTCCGA	GTAACTCAT.CGTGTCCGA
GTAACTCAT.GCAGCGATA	GTAACTCAT.GCAGCGATA
GTAAGGTCC.AATCCGCTG	GTAAGGTCC.AATCCGCTG
GTAAGGTCC.AGTCGATCA	GTAAGGTCC.AGTCGATCA
GTAAGGTCC.CATCGCTGG	GTAAGGTCC.CATCGCTGG
GTAAGGTCC.GTGTCGAGC	GTAAGGTCC.GTGTCGAGC
GTAAGGTCC.TAACATTGG	GTAAGGTCC.TAACATTGG
GTAAGGTCC.TCATCTGTC	GTAAGGTCC.TCATCTGTC
GTAAGGTCC.TGCGTAATC	GTAAGGTCC.TGCGTAATC
GTAAGTGAG.AATGCGTGC	GTAAGTGAG.AATGCGTGC
GTAAGTGAG.AGCAGACAA	GTAAGTGAG.AGCAGACAA
GTAAGTGAG.AGTGTGCAC	GTAAGTGAG.AGTGTGCAC
GTAAGTGAG.CATCGAAGC	GTAAGTGAG.CATCGAAGC
GTAAGTGAG.CCTCTCTAG	GTAAGTGAG.CCTCTCTAG
GTAAGTGAG.CTACGTTGG	GTAAGTGAG.CTACGTTGG
GTAAGTGAG.GGATACAAT	GTAAGTGAG.GGATACAAT
GTAAGTGAG.TAGTTGACG	GTAAGTGAG.TAGTTGACG
GTAATATCG.AACCGTGAG	GTAATATCG.AACCGTGAG
GTAATATCG.ATCCGTCTC	GTAATATCG.ATCCGTCTC
GTAATATCG.CACCTCGGA	GTAATATCG.CACCTCGGA
GTAATATCG.GCACTGGAT	GTAATATCG.GCACTGGAT
GTAATATCG.TGCATCGGA	GTAATATCG.TGCATCGGA
GTAATATCG.TGGTGGATC	GTAATATCG.TGGTGGATC
GTAATATCG.TGTATGTAG	GTAATATCG.TGTATGTAG
GTAATCAGC.GGAGACACA	GTAATCAGC.GGAGACACA
GTAATCAGC.TCGCATTCG	GTAATCAGC.TCGCATTCG
GTAATCAGC.TTATCGCAC	GTAATCAGC.TTATCGCAC
GTACAATGC.ACCTCCTAG	GTACAATGC.ACCTCCTAG
GTACAATGC.AGTACTCTC	GTACAATGC.AGTACTCTC
GTACAATGC.TATTACTCG	GTACAATGC.TATTACTCG
GTACAATGC.TCTCAGGAT	GTACAATGC.TCTCAGGAT
GTACAATGC.TTACTTACG	GTACAATGC.TTACTTACG
GTACCACAA.AGATGAGAT	GTACCACAA.AGATGAGAT
GTACCACAA.TAAGGTGAT	GTACCACAA.TAAGGTGAT
GTACCACAA.TCGCTGATT	GTACCACAA.TCGCTGATT
GTACCACAA.TGGACTGCC	GTACCACAA.TGGACTGCC
GTACCTAAC.CGCGATGTA	GTACCTAAC.CGCGATGTA
GTACCTAAC.GCGTTCAGA	GTACCTAAC.GCGTTCAGA
GTACCTAAC.TCCTATTCC	GTACCTAAC.TCCTATTCC
GTACCTAAC.TGAGATCAT	GTACCTAAC.TGAGATCAT
GTACGAACG.AGTCCAGTG	GTACGAACG.AGTCCAGTG
GTACGAACG.GCTATGTAA	GTACGAACG.GCTATGTAA
GTACGAACG.GGAGTTAGC	GTACGAACG.GGAGTTAGC
GTACGAACG.TGCTCCTCC	GTACGAACG.TGCTCCTCC
GTACGCGAT.AGTCCGTGT	GTACGCGAT.AGTCCGTGT
GTACGCGAT.CCGCAACAC	GTACGCGAT.CCGCAACAC
GTACGCGAT.TTCCTCGGT	GTACGCGAT.TTCCTCGGT
GTACGTCTA.AATACCTTG	GTACGTCTA.AATACCTTG
GTACGTCTA.AATCGCCAT	GTACGTCTA.AATCGCCAT
GTACGTCTA.CCTCCAATC	GTACGTCTA.CCTCCAATC
GTACGTCTA.TGAGTGACT	GTACGTCTA.TGAGTGACT
GTACGTCTA.TTACGCTCG	GTACGTCTA.TTACGCTCG
GTACGTCTA.TTCCAATTC	GTACGTCTA.TTCCAATTC
GTACGTCTA.TTCCTAAGG	GTACGTCTA.TTCCTAAGG
