TACGAGTGA.CCGCAGCTA	TACGAGTGA.CCGCAGCTA
TACGAGTGA.GAATTGTTG	TACGAGTGA.GAATTGTTG
TACGGTCGT.CAGCTGGAG	TACGGTCGT.CAGCTGGAG
TACGGTCGT.GTGCTCGGA	TACGGTCGT.GTGCTCGGA
TACGGTCGT.TCGTCCGAT	TACGGTCGT.TCGTCCGAT
TACGTTACC.ACCGTCCTA	TACGTTACC.ACCGTCCTA
TACGTTACC.CAACACCTA	TACGTTACC.CAACACCTA
TACGTTACC.TGGTGGTAA	TACGTTACC.TGGTGGTAA
TACGTTACC.TTGAGACGG	TACGTTACC.TTGAGACGG
TACGTTGGA.ACATTCCAC	TACGTTGGA.ACATTCCAC
TACGTTGGA.AGACTTCGT	TACGTTGGA.AGACTTCGT
TACGTTGGA.CTATGGATG	TACGTTGGA.CTATGGATG
TACGTTGGA.GACAGGTTA	TACGTTGGA.GACAGGTTA
TACGTTGGA.GGTTCTATC	TACGTTGGA.GGTTCTATC
TACGTTGGA.TCTGAGATA	TACGTTGGA.TCTGAGATA
TACTACTGT.AACGGAGAT	TACTACTGT.AACGGAGAT
TACTACTGT.AACTGCGAC	TACTACTGT.AACTGCGAC
TACTACTGT.CATAGGTGT	TACTACTGT.CATAGGTGT
TACTACTGT.GTCTACCAA	TACTACTGT.GTCTACCAA
TACTAGTAG.ACTCGCTGT	TACTAGTAG.ACTCGCTGT
TACTAGTAG.ATGAGGTAT	TACTAGTAG.ATGAGGTAT
TACTAGTAG.CATTCGAAT	TACTAGTAG.CATTCGAAT
TACTAGTAG.CTCGTTCAC	TACTAGTAG.CTCGTTCAC
TACTAGTAG.TAAGCCATT	TACTAGTAG.TAAGCCATT
TACTAGTAG.TAGCACTAT	TACTAGTAG.TAGCACTAT
TACTAGTAG.TAGCGAGAA	TACTAGTAG.TAGCGAGAA
TACTCGACC.AATTAGAGG	TACTCGACC.AATTAGAGG
TACTCGACC.CCAGTACTC	TACTCGACC.CCAGTACTC
TACTCGACC.CTGTACGAC	TACTCGACC.CTGTACGAC
TACTCGACC.GATTGAGTA	TACTCGACC.GATTGAGTA
TACTCGACC.GCCACATGG	TACTCGACC.GCCACATGG
TACTCGACC.TATGACCGA	TACTCGACC.TATGACCGA
TACTCGACC.TTGAGACGG	TACTCGACC.TTGAGACGG
TACTCGCTG.CAGCTCTTC	TACTCGCTG.CAGCTCTTC
TACTCGCTG.CCGACGTCA	TACTCGCTG.CCGACGTCA
TACTCGCTG.GCCGTCTTC	TACTCGCTG.GCCGTCTTC
TACTCGCTG.TAAGTGTAG	TACTCGCTG.TAAGTGTAG
TACTCGCTG.TACAGGACT	TACTCGCTG.TACAGGACT
TACTCGCTG.TCCACGTGC	TACTCGCTG.TCCACGTGC
TACTCGCTG.TGCGTAATC	TACTCGCTG.TGCGTAATC
TACTGATGA.ACATTGACA	TACTGATGA.ACATTGACA
TACTGATGA.CCTTGCTTG	TACTGATGA.CCTTGCTTG
TACTGATGA.CGTGTCCGA	TACTGATGA.CGTGTCCGA
TACTGATGA.TCACGCGAC	TACTGATGA.TCACGCGAC
TACTTACCA.ATAAGACAG	TACTTACCA.ATAAGACAG
TACTTACCA.CCGTCAGGT	TACTTACCA.CCGTCAGGT
TACTTACCA.CTCTGTCAA	TACTTACCA.CTCTGTCAA
TACTTACCA.GCCGTTGTT	TACTTACCA.GCCGTTGTT
TACTTACCA.GCCTGGAAT	TACTTACCA.GCCTGGAAT
TACTTACCA.TTAGATCGG	TACTTACCA.TTAGATCGG
TACTTCCAG.TTCCTGCTA	TACTTCCAG.TTCCTGCTA
TAGACACGT.GATCGCGAA	TAGACACGT.GATCGCGAA
TAGACACGT.TGGAACTAA	TAGACACGT.TGGAACTAA
TAGACCATG.CACTAGACT	TAGACCATG.CACTAGACT
TAGACCATG.CCTGCAGAT	TAGACCATG.CCTGCAGAT
TAGACCATG.TGGTCTACG	TAGACCATG.TGGTCTACG
TAGACCATG.TTGACCTGA	TAGACCATG.TTGACCTGA
TAGACCGCA.AAGAGAACT	TAGACCGCA.AAGAGAACT
TAGACCGCA.AAGCTGAGG	TAGACCGCA.AAGCTGAGG
TAGACCTAC.ATGAACTAG	TAGACCTAC.ATGAACTAG
TAGAGACTA.AGACGCCTG	TAGAGACTA.AGACGCCTG
TAGAGACTA.ATATGTCCA	TAGAGACTA.ATATGTCCA
TAGAGACTA.ATTGATCAC	TAGAGACTA.ATTGATCAC
TAGAGACTA.GCGTATAGG	TAGAGACTA.GCGTATAGG
TAGAGACTA.GGTGTGACC	TAGAGACTA.GGTGTGACC
TAGAGACTA.TCTATGACA	TAGAGACTA.TCTATGACA
TAGAGCCAG.CCTACTAGA	TAGAGCCAG.CCTACTAGA
TAGAGCCAG.CTTAAGTTG	TAGAGCCAG.CTTAAGTTG
TAGAGCCAG.GGAGCTCAA	TAGAGCCAG.GGAGCTCAA
TAGAGCGTC.AACACACTC	TAGAGCGTC.AACACACTC
TAGAGCGTC.GGTTCTATC	TAGAGCGTC.GGTTCTATC
TAGAGCGTC.TGAGACAGC	TAGAGCGTC.TGAGACAGC
TAGATAGCC.CTCTCAGTC	TAGATAGCC.CTCTCAGTC
TAGATAGCC.TAGATAGCC	TAGATAGCC.TAGATAGCC
TAGATCTGT.AAGCCACAC	TAGATCTGT.AAGCCACAC
TAGATCTGT.ACATGACTA	TAGATCTGT.ACATGACTA
TAGATCTGT.CGCCACCAT	TAGATCTGT.CGCCACCAT
TAGATCTGT.GTCCTAGTT	TAGATCTGT.GTCCTAGTT
TAGATCTGT.TCCATCATT	TAGATCTGT.TCCATCATT
TAGATCTGT.TCTACGCAA	TAGATCTGT.TCTACGCAA
TAGCACACG.ACGTCGCTC	TAGCACACG.ACGTCGCTC
TAGCACACG.AGTAGAGGA	TAGCACACG.AGTAGAGGA
TAGCACACG.ATGCTCACC	TAGCACACG.ATGCTCACC
TAGCACACG.CAGTGCTGC	TAGCACACG.CAGTGCTGC
TAGCACACG.CCGATCAGC	TAGCACACG.CCGATCAGC
TAGCACACG.CTGCAGAGC	TAGCACACG.CTGCAGAGC
TAGCACACG.TAGCGAGAA	TAGCACACG.TAGCGAGAA
TAGCACTAT.GAAGTGTGA	TAGCACTAT.GAAGTGTGA
TAGCACTAT.GCCTGCATC	TAGCACTAT.GCCTGCATC
TAGCACTAT.GCTACCTTA	TAGCACTAT.GCTACCTTA
TAGCACTAT.GTAGCTACA	TAGCACTAT.GTAGCTACA
TAGCAGAGT.AGACTTCGT	TAGCAGAGT.AGACTTCGT
TAGCAGAGT.CAGTGCTGC	TAGCAGAGT.CAGTGCTGC
TAGCAGAGT.TATCCTCAG	TAGCAGAGT.TATCCTCAG
TAGCAGAGT.TCGGATGTT	TAGCAGAGT.TCGGATGTT
TAGCAGAGT.TGTCATAGC	TAGCAGAGT.TGTCATAGC
TAGCCAGTG.AGTATGACG	TAGCCAGTG.AGTATGACG
TAGCCAGTG.CACAATAAC	TAGCCAGTG.CACAATAAC
TAGCCAGTG.CCTCGAGAG	TAGCCAGTG.CCTCGAGAG
TAGCCAGTG.TCCAGAACG	TAGCCAGTG.TCCAGAACG
TAGCCAGTG.TGCGACGTT	TAGCCAGTG.TGCGACGTT
TAGCCTTGT.AAGGTGCTG	TAGCCTTGT.AAGGTGCTG
TAGCCTTGT.GATCTAGAG	TAGCCTTGT.GATCTAGAG
TAGCCTTGT.GCAACCAAC	TAGCCTTGT.GCAACCAAC
TAGCGAGAA.CACAGCGAA	TAGCGAGAA.CACAGCGAA
TAGCGAGAA.CCGCATCCT	TAGCGAGAA.CCGCATCCT
TAGCGAGAA.GCACGCATT	TAGCGAGAA.GCACGCATT
TAGCGAGAA.GGAACCTAG	TAGCGAGAA.GGAACCTAG
TAGCGAGAA.GTAGGACGC	TAGCGAGAA.GTAGGACGC
TAGCGAGAA.GTATCGTCG	TAGCGAGAA.GTATCGTCG
TAGCGAGAA.TACCTCCTC	TAGCGAGAA.TACCTCCTC
TAGCGAGAA.TGCTCAGCG	TAGCGAGAA.TGCTCAGCG
TAGCGCAGC.AGTACTACA	TAGCGCAGC.AGTACTACA
TAGCGCAGC.CATCGAAGC	TAGCGCAGC.CATCGAAGC
TAGCGCAGC.GTATGTATC	TAGCGCAGC.GTATGTATC
TAGCTAAGA.CCTTCCTCA	TAGCTAAGA.CCTTCCTCA
TAGCTAAGA.GGAGTTAGC	TAGCTAAGA.GGAGTTAGC
TAGCTAAGA.TACCTATCC	TAGCTAAGA.TACCTATCC
TAGCTAAGA.TCACATACT	TAGCTAAGA.TCACATACT
TAGCTAAGA.TCGATTCAG	TAGCTAAGA.TCGATTCAG
TAGCTGTTG.AATGCTGAT	TAGCTGTTG.AATGCTGAT
TAGCTGTTG.CATGGTCGA	TAGCTGTTG.CATGGTCGA
TAGCTGTTG.GCGTGATAC	TAGCTGTTG.GCGTGATAC
TAGCTGTTG.GGATTACGC	TAGCTGTTG.GGATTACGC
TAGCTGTTG.TGATACCGT	TAGCTGTTG.TGATACCGT
TAGGAGCTA.AGTCGATCA	TAGGAGCTA.AGTCGATCA
TAGGAGCTA.TAGGAGCTA	TAGGAGCTA.TAGGAGCTA
TAGGAGGAT.AGCTATATG	TAGGAGGAT.AGCTATATG
TAGGAGGAT.CGAATGAGT	TAGGAGGAT.CGAATGAGT
TAGGAGGAT.GACGTGGTC	TAGGAGGAT.GACGTGGTC
TAGGAGGAT.TCCTCTAGT	TAGGAGGAT.TCCTCTAGT
TAGGATGCC.AACTCCATG	TAGGATGCC.AACTCCATG
TAGGATGCC.ACATGGATT	TAGGATGCC.ACATGGATT
TAGGATGCC.ACGTATGTC	TAGGATGCC.ACGTATGTC
TAGGATGCC.AGAAGTAAC	TAGGATGCC.AGAAGTAAC
TAGGATGCC.ATAGACCGA	TAGGATGCC.ATAGACCGA
TAGGATGCC.TTCATCCAA	TAGGATGCC.TTCATCCAA
TAGGATTAG.CTCGTGTCC	TAGGATTAG.CTCGTGTCC
TAGGATTAG.TTACTAGTC	TAGGATTAG.TTACTAGTC
TAGGTCAAC.ACACACCGT	TAGGTCAAC.ACACACCGT
TAGGTCAAC.CGTACATCT	TAGGTCAAC.CGTACATCT
TAGGTTAGT.ACAAGTACA	TAGGTTAGT.ACAAGTACA
TAGGTTAGT.AGTCGTCCG	TAGGTTAGT.AGTCGTCCG
TAGGTTAGT.ATCCTGCCT	TAGGTTAGT.ATCCTGCCT
TAGGTTAGT.CTGTCACTT	TAGGTTAGT.CTGTCACTT
TAGGTTAGT.CTTAATCGT	TAGGTTAGT.CTTAATCGT
TAGGTTAGT.TAAGGTCCG	TAGGTTAGT.TAAGGTCCG
TAGGTTAGT.TCAGAGTCA	TAGGTTAGT.TCAGAGTCA
TAGTAACGG.ACTGACTAC	TAGTAACGG.ACTGACTAC
TAGTAACGG.CAATACCAC	TAGTAACGG.CAATACCAC
TAGTAACGG.CGCAACCTC	TAGTAACGG.CGCAACCTC
TAGTAACGG.GACCACTCG	TAGTAACGG.GACCACTCG
TAGTAACGG.TTACTAGTC	TAGTAACGG.TTACTAGTC
TAGTACGTA.CACAATAAC	TAGTACGTA.CACAATAAC
TAGTAGTCT.ACGTGCTCG	TAGTAGTCT.ACGTGCTCG
TAGTAGTCT.CGCATCTAC	TAGTAGTCT.CGCATCTAC
TAGTAGTCT.GGAACTGCT	TAGTAGTCT.GGAACTGCT
TAGTCAGAC.AGTACGAAT	TAGTCAGAC.AGTACGAAT
TAGTCAGAC.GCAATGAGA	TAGTCAGAC.GCAATGAGA
TAGTCGCAT.ATATAGCGT	TAGTCGCAT.ATATAGCGT
TAGTCGCAT.CGTGACCAG	TAGTCGCAT.CGTGACCAG
TAGTCGCAT.CTGCATGTT	TAGTCGCAT.CTGCATGTT
TAGTCGCAT.GCGAAGACA	TAGTCGCAT.GCGAAGACA
TAGTCGCAT.GTGTTGGAA	TAGTCGCAT.GTGTTGGAA
TAGTCGCAT.TCCTCTAGT	TAGTCGCAT.TCCTCTAGT
TAGTCGCAT.TGCGTCTTA	TAGTCGCAT.TGCGTCTTA
TAGTGATCC.AACGAGAAT	TAGTGATCC.AACGAGAAT
TAGTGATCC.AAGACTGGT	TAGTGATCC.AAGACTGGT
TAGTGATCC.ACAGAAGAG	TAGTGATCC.ACAGAAGAG
TAGTGATCC.CACGACTCA	TAGTGATCC.CACGACTCA
TAGTGATCC.CATACGCAG	TAGTGATCC.CATACGCAG
TAGTGCACT.ATTCACCTC	TAGTGCACT.ATTCACCTC
TAGTGCACT.GTCATTCTA	TAGTGCACT.GTCATTCTA
TAGTTGACG.ACCGTCCTA	TAGTTGACG.ACCGTCCTA
TAGTTGACG.ATATCAGCC	TAGTTGACG.ATATCAGCC
TAGTTGACG.CCATATCTT	TAGTTGACG.CCATATCTT
TAGTTGACG.CCTGCAGAT	TAGTTGACG.CCTGCAGAT
TAGTTGACG.TTATGAGGA	TAGTTGACG.TTATGAGGA
TATAATCGC.AAGGTGCTG	TATAATCGC.AAGGTGCTG
TATAATCGC.ATGAACTAG	TATAATCGC.ATGAACTAG
TATAATCGC.CAGTCGGTA	TATAATCGC.CAGTCGGTA
TATAATCGC.GCAGATCCG	TATAATCGC.GCAGATCCG
TATAATCGC.GTGCTCTTG	TATAATCGC.GTGCTCTTG
TATAATCGC.TCCACCTCA	TATAATCGC.TCCACCTCA
TATACCACT.ACCTAGTTA	TATACCACT.ACCTAGTTA
TATACCACT.CACTTGGAT	TATACCACT.CACTTGGAT
TATACCACT.CCTTATCCG	TATACCACT.CCTTATCCG
TATACCACT.CTCGTGTCC	TATACCACT.CTCGTGTCC
TATACCACT.TCCGATAAC	TATACCACT.TCCGATAAC
TATACCACT.TGATTGTGC	TATACCACT.TGATTGTGC
TATACCACT.TTAACGGAG	TATACCACT.TTAACGGAG
TATACCACT.TTCCTTGAC	TATACCACT.TTCCTTGAC
TATACGGAT.AACTAACTG	TATACGGAT.AACTAACTG
TATACGGAT.GCATGTAAG	TATACGGAT.GCATGTAAG
TATACGGAT.TCCGATCTG	TATACGGAT.TCCGATCTG
TATACGGAT.TTAGTCGGA	TATACGGAT.TTAGTCGGA
TATACGTGG.ACCAGCGTT	TATACGTGG.ACCAGCGTT
TATACGTGG.CACTAGACT	TATACGTGG.CACTAGACT
TATACGTGG.CGCCATTAC	TATACGTGG.CGCCATTAC
TATACGTGG.GTCCACAAC	TATACGTGG.GTCCACAAC
TATAGTGCG.ATGCTTCAG	TATAGTGCG.ATGCTTCAG
TATAGTGCG.CCTGTTAGC	TATAGTGCG.CCTGTTAGC
TATAGTGCG.TCCAGCTAT	TATAGTGCG.TCCAGCTAT
TATCACCTG.AACGAGAAT	TATCACCTG.AACGAGAAT
TATCACCTG.AATGCCTCA	TATCACCTG.AATGCCTCA
TATCACCTG.AGTCTAAGC	TATCACCTG.AGTCTAAGC
TATCACCTG.GCTTAGAAC	TATCACCTG.GCTTAGAAC
TATCAGTGC.ATGGAGAGT	TATCAGTGC.ATGGAGAGT
TATCAGTGC.CATCCGACA	TATCAGTGC.CATCCGACA
TATCAGTGC.GTAAGGTCC	TATCAGTGC.GTAAGGTCC
TATCAGTGC.TGACAAGTT	TATCAGTGC.TGACAAGTT
TATCATGCT.ACCACGCTA	TATCATGCT.ACCACGCTA
TATCATGCT.CAGGTTGTC	TATCATGCT.CAGGTTGTC
TATCATGCT.CCGGATTGC	TATCATGCT.CCGGATTGC
TATCATGCT.CTGGAGCGA	TATCATGCT.CTGGAGCGA
TATCATGCT.GATCTGTTC	TATCATGCT.GATCTGTTC
TATCATGCT.TCGGACAGT	TATCATGCT.TCGGACAGT
TATCCTCAG.AAGTTCTCT	TATCCTCAG.AAGTTCTCT
TATCCTCAG.ACACAGAAC	TATCCTCAG.ACACAGAAC
TATCCTCAG.ACAGCATCA	TATCCTCAG.ACAGCATCA
TATCCTCAG.ACGTGTAGT	TATCCTCAG.ACGTGTAGT
TATCCTCAG.AGACCAGCT	TATCCTCAG.AGACCAGCT
TATCCTCAG.CCTAGAGTA	TATCCTCAG.CCTAGAGTA
TATCCTCAG.CGGTGTTAC	TATCCTCAG.CGGTGTTAC
TATCCTCAG.TAGCGCAGC	TATCCTCAG.TAGCGCAGC
TATCCTCAG.TGGTGGATC	TATCCTCAG.TGGTGGATC
TATCGAGCC.AGAGCGGAG	TATCGAGCC.AGAGCGGAG
TATCGAGCC.AGCATTCCA	TATCGAGCC.AGCATTCCA
TATCGAGCC.CCTCTTGTA	TATCGAGCC.CCTCTTGTA
TATCGAGCC.GAGATACAC	TATCGAGCC.GAGATACAC
TATCGAGCC.GTCTTCATA	TATCGAGCC.GTCTTCATA
TATCGGAAC.GTCACTATG	TATCGGAAC.GTCACTATG
TATCTAGGT.AAGTTGCCA	TATCTAGGT.AAGTTGCCA
TATCTAGGT.AGAGGTGAA	TATCTAGGT.AGAGGTGAA
TATCTAGGT.ATAGCCTAA	TATCTAGGT.ATAGCCTAA
TATCTAGGT.ATTCGCTTA	TATCTAGGT.ATTCGCTTA
TATCTAGGT.GTCTGACGT	TATCTAGGT.GTCTGACGT
TATCTAGGT.TACCGATTG	TATCTAGGT.TACCGATTG
TATCTAGGT.TCACACTGC	TATCTAGGT.TCACACTGC
TATCTGTCA.AACCATGGT	TATCTGTCA.AACCATGGT
TATCTGTCA.CCTAGTCTC	TATCTGTCA.CCTAGTCTC
TATCTGTCA.CTGAGTAGC	TATCTGTCA.CTGAGTAGC
TATCTGTCA.GCGTATAGG	TATCTGTCA.GCGTATAGG
TATCTGTCA.TGCAGCCTT	TATCTGTCA.TGCAGCCTT
TATGAAGAC.AAGACTACC	TATGAAGAC.AAGACTACC
TATGAAGAC.ACGCTATGT	TATGAAGAC.ACGCTATGT
TATGAAGAC.GTCAGTTGT	TATGAAGAC.GTCAGTTGT
TATGAAGAC.TCGTGACGT	TATGAAGAC.TCGTGACGT
TATGACCGA.ACGCTATGT	TATGACCGA.ACGCTATGT
TATGACCGA.CAGCTAGTT	TATGACCGA.CAGCTAGTT
TATGACCGA.GCCATCGCT	TATGACCGA.GCCATCGCT
TATGACCGA.GTAACGCGA	TATGACCGA.GTAACGCGA
TATGACCGA.GTGCTCGGA	TATGACCGA.GTGCTCGGA
TATGACCGA.TACTCGACC	TATGACCGA.TACTCGACC
TATGAGACC.TCACACTGC	TATGAGACC.TCACACTGC
TATGATGTG.ATCAGAAGC	TATGATGTG.ATCAGAAGC
TATGATGTG.TATCACCTG	TATGATGTG.TATCACCTG
TATGATGTG.TATTACAGC	TATGATGTG.TATTACAGC
TATGATGTG.TCGCCAAGC	TATGATGTG.TCGCCAAGC
TATGCCTTC.AGTACTACA	TATGCCTTC.AGTACTACA
TATGCCTTC.CAGTCGGTA	TATGCCTTC.CAGTCGGTA
TATGCCTTC.CCGACGTCA	TATGCCTTC.CCGACGTCA
TATGCCTTC.CTATTCCGT	TATGCCTTC.CTATTCCGT
TATGCCTTC.CTGATCAAG	TATGCCTTC.CTGATCAAG
TATGCCTTC.GCAATGAGA	TATGCCTTC.GCAATGAGA
TATGGTTGG.AGCACCAGC	TATGGTTGG.AGCACCAGC
TATGGTTGG.ATAGTCAGT	TATGGTTGG.ATAGTCAGT
TATGGTTGG.ATATAGCGT	TATGGTTGG.ATATAGCGT
TATGGTTGG.ATCCTGCCT	TATGGTTGG.ATCCTGCCT
TATGGTTGG.ATCGCCTCT	TATGGTTGG.ATCGCCTCT
TATGGTTGG.ATTAAGACC	TATGGTTGG.ATTAAGACC
TATGGTTGG.CCAATATAC	TATGGTTGG.CCAATATAC
TATGGTTGG.CGTGACCAG	TATGGTTGG.CGTGACCAG
TATGGTTGG.GAACTATGG	TATGGTTGG.GAACTATGG
TATGGTTGG.TGCACGATG	TATGGTTGG.TGCACGATG
TATGGTTGG.TGCGTCTTA	TATGGTTGG.TGCGTCTTA
TATGGTTGG.TTGACCTGA	TATGGTTGG.TTGACCTGA
TATGTACCT.CTCGCAAGA	TATGTACCT.CTCGCAAGA
TATGTACCT.GAGATGTAT	TATGTACCT.GAGATGTAT
TATGTACCT.TTCACTCCT	TATGTACCT.TTCACTCCT
TATGTATGC.CCTCGAGAG	TATGTATGC.CCTCGAGAG
TATGTATGC.GTCAGCGTC	TATGTATGC.GTCAGCGTC
TATGTATGC.GTCAGTTGT	TATGTATGC.GTCAGTTGT
TATGTATGC.GTCTTCATA	TATGTATGC.GTCTTCATA
TATGTATGC.GTTCCAACA	TATGTATGC.GTTCCAACA
TATTACAGC.CAGCTTACC	TATTACAGC.CAGCTTACC
TATTACAGC.TGGATTAGC	TATTACAGC.TGGATTAGC
TATTACTCG.GCTGACAGA	TATTACTCG.GCTGACAGA
TATTACTCG.TTACAGTGT	TATTACTCG.TTACAGTGT
TATTCAACG.ACAATAGGT	TATTCAACG.ACAATAGGT
TATTCAACG.AGTGTCTCT	TATTCAACG.AGTGTCTCT
TATTCAACG.CTCGTTCAC	TATTCAACG.CTCGTTCAC
TATTCAACG.CTGTCACTT	TATTCAACG.CTGTCACTT
TATTCAACG.TACCTCCTC	TATTCAACG.TACCTCCTC
TATTCAACG.TCCGTATAC	TATTCAACG.TCCGTATAC
TATTGCTAC.AACAACCTA	TATTGCTAC.AACAACCTA
TATTGCTAC.ACAACGAGC	TATTGCTAC.ACAACGAGC
TATTGCTAC.CAGTTGAGT	TATTGCTAC.CAGTTGAGT
TATTGCTAC.CGGTGAGTC	TATTGCTAC.CGGTGAGTC
TATTGCTAC.CTGGTACAT	TATTGCTAC.CTGGTACAT
TCAACACTC.AGATACGTT	TCAACACTC.AGATACGTT
TCAACACTC.AGCCTCGCA	TCAACACTC.AGCCTCGCA
TCAACACTC.AGTGTCTCT	TCAACACTC.AGTGTCTCT
TCAACACTC.CAGTTGAGT	TCAACACTC.CAGTTGAGT
TCAACACTC.GAATCGAGA	TCAACACTC.GAATCGAGA
TCAACACTC.TCCTTAGGT	TCAACACTC.TCCTTAGGT
TCAAGCGTA.ACCACGCTA	TCAAGCGTA.ACCACGCTA
TCAAGCGTA.ATACCGCTT	TCAAGCGTA.ATACCGCTT
TCAAGCGTA.CACTGTATC	TCAAGCGTA.CACTGTATC
TCAAGCGTA.CATAGTATG	TCAAGCGTA.CATAGTATG
TCAAGCGTA.TTACGGACC	TCAAGCGTA.TTACGGACC
TCAAGGAGT.AGAGGTGAA	TCAAGGAGT.AGAGGTGAA
TCAAGGAGT.CCGAGCTGA	TCAAGGAGT.CCGAGCTGA
TCAAGGAGT.CCTAAGTCT	TCAAGGAGT.CCTAAGTCT
TCAAGGAGT.CGCATCTAC	TCAAGGAGT.CGCATCTAC
TCAAGGAGT.CGCTGTAGT	TCAAGGAGT.CGCTGTAGT
TCAAGGTCG.AGTTGTGTA	TCAAGGTCG.AGTTGTGTA
TCAAGGTCG.CCTGTATCT	TCAAGGTCG.CCTGTATCT
TCAAGGTCG.GAAGGATCA	TCAAGGTCG.GAAGGATCA
TCAAGGTCG.TGATGGACA	TCAAGGTCG.TGATGGACA
TCAATCTAG.ACGTATGTC	TCAATCTAG.ACGTATGTC
TCAATCTAG.CCATACGAT	TCAATCTAG.CCATACGAT
TCAATCTAG.GAGATGTAT	TCAATCTAG.GAGATGTAT
TCAATCTAG.GCATGTAAG	TCAATCTAG.GCATGTAAG
TCAATCTAG.GTGAGGACG	TCAATCTAG.GTGAGGACG
TCAATCTAG.TCAAGCGTA	TCAATCTAG.TCAAGCGTA
TCAATGGAC.ATCTAGGTT	TCAATGGAC.ATCTAGGTT
TCACACTGC.CAAGAGGAG	TCACACTGC.CAAGAGGAG
TCACACTGC.CGGATTCTC	TCACACTGC.CGGATTCTC
TCACACTGC.TACAAGAGG	TCACACTGC.TACAAGAGG
TCACAGGTA.CCAGCCAAT	TCACAGGTA.CCAGCCAAT
TCACAGGTA.CTACGTTGG	TCACAGGTA.CTACGTTGG
TCACAGGTA.TGAGATCAT	TCACAGGTA.TGAGATCAT
TCACAGGTA.TTCGGAGTC	TCACAGGTA.TTCGGAGTC
TCACATACT.ACCGGAAGG	TCACATACT.ACCGGAAGG
TCACATACT.CTTCCGGTA	TCACATACT.CTTCCGGTA
TCACATACT.GTGAGGACG	TCACATACT.GTGAGGACG
TCACATACT.GTTGATGCA	TCACATACT.GTTGATGCA
TCACATACT.TCGAACGCT	TCACATACT.TCGAACGCT
TCACATACT.TTGTTAGAG	TCACATACT.TTGTTAGAG
TCACCGAGG.AAGACTACC	TCACCGAGG.AAGACTACC
TCACCGAGG.CTGCGTCAC	TCACCGAGG.CTGCGTCAC
TCACCGAGG.GTGGAGGTC	TCACCGAGG.GTGGAGGTC
TCACGACAA.AGCCTCTAG	TCACGACAA.AGCCTCTAG
TCACGACAA.ATAAGACAG	TCACGACAA.ATAAGACAG
TCACGACAA.CTCTCAGTC	TCACGACAA.CTCTCAGTC
TCACGACAA.GACTCTGGT	TCACGACAA.GACTCTGGT
TCACGCGAC.ACCACGCTA	TCACGCGAC.ACCACGCTA
TCACGCGAC.CAACGATCG	TCACGCGAC.CAACGATCG
TCACGCGAC.GGTTACGCA	TCACGCGAC.GGTTACGCA
TCACGCGAC.TGCTCACAC	TCACGCGAC.TGCTCACAC
TCACTACGT.GCTATGTAA	TCACTACGT.GCTATGTAA
TCACTACGT.TTAACGTTC	TCACTACGT.TTAACGTTC
TCACTCGCT.ACGTACTGC	TCACTCGCT.ACGTACTGC
TCACTCGCT.AGCTCTCCG	TCACTCGCT.AGCTCTCCG
TCACTCGCT.CAGTCCTAA	TCACTCGCT.CAGTCCTAA
TCACTCGCT.GTATCGTCG	TCACTCGCT.GTATCGTCG
TCACTCGCT.TCCTCGTCG	TCACTCGCT.TCCTCGTCG
TCACTCGCT.TCGCAAGCA	TCACTCGCT.TCGCAAGCA
TCACTCGCT.TGAGCTAGA	TCACTCGCT.TGAGCTAGA
TCAGACAAG.AACTAACTG	TCAGACAAG.AACTAACTG
TCAGACAAG.AAGGAAGTC	TCAGACAAG.AAGGAAGTC
TCAGACAAG.ATCGTAGTG	TCAGACAAG.ATCGTAGTG
TCAGACAAG.CGCGATGTA	TCAGACAAG.CGCGATGTA
TCAGACAAG.GAGGTCCTT	TCAGACAAG.GAGGTCCTT
TCAGAGCGT.AAGGTCTGA	TCAGAGCGT.AAGGTCTGA
TCAGAGCGT.ACCATGTCT	TCAGAGCGT.ACCATGTCT
TCAGAGCGT.ACGACATCT	TCAGAGCGT.ACGACATCT
TCAGAGCGT.AGATATGGA	TCAGAGCGT.AGATATGGA
TCAGAGCGT.ATCTGGTAG	TCAGAGCGT.ATCTGGTAG
TCAGAGCGT.CTTACATGC	TCAGAGCGT.CTTACATGC
TCAGAGCGT.GTGTCCGTG	TCAGAGCGT.GTGTCCGTG
TCAGAGCGT.TGCGTAATC	TCAGAGCGT.TGCGTAATC
TCAGAGTCA.AGACTAGTA	TCAGAGTCA.AGACTAGTA
TCAGAGTCA.CCACCATGC	TCAGAGTCA.CCACCATGC
TCAGAGTCA.CTGAGTCCA	TCAGAGTCA.CTGAGTCCA
TCAGAGTCA.GACGGTGCT	TCAGAGTCA.GACGGTGCT
TCAGCGACC.AGTGATGCG	TCAGCGACC.AGTGATGCG
TCAGCGACC.GACACCGAT	TCAGCGACC.GACACCGAT
TCAGCGACC.TGGATTAGC	TCAGCGACC.TGGATTAGC
TCAGCTCAG.AAGCCACAC	TCAGCTCAG.AAGCCACAC
TCAGCTCAG.AGTTGCCTT	TCAGCTCAG.AGTTGCCTT
TCAGCTCAG.CACCTTCCT	TCAGCTCAG.CACCTTCCT
TCAGCTCAG.CCACTTCGC	TCAGCTCAG.CCACTTCGC
TCAGGACTG.TAGTACGTA	TCAGGACTG.TAGTACGTA
TCAGGACTG.TGCACGATG	TCAGGACTG.TGCACGATG
TCAGGACTG.TGGAATCGT	TCAGGACTG.TGGAATCGT
TCAGGTGCA.CAGTCTAAC	TCAGGTGCA.CAGTCTAAC
TCAGGTGCA.CGTCAGCAC	TCAGGTGCA.CGTCAGCAC
TCAGTAAGC.CGACCACTT	TCAGTAAGC.CGACCACTT
TCAGTAAGC.CTCCGCATT	TCAGTAAGC.CTCCGCATT
TCAGTAAGC.TGCGCACTG	TCAGTAAGC.TGCGCACTG
TCAGTAAGC.TTCATCCAA	TCAGTAAGC.TTCATCCAA
TCAGTGCAA.AAGAGAACT	TCAGTGCAA.AAGAGAACT
TCAGTGCAA.AGTGGAATG	TCAGTGCAA.AGTGGAATG
TCAGTGCAA.CAATGCATT	TCAGTGCAA.CAATGCATT
TCAGTGCAA.CAGCAGTAC	TCAGTGCAA.CAGCAGTAC
TCAGTGCAA.GGTCCTGGT	TCAGTGCAA.GGTCCTGGT
TCAGTGTTC.CAGTGCCAT	TCAGTGTTC.CAGTGCCAT
TCAGTGTTC.CTGTACGAC	TCAGTGTTC.CTGTACGAC
TCAGTGTTC.TGATTGTGC	TCAGTGTTC.TGATTGTGC
TCAGTGTTC.TTGTCAACC	TCAGTGTTC.TTGTCAACC
TCATATCGC.ATATGTCCA	TCATATCGC.ATATGTCCA
TCATCAGAG.GGACACTGG	TCATCAGAG.GGACACTGG
TCATCATCT.ACAATTCGG	TCATCATCT.ACAATTCGG
TCATCATCT.AGATGAAGA	TCATCATCT.AGATGAAGA
TCATCATCT.ATCAAGAGA	TCATCATCT.ATCAAGAGA
TCATCATCT.CGTGTATTC	TCATCATCT.CGTGTATTC
TCATCATCT.TCATGCAGG	TCATCATCT.TCATGCAGG
TCATCTGTC.ATCTCGTGA	TCATCTGTC.ATCTCGTGA
TCATCTGTC.CAAGCGCAT	TCATCTGTC.CAAGCGCAT
TCATGCAGG.AACAGCAGT	TCATGCAGG.AACAGCAGT
TCATGCAGG.AGAAGTAAC	TCATGCAGG.AGAAGTAAC
TCATGCAGG.CAGTATGAT	TCATGCAGG.CAGTATGAT
TCATGCAGG.CGTCGTCAA	TCATGCAGG.CGTCGTCAA
TCATGCAGG.GATTCTCGG	TCATGCAGG.GATTCTCGG
TCATGCAGG.TTATGAGGA	TCATGCAGG.TTATGAGGA
TCATGCAGG.TTCCGAGCG	TCATGCAGG.TTCCGAGCG
TCATGCTCA.CATCGCTGG	TCATGCTCA.CATCGCTGG
TCATGCTCA.CGACGTACG	TCATGCTCA.CGACGTACG
TCATGCTCA.CTCGACTGC	TCATGCTCA.CTCGACTGC
TCATGCTCA.GTCAGACCG	TCATGCTCA.GTCAGACCG
TCATGCTCA.TAACACATC	TCATGCTCA.TAACACATC
TCATGCTCA.TCTCCGCGT	TCATGCTCA.TCTCCGCGT
TCATGCTCA.TTCGCATCC	TCATGCTCA.TTCGCATCC
TCCAACGTG.ATGGATATC	TCCAACGTG.ATGGATATC
TCCAACGTG.CACAACCAG	TCCAACGTG.CACAACCAG
TCCAACGTG.CTGCGTCAC	TCCAACGTG.CTGCGTCAC
TCCAACGTG.TATGCCTTC	TCCAACGTG.TATGCCTTC
TCCAACGTG.TGGACTGCC	TCCAACGTG.TGGACTGCC
TCCAACGTG.TTGAGACGG	TCCAACGTG.TTGAGACGG
TCCAAGTAA.TAATTCGTG	TCCAAGTAA.TAATTCGTG
TCCAAGTAA.TACATGCAC	TCCAAGTAA.TACATGCAC
TCCAATCAT.CATACGCAG	TCCAATCAT.CATACGCAG
TCCAATCAT.GAGCACATT	TCCAATCAT.GAGCACATT
TCCAATCAT.GCTACCTTA	TCCAATCAT.GCTACCTTA
TCCAATCAT.TCAATGGAC	TCCAATCAT.TCAATGGAC
TCCACCGGT.AACCGTGAG	TCCACCGGT.AACCGTGAG
TCCACCGGT.CCGTTCCAA	TCCACCGGT.CCGTTCCAA
TCCACCGGT.CGCTTATGA	TCCACCGGT.CGCTTATGA
TCCACCGGT.CGGTTCTAT	TCCACCGGT.CGGTTCTAT
TCCACCGGT.CGTGTGTGG	TCCACCGGT.CGTGTGTGG
TCCACCGGT.GCATTGATC	TCCACCGGT.GCATTGATC
TCCACCGGT.TCGGAACGA	TCCACCGGT.TCGGAACGA
TCCACCGGT.TGTTACTGA	TCCACCGGT.TGTTACTGA
TCCACCTCA.AGTTCAACC	TCCACCTCA.AGTTCAACC
TCCACGTGC.TTCTGGTGC	TCCACGTGC.TTCTGGTGC
TCCACGTGC.TTGCCGTAG	TCCACGTGC.TTGCCGTAG
TCCAGAACG.CCGGTTGAG	TCCAGAACG.CCGGTTGAG
TCCAGAACG.CTCTGTCAA	TCCAGAACG.CTCTGTCAA
TCCAGAACG.GCCACATGG	TCCAGAACG.GCCACATGG
TCCAGAACG.GTCATTCTA	TCCAGAACG.GTCATTCTA
TCCAGCAGC.CCTAAGTCT	TCCAGCAGC.CCTAAGTCT
TCCAGCAGC.GGAGACACA	TCCAGCAGC.GGAGACACA
TCCAGCAGC.GTTAGAGAC	TCCAGCAGC.GTTAGAGAC
TCCAGCTAT.AGTTCGATA	TCCAGCTAT.AGTTCGATA
TCCAGCTAT.GTAGCATAC	TCCAGCTAT.GTAGCATAC
TCCAGCTAT.TGAACCAAT	TCCAGCTAT.TGAACCAAT
TCCATCATT.CCACGGATC	TCCATCATT.CCACGGATC
TCCATCATT.CCATCTAGG	TCCATCATT.CCATCTAGG
TCCATCATT.CCTCGCGTT	TCCATCATT.CCTCGCGTT
TCCATCATT.CGTAATGAC	TCCATCATT.CGTAATGAC
TCCATCATT.GGATTCGTC	TCCATCATT.GGATTCGTC
TCCATCATT.TTCCTTGAC	TCCATCATT.TTCCTTGAC
TCCGATAAC.CCATAAGTA	TCCGATAAC.CCATAAGTA
TCCGATAAC.GGTTCGCAA	TCCGATAAC.GGTTCGCAA
TCCGATAAC.TCACTCGCT	TCCGATAAC.TCACTCGCT
TCCGATAAC.TCTACGCAA	TCCGATAAC.TCTACGCAA
TCCGATCTG.GGATACCTA	TCCGATCTG.GGATACCTA
TCCGGAGCT.ACACTGTGA	TCCGGAGCT.ACACTGTGA
TCCGGAGCT.ACTAACCGA	TCCGGAGCT.ACTAACCGA
TCCGGAGCT.ACTGACTAC	TCCGGAGCT.ACTGACTAC
TCCGGAGCT.GAACCAGTT	TCCGGAGCT.GAACCAGTT
TCCGGAGCT.GAGTATCGC	TCCGGAGCT.GAGTATCGC
TCCGGAGCT.GCTTAGAAC	TCCGGAGCT.GCTTAGAAC
TCCGGAGCT.TATGAAGAC	TCCGGAGCT.TATGAAGAC
TCCGTATAC.AGCTCGTCT	TCCGTATAC.AGCTCGTCT
TCCGTATAC.AGCTTGGTG	TCCGTATAC.AGCTTGGTG
TCCGTATAC.ATCTGCGTA	TCCGTATAC.ATCTGCGTA
TCCGTATAC.CGATTGAAC	TCCGTATAC.CGATTGAAC
TCCGTATAC.CGTGTCCGA	TCCGTATAC.CGTGTCCGA
TCCGTATAC.GCTGATGTC	TCCGTATAC.GCTGATGTC
TCCGTATAC.TGGAGAACC	TCCGTATAC.TGGAGAACC
TCCTATTCC.AACTGCGAC	TCCTATTCC.AACTGCGAC
TCCTATTCC.AGACGGAGG	TCCTATTCC.AGACGGAGG
TCCTATTCC.CATCGAAGC	TCCTATTCC.CATCGAAGC
TCCTATTCC.CTAACTAAG	TCCTATTCC.CTAACTAAG
TCCTATTCC.GATGTTACA	TCCTATTCC.GATGTTACA
TCCTATTCC.GCTGAGCAG	TCCTATTCC.GCTGAGCAG
TCCTATTCC.TGCATCGGA	TCCTATTCC.TGCATCGGA
TCCTCGTCG.ACGTTCAAT	TCCTCGTCG.ACGTTCAAT
TCCTCGTCG.CTACCTGCG	TCCTCGTCG.CTACCTGCG
TCCTCGTCG.GATACCGGA	TCCTCGTCG.GATACCGGA
TCCTCGTCG.TCGCTGATT	TCCTCGTCG.TCGCTGATT
TCCTCTAGT.ATCTCGAAC	TCCTCTAGT.ATCTCGAAC
TCCTCTAGT.ATTCTCTGG	TCCTCTAGT.ATTCTCTGG
TCCTCTAGT.CACGGATAG	TCCTCTAGT.CACGGATAG
TCCTCTAGT.CTAGAGTCG	TCCTCTAGT.CTAGAGTCG
TCCTCTAGT.GCCACATGG	TCCTCTAGT.GCCACATGG
TCCTCTAGT.TTAGTCGGA	TCCTCTAGT.TTAGTCGGA
