GTACTCTAC.AACAACCTA	GTACTCTAC.AACAACCTA
GTACTCTAC.CTCCTATCT	GTACTCTAC.CTCCTATCT
GTACTCTAC.GATAGTTCT	GTACTCTAC.GATAGTTCT
GTAGAAGTT.ACCGTACGC	GTAGAAGTT.ACCGTACGC
GTAGAAGTT.CCGCTCATG	GTAGAAGTT.CCGCTCATG
GTAGAAGTT.GGACACTGG	GTAGAAGTT.GGACACTGG
GTAGAAGTT.TTGTCAACC	GTAGAAGTT.TTGTCAACC
GTAGACTCT.ATGGATATC	GTAGACTCT.ATGGATATC
GTAGACTCT.CACTGCTTA	GTAGACTCT.CACTGCTTA
GTAGACTCT.GCTCAGCCA	GTAGACTCT.GCTCAGCCA
GTAGACTCT.GCTGATGTC	GTAGACTCT.GCTGATGTC
GTAGACTCT.TAGAGCCAG	GTAGACTCT.TAGAGCCAG
GTAGACTCT.TCGAACGCT	GTAGACTCT.TCGAACGCT
GTAGACTCT.TGTGCAGTA	GTAGACTCT.TGTGCAGTA
GTAGAGAGC.AACCATGGT	GTAGAGAGC.AACCATGGT
GTAGAGAGC.ACTACCATC	GTAGAGAGC.ACTACCATC
GTAGAGAGC.AGATGAAGA	GTAGAGAGC.AGATGAAGA
GTAGAGAGC.CTCTGTCAA	GTAGAGAGC.CTCTGTCAA
GTAGCATAC.AGTCGTCCG	GTAGCATAC.AGTCGTCCG
GTAGCATAC.CATAGGTGT	GTAGCATAC.CATAGGTGT
GTAGCATAC.CTAGAGGTA	GTAGCATAC.CTAGAGGTA
GTAGCATAC.GGAGCATCT	GTAGCATAC.GGAGCATCT
GTAGCCTTG.ACTTCAGTA	GTAGCCTTG.ACTTCAGTA
GTAGCCTTG.CCTCCAATC	GTAGCCTTG.CCTCCAATC
GTAGCCTTG.GCACCATCG	GTAGCCTTG.GCACCATCG
GTAGCCTTG.GGATTACGC	GTAGCCTTG.GGATTACGC
GTAGCCTTG.GGTCTTGCA	GTAGCCTTG.GGTCTTGCA
GTAGCCTTG.TGGATAGGT	GTAGCCTTG.TGGATAGGT
GTAGCTACA.ACGGTGCCT	GTAGCTACA.ACGGTGCCT
GTAGCTACA.GAATTGTTG	GTAGCTACA.GAATTGTTG
GTAGCTACA.GTTCCAACA	GTAGCTACA.GTTCCAACA
GTAGGACGC.ACTGTGTCA	GTAGGACGC.ACTGTGTCA
GTAGGACGC.CTGGACACT	GTAGGACGC.CTGGACACT
GTAGGACGC.GTCAGCGTC	GTAGGACGC.GTCAGCGTC
GTAGGACGC.TGCTCACAC	GTAGGACGC.TGCTCACAC
GTAGTGGAG.GAGATGTAT	GTAGTGGAG.GAGATGTAT
GTAGTGGAG.GCTCTGTGT	GTAGTGGAG.GCTCTGTGT
GTAGTGGAG.TATTCAACG	GTAGTGGAG.TATTCAACG
GTAGTGGAG.TGCCGAACT	GTAGTGGAG.TGCCGAACT
GTAGTTGGT.CAGTACATC	GTAGTTGGT.CAGTACATC
GTAGTTGGT.CGAAGAGGT	GTAGTTGGT.CGAAGAGGT
GTAGTTGGT.TTCCAATTC	GTAGTTGGT.TTCCAATTC
GTATACAGA.TTGACCTGA	GTATACAGA.TTGACCTGA
GTATCCTGC.CAGCTCTTC	GTATCCTGC.CAGCTCTTC
GTATCCTGC.GGACAGATT	GTATCCTGC.GGACAGATT
GTATCCTGC.TAGGATTAG	GTATCCTGC.TAGGATTAG
GTATCCTGC.TGACCAAGT	GTATCCTGC.TGACCAAGT
GTATCCTGC.TTATCGCAC	GTATCCTGC.TTATCGCAC
GTATCGTCG.TGACCAAGT	GTATCGTCG.TGACCAAGT
GTATGATCT.CCTAAGAAG	GTATGATCT.CCTAAGAAG
GTATGATCT.CGCCTGCAA	GTATGATCT.CGCCTGCAA
GTATGATCT.GTCTTATGC	GTATGATCT.GTCTTATGC
GTATGATCT.TCGCTTAAC	GTATGATCT.TCGCTTAAC
GTATGCCTT.CTCCACGTC	GTATGCCTT.CTCCACGTC
GTATGCCTT.TATCATGCT	GTATGCCTT.TATCATGCT
GTATGTATC.ACGAGAGCA	GTATGTATC.ACGAGAGCA
GTATGTATC.ACGTGAATC	GTATGTATC.ACGTGAATC
GTATGTATC.CAACGATCG	GTATGTATC.CAACGATCG
GTATGTATC.CTGATCCGA	GTATGTATC.CTGATCCGA
GTATGTATC.GCCTTGTGA	GTATGTATC.GCCTTGTGA
GTATGTATC.GTCAATACA	GTATGTATC.GTCAATACA
GTATTACTG.ATTAGCACA	GTATTACTG.ATTAGCACA
GTATTACTG.GCGAGCAAG	GTATTACTG.GCGAGCAAG
GTCAACTGA.ATATAGCGT	GTCAACTGA.ATATAGCGT
GTCAACTGA.ATCTCTGCT	GTCAACTGA.ATCTCTGCT
GTCAACTGA.CCGCTATCC	GTCAACTGA.CCGCTATCC
GTCAAGATC.ACGATGACC	GTCAAGATC.ACGATGACC
GTCAAGATC.ACTTGATCT	GTCAAGATC.ACTTGATCT
GTCAAGATC.CGGTTCTAT	GTCAAGATC.CGGTTCTAT
GTCAATACA.ATAGTGGTT	GTCAATACA.ATAGTGGTT
GTCAATACA.GATAACGTC	GTCAATACA.GATAACGTC
GTCAATACA.GGTTCGCAA	GTCAATACA.GGTTCGCAA
GTCACAGAG.AGCGTCGTC	GTCACAGAG.AGCGTCGTC
GTCACAGAG.AGTGAACGG	GTCACAGAG.AGTGAACGG
GTCACAGAG.CCATGCGTC	GTCACAGAG.CCATGCGTC
GTCACAGAG.CCGATCTCT	GTCACAGAG.CCGATCTCT
GTCACAGAG.CTCAGGTAC	GTCACAGAG.CTCAGGTAC
GTCACAGAG.GGAGACACA	GTCACAGAG.GGAGACACA
GTCACAGAG.GTGTCGAGC	GTCACAGAG.GTGTCGAGC
GTCACAGAG.TTGGTAACT	GTCACAGAG.TTGGTAACT
GTCACTATG.ACTCCAACT	GTCACTATG.ACTCCAACT
GTCACTATG.AGTTACAAG	GTCACTATG.AGTTACAAG
GTCACTATG.CGCACTCTT	GTCACTATG.CGCACTCTT
GTCACTATG.TGCCAATGG	GTCACTATG.TGCCAATGG
GTCACTATG.TGGTGCCTG	GTCACTATG.TGGTGCCTG
GTCAGACCG.CACCTAGCG	GTCAGACCG.CACCTAGCG
GTCAGCGTC.AATTAGAGG	GTCAGCGTC.AATTAGAGG
GTCAGCGTC.TCATGCAGG	GTCAGCGTC.TCATGCAGG
GTCAGTTGT.ACGTTCAAT	GTCAGTTGT.ACGTTCAAT
GTCAGTTGT.AGTCGTCCG	GTCAGTTGT.AGTCGTCCG
GTCAGTTGT.GGTTCAGAC	GTCAGTTGT.GGTTCAGAC
GTCAGTTGT.GTCTGAGCC	GTCAGTTGT.GTCTGAGCC
GTCAGTTGT.TCGCCAAGC	GTCAGTTGT.TCGCCAAGC
GTCATTCTA.AAGCTGGTC	GTCATTCTA.AAGCTGGTC
GTCATTCTA.AGAGCCGCA	GTCATTCTA.AGAGCCGCA
GTCATTCTA.CAATGCATT	GTCATTCTA.CAATGCATT
GTCATTCTA.CATTCAGTT	GTCATTCTA.CATTCAGTT
GTCATTCTA.CCGATCAGC	GTCATTCTA.CCGATCAGC
GTCATTCTA.GTGTTGGAA	GTCATTCTA.GTGTTGGAA
GTCATTCTA.TGATCGGAA	GTCATTCTA.TGATCGGAA
GTCCACAAC.ACGATGACC	GTCCACAAC.ACGATGACC
GTCCACAAC.ATACAACCG	GTCCACAAC.ATACAACCG
GTCCACAAC.CGTGCCTAT	GTCCACAAC.CGTGCCTAT
GTCCACAAC.TAGGTCAAC	GTCCACAAC.TAGGTCAAC
GTCCACAAC.TTGATCGTA	GTCCACAAC.TTGATCGTA
GTCCGCTCA.ACCGTCCTA	GTCCGCTCA.ACCGTCCTA
GTCCGCTCA.ACTGGTCAG	GTCCGCTCA.ACTGGTCAG
GTCCGCTCA.AGTGATGCG	GTCCGCTCA.AGTGATGCG
GTCCGCTCA.AGTTGAGCG	GTCCGCTCA.AGTTGAGCG
GTCCGCTCA.ATAGTCAGT	GTCCGCTCA.ATAGTCAGT
GTCCGCTCA.CATACGCAG	GTCCGCTCA.CATACGCAG
GTCCGCTCA.GGTAAGTGA	GTCCGCTCA.GGTAAGTGA
GTCCGCTCA.GTGCTAAGC	GTCCGCTCA.GTGCTAAGC
GTCCGCTCA.TAGTTGACG	GTCCGCTCA.TAGTTGACG
GTCCGCTCA.TCAATCTAG	GTCCGCTCA.TCAATCTAG
GTCCGTAAG.AGCGGTCTA	GTCCGTAAG.AGCGGTCTA
GTCCGTAAG.ATTGGTTCC	GTCCGTAAG.ATTGGTTCC
GTCCGTAAG.GGAACTGCT	GTCCGTAAG.GGAACTGCT
GTCCGTAAG.TCATGCAGG	GTCCGTAAG.TCATGCAGG
GTCCTAGTT.ACCGAGACA	GTCCTAGTT.ACCGAGACA
GTCCTAGTT.CTAATACGC	GTCCTAGTT.CTAATACGC
GTCCTAGTT.GTCTCTTCA	GTCCTAGTT.GTCTCTTCA
GTCCTAGTT.TTCTGCCGA	GTCCTAGTT.TTCTGCCGA
GTCCTTCAT.AACCGCTGA	GTCCTTCAT.AACCGCTGA
GTCCTTCAT.AATGCAGCG	GTCCTTCAT.AATGCAGCG
GTCCTTCAT.AGTTGTGTA	GTCCTTCAT.AGTTGTGTA
GTCCTTCAT.ATGGAGGAA	GTCCTTCAT.ATGGAGGAA
GTCCTTCAT.ATTGATTGG	GTCCTTCAT.ATTGATTGG
GTCCTTCAT.CAATCATAC	GTCCTTCAT.CAATCATAC
GTCCTTCAT.GACGTTCAG	GTCCTTCAT.GACGTTCAG
GTCCTTCAT.GCTCTGTGT	GTCCTTCAT.GCTCTGTGT
GTCCTTCAT.TCAATCTAG	GTCCTTCAT.TCAATCTAG
GTCCTTCAT.TGAGCAGAT	GTCCTTCAT.TGAGCAGAT
GTCCTTCAT.TTGGTAACT	GTCCTTCAT.TTGGTAACT
GTCGACATT.ATCTCTGCT	GTCGACATT.ATCTCTGCT
GTCGACATT.CAAGCCTCG	GTCGACATT.CAAGCCTCG
GTCGACATT.CGTTAATGG	GTCGACATT.CGTTAATGG
GTCGAGTAC.AGCGTAGAA	GTCGAGTAC.AGCGTAGAA
GTCGAGTAC.CTCATGCCA	GTCGAGTAC.CTCATGCCA
GTCGAGTAC.GTCGAGTAC	GTCGAGTAC.GTCGAGTAC
GTCGAGTAC.GTGCGTTCC	GTCGAGTAC.GTGCGTTCC
GTCGAGTAC.TACAACACC	GTCGAGTAC.TACAACACC
GTCGCAGGT.ACAGAAGAG	GTCGCAGGT.ACAGAAGAG
GTCGCAGGT.ACGTGAATC	GTCGCAGGT.ACGTGAATC
GTCGCAGGT.CGACGTGAT	GTCGCAGGT.CGACGTGAT
GTCGCAGGT.TCATATCGC	GTCGCAGGT.TCATATCGC
GTCGCAGGT.TGCAGTTCA	GTCGCAGGT.TGCAGTTCA
GTCGCAGGT.TTACCTCTC	GTCGCAGGT.TTACCTCTC
GTCGTCGAC.ATAACGACA	GTCGTCGAC.ATAACGACA
GTCGTCGAC.CAACTCCAG	GTCGTCGAC.CAACTCCAG
GTCGTCGAC.GTAACCATA	GTCGTCGAC.GTAACCATA
GTCGTCGAC.TCACGCGAC	GTCGTCGAC.TCACGCGAC
GTCGTCGAC.TTCGTGATG	GTCGTCGAC.TTCGTGATG
GTCGTGTTA.AACAATGCA	GTCGTGTTA.AACAATGCA
GTCGTGTTA.ACGTATGTC	GTCGTGTTA.ACGTATGTC
GTCGTGTTA.CCAGATCAC	GTCGTGTTA.CCAGATCAC
GTCGTGTTA.CCTGTTAGC	GTCGTGTTA.CCTGTTAGC
GTCGTGTTA.TAAGCACTA	GTCGTGTTA.TAAGCACTA
GTCGTTAGA.AGGAAGGTG	GTCGTTAGA.AGGAAGGTG
GTCGTTAGA.CAATTGTCT	GTCGTTAGA.CAATTGTCT
GTCGTTAGA.CTGCTGCTT	GTCGTTAGA.CTGCTGCTT
GTCGTTAGA.GGTTAGATG	GTCGTTAGA.GGTTAGATG
GTCGTTAGA.TATCCTCAG	GTCGTTAGA.TATCCTCAG
GTCGTTGCG.ATTGCCGAC	GTCGTTGCG.ATTGCCGAC
GTCGTTGCG.CAGCGTAAG	GTCGTTGCG.CAGCGTAAG
GTCGTTGCG.CCGCACTCA	GTCGTTGCG.CCGCACTCA
GTCGTTGCG.GGATCAATG	GTCGTTGCG.GGATCAATG
GTCGTTGCG.TGCCAGACG	GTCGTTGCG.TGCCAGACG
GTCGTTGCG.TTACTAGTC	GTCGTTGCG.TTACTAGTC
GTCTACCAA.ATTGATTGG	GTCTACCAA.ATTGATTGG
GTCTACCAA.GCACAACTC	GTCTACCAA.GCACAACTC
GTCTACCAA.TCACATACT	GTCTACCAA.TCACATACT
GTCTACCAA.TGAAGACCA	GTCTACCAA.TGAAGACCA
GTCTACCAA.TGATTATCG	GTCTACCAA.TGATTATCG
GTCTCCAGG.AATCCTCGT	GTCTCCAGG.AATCCTCGT
GTCTCCAGG.ACAGGAACT	GTCTCCAGG.ACAGGAACT
GTCTCCAGG.CATCGAAGC	GTCTCCAGG.CATCGAAGC
GTCTCCAGG.CTTGGATCA	GTCTCCAGG.CTTGGATCA
GTCTCCAGG.GACGTTCAG	GTCTCCAGG.GACGTTCAG
GTCTCTTCA.GTCAGTTGT	GTCTCTTCA.GTCAGTTGT
GTCTCTTCA.TAATGTAGC	GTCTCTTCA.TAATGTAGC
GTCTCTTCA.TCCATCATT	GTCTCTTCA.TCCATCATT
GTCTCTTCA.TCTGCAACA	GTCTCTTCA.TCTGCAACA
GTCTGACGT.AGTAAGCCA	GTCTGACGT.AGTAAGCCA
GTCTGACGT.CGCGAGTGT	GTCTGACGT.CGCGAGTGT
GTCTGACGT.TAGAGCGTC	GTCTGACGT.TAGAGCGTC
GTCTGAGCC.CATGACGTT	GTCTGAGCC.CATGACGTT
GTCTGAGCC.CTGCGATTC	GTCTGAGCC.CTGCGATTC
GTCTGAGCC.CTGGACTAA	GTCTGAGCC.CTGGACTAA
GTCTGAGCC.CTGTACGAC	GTCTGAGCC.CTGTACGAC
GTCTGAGCC.TGGAGAACC	GTCTGAGCC.TGGAGAACC
GTCTGAGCC.TGGATTAGC	GTCTGAGCC.TGGATTAGC
GTCTGAGCC.TGTATCGTG	GTCTGAGCC.TGTATCGTG
GTCTTATGC.GGATAGTCA	GTCTTATGC.GGATAGTCA
GTCTTCATA.ATCTACATC	GTCTTCATA.ATCTACATC
GTCTTCATA.CTGAGTAGC	GTCTTCATA.CTGAGTAGC
GTCTTCATA.GTACCTAAC	GTCTTCATA.GTACCTAAC
GTCTTCATA.TCCACCTCA	GTCTTCATA.TCCACCTCA
GTCTTCATA.TGAGAGGAC	GTCTTCATA.TGAGAGGAC
GTCTTCTCG.AACAGCAGT	GTCTTCTCG.AACAGCAGT
GTCTTCTCG.AAGCAACTA	GTCTTCTCG.AAGCAACTA
GTCTTCTCG.ACTTGATCT	GTCTTCTCG.ACTTGATCT
GTCTTCTCG.ATATGCAGC	GTCTTCTCG.ATATGCAGC
GTCTTCTCG.CACAATAAC	GTCTTCTCG.CACAATAAC
GTCTTCTCG.TAAGCACTA	GTCTTCTCG.TAAGCACTA
GTGAACCAC.AGTCGCCGA	GTGAACCAC.AGTCGCCGA
GTGAACCAC.CAGGATCAA	GTGAACCAC.CAGGATCAA
GTGAACCAC.CGGACAAGT	GTGAACCAC.CGGACAAGT
GTGAACCAC.GACAGGTTA	GTGAACCAC.GACAGGTTA
GTGAACCAC.GCAGGAGAA	GTGAACCAC.GCAGGAGAA
GTGAACCAC.GTGTCACAC	GTGAACCAC.GTGTCACAC
GTGAATGCC.CATGGTCGA	GTGAATGCC.CATGGTCGA
GTGAATGCC.CTCAGTGAT	GTGAATGCC.CTCAGTGAT
GTGAATGCC.GTCGCAGGT	GTGAATGCC.GTCGCAGGT
GTGACGTAA.ACTCGTCTA	GTGACGTAA.ACTCGTCTA
GTGACGTAA.ATACAACCG	GTGACGTAA.ATACAACCG
GTGACGTAA.CAGCTTACC	GTGACGTAA.CAGCTTACC
GTGACGTAA.GATACACTA	GTGACGTAA.GATACACTA
GTGACGTAA.GCCTGCATC	GTGACGTAA.GCCTGCATC
GTGACGTAA.TACTCGACC	GTGACGTAA.TACTCGACC
GTGACGTAA.TGCGATACT	GTGACGTAA.TGCGATACT
GTGACGTAA.TTCCTCGGT	GTGACGTAA.TTCCTCGGT
GTGACTCTC.ACAAGTACA	GTGACTCTC.ACAAGTACA
GTGACTCTC.GCTCTCCAA	GTGACTCTC.GCTCTCCAA
GTGACTCTC.GTACAATGC	GTGACTCTC.GTACAATGC
GTGAGGACG.ACTCGAGTC	GTGAGGACG.ACTCGAGTC
GTGAGGACG.GAGTATCGC	GTGAGGACG.GAGTATCGC
GTGATGTGC.TTGCAGTCA	GTGATGTGC.TTGCAGTCA
GTGCACGAG.AGTTAGGTC	GTGCACGAG.AGTTAGGTC
GTGCACGAG.ATCTAGGTT	GTGCACGAG.ATCTAGGTT
GTGCATCAA.ATTCGCTTA	GTGCATCAA.ATTCGCTTA
GTGCATCAA.CAACCGGTC	GTGCATCAA.CAACCGGTC
GTGCATCAA.CGCTTCACG	GTGCATCAA.CGCTTCACG
GTGCATCAA.TCGGAACGA	GTGCATCAA.TCGGAACGA
GTGCCATGA.AGATACGTT	GTGCCATGA.AGATACGTT
GTGCCATGA.AGTTCGATA	GTGCCATGA.AGTTCGATA
GTGCCATGA.CGGATTCTC	GTGCCATGA.CGGATTCTC
GTGCCATGA.GCGGACGAA	GTGCCATGA.GCGGACGAA
GTGCGAGTA.CTAGTATAG	GTGCGAGTA.CTAGTATAG
GTGCGAGTA.GCTATGTAA	GTGCGAGTA.GCTATGTAA
GTGCGTTCC.AATCTCCTA	GTGCGTTCC.AATCTCCTA
GTGCGTTCC.ATTCATGTG	GTGCGTTCC.ATTCATGTG
GTGCGTTCC.CCAGTCTCA	GTGCGTTCC.CCAGTCTCA
GTGCGTTCC.CCGATACCG	GTGCGTTCC.CCGATACCG
GTGCTAAGC.AACAATGCA	GTGCTAAGC.AACAATGCA
GTGCTAAGC.CTTAACAGC	GTGCTAAGC.CTTAACAGC
GTGCTAAGC.TAGATCTGT	GTGCTAAGC.TAGATCTGT
GTGCTCGGA.AGATACGTT	GTGCTCGGA.AGATACGTT
GTGCTCGGA.CACCTACGC	GTGCTCGGA.CACCTACGC
GTGCTCGGA.CACTGGTCC	GTGCTCGGA.CACTGGTCC
GTGCTCGGA.GGTAATCTA	GTGCTCGGA.GGTAATCTA
GTGCTCGGA.TGCGCACTG	GTGCTCGGA.TGCGCACTG
GTGCTCTTG.ACTCGTAGG	GTGCTCTTG.ACTCGTAGG
GTGCTCTTG.ATATAGCGT	GTGCTCTTG.ATATAGCGT
GTGCTCTTG.CAGCTCTTC	GTGCTCTTG.CAGCTCTTC
GTGCTCTTG.CTGAGTAGC	GTGCTCTTG.CTGAGTAGC
GTGCTCTTG.GCCTTATCT	GTGCTCTTG.GCCTTATCT
GTGCTCTTG.GCGCATTAC	GTGCTCTTG.GCGCATTAC
GTGCTCTTG.TCTATTAGG	GTGCTCTTG.TCTATTAGG
GTGCTGACT.CACACCACA	GTGCTGACT.CACACCACA
GTGCTGACT.CCGATCAGC	GTGCTGACT.CCGATCAGC
GTGCTGACT.TATTGCTAC	GTGCTGACT.TATTGCTAC
GTGCTGACT.TCCATCATT	GTGCTGACT.TCCATCATT
GTGCTGACT.TCCTGAGAC	GTGCTGACT.TCCTGAGAC
GTGGACTGG.CGTAATGAC	GTGGACTGG.CGTAATGAC
GTGGACTGG.CTCTGCGGT	GTGGACTGG.CTCTGCGGT
GTGGACTGG.TCCACCGGT	GTGGACTGG.TCCACCGGT
GTGGAGGTC.AAGCATTGC	GTGGAGGTC.AAGCATTGC
GTGGAGGTC.ACAGCGTAT	GTGGAGGTC.ACAGCGTAT
GTGGAGGTC.AGACGCCTG	GTGGAGGTC.AGACGCCTG
GTGGAGGTC.TCATGCTCA	GTGGAGGTC.TCATGCTCA
GTGGATAAG.ACTCCAACT	GTGGATAAG.ACTCCAACT
GTGGATAAG.GTTAGTCAA	GTGGATAAG.GTTAGTCAA
GTGGTACGG.AAGCATTGC	GTGGTACGG.AAGCATTGC
GTGGTACGG.GTCAGCGTC	GTGGTACGG.GTCAGCGTC
GTGGTTACC.CGCTTCACG	GTGGTTACC.CGCTTCACG
GTGGTTACC.GACTGCCTG	GTGGTTACC.GACTGCCTG
GTGGTTACC.GCCAACAAT	GTGGTTACC.GCCAACAAT
GTGGTTACC.GTACGAACG	GTGGTTACC.GTACGAACG
GTGTACCGT.AGGATCTCA	GTGTACCGT.AGGATCTCA
GTGTACCGT.CCAACAACA	GTGTACCGT.CCAACAACA
GTGTACCGT.GCTCAGCCA	GTGTACCGT.GCTCAGCCA
GTGTACCGT.TCACAGGTA	GTGTACCGT.TCACAGGTA
GTGTATCTG.AATGCGTGC	GTGTATCTG.AATGCGTGC
GTGTATCTG.ACAATAGGT	GTGTATCTG.ACAATAGGT
GTGTATCTG.ACCGTACGC	GTGTATCTG.ACCGTACGC
GTGTATCTG.ATTCCGTAC	GTGTATCTG.ATTCCGTAC
GTGTATCTG.CTGTAGAAG	GTGTATCTG.CTGTAGAAG
GTGTATCTG.GCGCTACCT	GTGTATCTG.GCGCTACCT
GTGTATCTG.TCTTAAGTG	GTGTATCTG.TCTTAAGTG
GTGTATCTG.TGGTGGATC	GTGTATCTG.TGGTGGATC
GTGTCACAC.CAGAGCACC	GTGTCACAC.CAGAGCACC
GTGTCACAC.CTGCAAGCC	GTGTCACAC.CTGCAAGCC
GTGTCCGTG.AGTAATCAG	GTGTCCGTG.AGTAATCAG
GTGTCCGTG.ATCGTAGTG	GTGTCCGTG.ATCGTAGTG
GTGTCCGTG.CACCTAGCG	GTGTCCGTG.CACCTAGCG
GTGTCCGTG.CACTCACTA	GTGTCCGTG.CACTCACTA
GTGTCCGTG.CTTCTCATC	GTGTCCGTG.CTTCTCATC
GTGTCGAGC.AGCTACTCA	GTGTCGAGC.AGCTACTCA
GTGTCGAGC.CATACAACC	GTGTCGAGC.CATACAACC
GTGTCGAGC.TCCGATAAC	GTGTCGAGC.TCCGATAAC
GTGTCGAGC.TGAGATCAT	GTGTCGAGC.TGAGATCAT
GTGTCGAGC.TGTAGATCG	GTGTCGAGC.TGTAGATCG
GTGTCTGGA.CAACTAATC	GTGTCTGGA.CAACTAATC
GTGTCTGGA.CATCCGACA	GTGTCTGGA.CATCCGACA
GTGTCTGGA.GGACTCCTT	GTGTCTGGA.GGACTCCTT
GTGTCTGGA.GTCAGCGTC	GTGTCTGGA.GTCAGCGTC
GTGTCTGGA.TAGCACTAT	GTGTCTGGA.TAGCACTAT
GTGTCTGGA.TGATACCGT	GTGTCTGGA.TGATACCGT
GTGTCTGGA.TTCACCTTG	GTGTCTGGA.TTCACCTTG
GTGTTCCAG.ATGCGGATT	GTGTTCCAG.ATGCGGATT
GTGTTCCAG.CAGTACATC	GTGTTCCAG.CAGTACATC
GTGTTCCAG.CATCAATAG	GTGTTCCAG.CATCAATAG
GTGTTCCAG.GACTATTGA	GTGTTCCAG.GACTATTGA
GTGTTCCAG.TGTCACATA	GTGTTCCAG.TGTCACATA
GTGTTCCAG.TGTGAGTAT	GTGTTCCAG.TGTGAGTAT
GTGTTGGAA.ACAATTCGG	GTGTTGGAA.ACAATTCGG
GTGTTGGAA.CCAACAACA	GTGTTGGAA.CCAACAACA
GTGTTGGAA.CCTCAGGTG	GTGTTGGAA.CCTCAGGTG
GTGTTGGAA.CTCAGCTGG	GTGTTGGAA.CTCAGCTGG
GTGTTGGAA.GAGTCGTAC	GTGTTGGAA.GAGTCGTAC
GTGTTGGAA.TGCCTTCAG	GTGTTGGAA.TGCCTTCAG
GTTAATTCG.AACTCCATG	GTTAATTCG.AACTCCATG
GTTAATTCG.ATTGGTTCC	GTTAATTCG.ATTGGTTCC
GTTAATTCG.CGTTCGTAC	GTTAATTCG.CGTTCGTAC
GTTAATTCG.CTTACATGC	GTTAATTCG.CTTACATGC
GTTAATTCG.GTCTCCAGG	GTTAATTCG.GTCTCCAGG
GTTACTACT.ACAGGAACT	GTTACTACT.ACAGGAACT
GTTACTACT.ACCGAGACA	GTTACTACT.ACCGAGACA
GTTACTACT.CTGCTTAGG	GTTACTACT.CTGCTTAGG
GTTACTACT.TATACCACT	GTTACTACT.TATACCACT
GTTACTACT.TTACAGTGT	GTTACTACT.TTACAGTGT
GTTAGAGAC.AACAGATCG	GTTAGAGAC.AACAGATCG
GTTAGAGAC.ACACACGTC	GTTAGAGAC.ACACACGTC
GTTAGAGAC.ACTCACGAA	GTTAGAGAC.ACTCACGAA
GTTAGAGAC.CAAGCGCAT	GTTAGAGAC.CAAGCGCAT
GTTAGAGAC.CTATACTAG	GTTAGAGAC.CTATACTAG
GTTAGAGAC.GGAGCATCT	GTTAGAGAC.GGAGCATCT
GTTAGAGAC.GGTCCTAAG	GTTAGAGAC.GGTCCTAAG
GTTAGATTG.GACGCTTGC	GTTAGATTG.GACGCTTGC
GTTAGATTG.GTCAGACCG	GTTAGATTG.GTCAGACCG
GTTAGATTG.TTCGTGATG	GTTAGATTG.TTCGTGATG
GTTAGTCAA.ATTCGCTTA	GTTAGTCAA.ATTCGCTTA
GTTATCGAT.ACAGGTATC	GTTATCGAT.ACAGGTATC
GTTATCGAT.CTACGTTGG	GTTATCGAT.CTACGTTGG
GTTATCGAT.CTAGACATG	GTTATCGAT.CTAGACATG
GTTATCGAT.GAGCCATCC	GTTATCGAT.GAGCCATCC
GTTATCGAT.TAGCACTAT	GTTATCGAT.TAGCACTAT
GTTCACTCC.AACTTGTCG	GTTCACTCC.AACTTGTCG
GTTCACTCC.ACTACCATC	GTTCACTCC.ACTACCATC
GTTCACTCC.AGAAGTAAC	GTTCACTCC.AGAAGTAAC
GTTCACTCC.GCCTAACGG	GTTCACTCC.GCCTAACGG
GTTCACTCC.GCGTGATAC	GTTCACTCC.GCGTGATAC
GTTCACTCC.GGACTCCTT	GTTCACTCC.GGACTCCTT
GTTCAGAAG.CCGCTATCC	GTTCAGAAG.CCGCTATCC
GTTCCAACA.TATCGAGCC	GTTCCAACA.TATCGAGCC
GTTCCAACA.TGGTGGATC	GTTCCAACA.TGGTGGATC
GTTGACCAT.AACCATGGT	GTTGACCAT.AACCATGGT
GTTGACCAT.CAATGTGCT	GTTGACCAT.CAATGTGCT
GTTGACCAT.CTCTGCAAG	GTTGACCAT.CTCTGCAAG
GTTGACCAT.GTACGAACG	GTTGACCAT.GTACGAACG
GTTGACGTG.ACAACGAGC	GTTGACGTG.ACAACGAGC
GTTGACGTG.AGGATGCGT	GTTGACGTG.AGGATGCGT
GTTGACGTG.CGACGTACG	GTTGACGTG.CGACGTACG
GTTGACGTG.GCACCATCG	GTTGACGTG.GCACCATCG
GTTGACGTG.TACCAGCCA	GTTGACGTG.TACCAGCCA
GTTGATGCA.CGGAAGACG	GTTGATGCA.CGGAAGACG
GTTGATGCA.TACAGTTAG	GTTGATGCA.TACAGTTAG
GTTGCATGG.ACCGACGGT	GTTGCATGG.ACCGACGGT
GTTGCATGG.ATACAACCG	GTTGCATGG.ATACAACCG
GTTGCATGG.CCGCACTCA	GTTGCATGG.CCGCACTCA
GTTGCATGG.CCGCAGCTA	GTTGCATGG.CCGCAGCTA
GTTGCATGG.TATCGAGCC	GTTGCATGG.TATCGAGCC
GTTGCATGG.TCGTCCGAT	GTTGCATGG.TCGTCCGAT
GTTGCATGG.TGGACTGCC	GTTGCATGG.TGGACTGCC
GTTGCTCAG.TACGACCAT	GTTGCTCAG.TACGACCAT
GTTGCTCAG.TGGTTATAC	GTTGCTCAG.TGGTTATAC
TAACACATC.ATAGACCGA	TAACACATC.ATAGACCGA
TAACACATC.ATGGAGAGT	TAACACATC.ATGGAGAGT
TAACACATC.CACGATAGA	TAACACATC.CACGATAGA
TAACACATC.GTTCACTCC	TAACACATC.GTTCACTCC
TAACACATC.TAAGTGTAG	TAACACATC.TAAGTGTAG
TAACACATC.TCTAGGATG	TAACACATC.TCTAGGATG
TAACACATC.TGATCTCGG	TAACACATC.TGATCTCGG
TAACACGAG.ACGTCTATG	TAACACGAG.ACGTCTATG
TAACACGAG.CTAGTCGTC	TAACACGAG.CTAGTCGTC
TAACACGAG.GCCGTCTTC	TAACACGAG.GCCGTCTTC
TAACATTGG.CACTCACTA	TAACATTGG.CACTCACTA
TAACCGTGA.GATAGTTCT	TAACCGTGA.GATAGTTCT
TAACGGATA.CTGAGTAGC	TAACGGATA.CTGAGTAGC
TAACGTGTC.TGGTGGATC	TAACGTGTC.TGGTGGATC
TAACTCCGA.ACGCGACAG	TAACTCCGA.ACGCGACAG
TAACTCCGA.AGGATTGAG	TAACTCCGA.AGGATTGAG
TAACTCCGA.CATGTGAAC	TAACTCCGA.CATGTGAAC
TAACTCCGA.GATGCAGAA	TAACTCCGA.GATGCAGAA
TAACTCCGA.GGTAGTGTT	TAACTCCGA.GGTAGTGTT
TAACTCCGA.GTCCGTAAG	TAACTCCGA.GTCCGTAAG
TAAGCACTA.CAGGTTGTC	TAAGCACTA.CAGGTTGTC
TAAGCACTA.TAGTCGCAT	TAAGCACTA.TAGTCGCAT
TAAGCACTA.TATCAGTGC	TAAGCACTA.TATCAGTGC
TAAGCCATT.CTACGAGAA	TAAGCCATT.CTACGAGAA
TAAGCCATT.GCCGTGAAC	TAAGCCATT.GCCGTGAAC
TAAGGTCCG.ACAGCATCA	TAAGGTCCG.ACAGCATCA
TAAGGTCCG.ACGACAGTC	TAAGGTCCG.ACGACAGTC
TAAGGTCCG.ATGGAGGAA	TAAGGTCCG.ATGGAGGAA
TAAGGTCCG.ATTAGCACA	TAAGGTCCG.ATTAGCACA
TAAGGTCCG.CATGTGAAC	TAAGGTCCG.CATGTGAAC
TAAGGTCCG.CCACTTCGC	TAAGGTCCG.CCACTTCGC
TAAGGTCCG.GTCCACAAC	TAAGGTCCG.GTCCACAAC
TAAGGTCCG.TCAGAGTCA	TAAGGTCCG.TCAGAGTCA
TAAGGTCCG.TTCATCCAA	TAAGGTCCG.TTCATCCAA
TAAGGTGAT.CCAAGCGAG	TAAGGTGAT.CCAAGCGAG
TAAGGTGAT.CCACCATGC	TAAGGTGAT.CCACCATGC
TAAGGTGAT.GTCTGACGT	TAAGGTGAT.GTCTGACGT
TAAGGTGAT.TGTAGATCG	TAAGGTGAT.TGTAGATCG
TAAGTACAC.CTCGTTCAC	TAAGTACAC.CTCGTTCAC
TAAGTACAC.GACTGCCTG	TAAGTACAC.GACTGCCTG
TAAGTACAC.GAGCCATCC	TAAGTACAC.GAGCCATCC
TAAGTACAC.GATCTAGAG	TAAGTACAC.GATCTAGAG
TAAGTGTAG.CATTCGAAT	TAAGTGTAG.CATTCGAAT
TAAGTGTAG.CGACGTACG	TAAGTGTAG.CGACGTACG
TAATCACGC.AACTTCTGC	TAATCACGC.AACTTCTGC
TAATCACGC.AGTAATCAG	TAATCACGC.AGTAATCAG
TAATCACGC.CCACATTAG	TAATCACGC.CCACATTAG
TAATCACGC.TAGATAGCC	TAATCACGC.TAGATAGCC
TAATCACGC.TCAGAGTCA	TAATCACGC.TCAGAGTCA
TAATCTGGA.CACTGTATC	TAATCTGGA.CACTGTATC
TAATCTGGA.GATCTTCGC	TAATCTGGA.GATCTTCGC
TAATCTGGA.GGACTCCTT	TAATCTGGA.GGACTCCTT
TAATCTGGA.TTGTTAGAG	TAATCTGGA.TTGTTAGAG
TAATGTAGC.AACGTCGAG	TAATGTAGC.AACGTCGAG
TAATGTAGC.ACCATACTT	TAATGTAGC.ACCATACTT
TAATGTAGC.ACTCTGCTC	TAATGTAGC.ACTCTGCTC
TAATGTAGC.CCTAGTCTC	TAATGTAGC.CCTAGTCTC
TAATGTAGC.GTTGATGCA	TAATGTAGC.GTTGATGCA
TAATGTAGC.TAGACCATG	TAATGTAGC.TAGACCATG
TAATTCGTG.CAGCTCTTC	TAATTCGTG.CAGCTCTTC
TAATTCGTG.CGAGTAGCA	TAATTCGTG.CGAGTAGCA
TAATTCGTG.TGTCTACAC	TAATTCGTG.TGTCTACAC
TAATTCGTG.TGTTACTGA	TAATTCGTG.TGTTACTGA
TACAACACC.ACTCGTAGG	TACAACACC.ACTCGTAGG
TACAACACC.AGTCGCCGA	TACAACACC.AGTCGCCGA
TACAACACC.AGTTGCCTT	TACAACACC.AGTTGCCTT
TACAACACC.ATGACACAA	TACAACACC.ATGACACAA
TACAACACC.CAAGAGGAG	TACAACACC.CAAGAGGAG
TACAACACC.CACATGTGC	TACAACACC.CACATGTGC
TACAACACC.CACTGCTTA	TACAACACC.CACTGCTTA
TACAACACC.CCGACTTGG	TACAACACC.CCGACTTGG
TACAACACC.CGAAGAGGT	TACAACACC.CGAAGAGGT
TACAACACC.TCTGCGCTG	TACAACACC.TCTGCGCTG
TACAACACC.TGTAACAGT	TACAACACC.TGTAACAGT
TACAAGAGG.GTGTCCGTG	TACAAGAGG.GTGTCCGTG
TACAAGAGG.TATCAGTGC	TACAAGAGG.TATCAGTGC
TACAAGAGG.TGAGATCAT	TACAAGAGG.TGAGATCAT
TACACGGTC.AGTAATCAG	TACACGGTC.AGTAATCAG
TACACGGTC.GCGAAGACA	TACACGGTC.GCGAAGACA
TACACGGTC.TATAGTGCG	TACACGGTC.TATAGTGCG
TACAGGACT.AGTAATCAG	TACAGGACT.AGTAATCAG
TACAGGACT.AGTCGCGAC	TACAGGACT.AGTCGCGAC
TACAGGACT.ATCAAGAGA	TACAGGACT.ATCAAGAGA
TACAGGACT.CGCCTGCAA	TACAGGACT.CGCCTGCAA
TACAGGACT.GAGCACATT	TACAGGACT.GAGCACATT
TACAGGACT.GGTGTGACC	TACAGGACT.GGTGTGACC
TACAGTTAG.CTCGTGTCC	TACAGTTAG.CTCGTGTCC
TACAGTTAG.TCTACGCAA	TACAGTTAG.TCTACGCAA
TACATGCAC.AGGAGGTGA	TACATGCAC.AGGAGGTGA
TACCAGCCA.AGTTGCCTT	TACCAGCCA.AGTTGCCTT
TACCAGCCA.GTAACGCGA	TACCAGCCA.GTAACGCGA
TACCATGTA.CAACCGGTC	TACCATGTA.CAACCGGTC
TACCATGTA.GATCCGCAC	TACCATGTA.GATCCGCAC
TACCATGTA.TGTAACAGT	TACCATGTA.TGTAACAGT
TACCGATTG.ACAATAGGT	TACCGATTG.ACAATAGGT
TACCGATTG.GACATAACG	TACCGATTG.GACATAACG
TACCGATTG.GAGAACAGG	TACCGATTG.GAGAACAGG
TACCGATTG.GCTTGTCCT	TACCGATTG.GCTTGTCCT
TACCGATTG.TCCACCGGT	TACCGATTG.TCCACCGGT
TACCGATTG.TGTATGTAG	TACCGATTG.TGTATGTAG
TACCGATTG.TTCCGAGCG	TACCGATTG.TTCCGAGCG
TACCGCGTT.AACTGATTC	TACCGCGTT.AACTGATTC
TACCGCGTT.CTCTTCAGC	TACCGCGTT.CTCTTCAGC
TACCGCGTT.TCGTCCGAT	TACCGCGTT.TCGTCCGAT
TACCGCGTT.TGGAGTGGA	TACCGCGTT.TGGAGTGGA
TACCTATCC.AACCGCTGA	TACCTATCC.AACCGCTGA
TACCTATCC.ACTCTAGGA	TACCTATCC.ACTCTAGGA
TACCTATCC.AGCTCTCCG	TACCTATCC.AGCTCTCCG
TACCTATCC.AGTCGATCA	TACCTATCC.AGTCGATCA
TACCTCCTC.TGCATACAT	TACCTCCTC.TGCATACAT
TACGAACTC.TCAATCTAG	TACGAACTC.TCAATCTAG
TACGACCAT.AAGGTCTGA	TACGACCAT.AAGGTCTGA
TACGACCAT.ACACACGTC	TACGACCAT.ACACACGTC
TACGACCAT.ATCTAGGTT	TACGACCAT.ATCTAGGTT
TACGACCAT.TGAGCAGAT	TACGACCAT.TGAGCAGAT
TACGACTTG.ACCAGCGTT	TACGACTTG.ACCAGCGTT
TACGACTTG.AGTCTGGAA	TACGACTTG.AGTCTGGAA
TACGACTTG.CAACACCTA	TACGACTTG.CAACACCTA
TACGACTTG.CCTAGAGTA	TACGACTTG.CCTAGAGTA
TACGACTTG.TGCTATGAA	TACGACTTG.TGCTATGAA
TACGACTTG.TTCAGTGCC	TACGACTTG.TTCAGTGCC
TACGAGTGA.ATTCGCTTA	TACGAGTGA.ATTCGCTTA
TACGAGTGA.CCACATTAG	TACGAGTGA.CCACATTAG
