CCTGTATCT.CAAGTCACT	CCTGTATCT.CAAGTCACT
CCTGTATCT.TGAGTTAAG	CCTGTATCT.TGAGTTAAG
CCTGTCATT.AGGATGCGT	CCTGTCATT.AGGATGCGT
CCTGTCATT.CTCCTGACG	CCTGTCATT.CTCCTGACG
CCTGTCATT.GCTTCTGAA	CCTGTCATT.GCTTCTGAA
CCTGTCGAC.GCCGAACCA	CCTGTCGAC.GCCGAACCA
CCTGTCGAC.GGTAGACAT	CCTGTCGAC.GGTAGACAT
CCTGTCGAC.GGTGATAGG	CCTGTCGAC.GGTGATAGG
CCTGTCGAC.TAGACACGT	CCTGTCGAC.TAGACACGT
CCTGTCGAC.TGTAGCAAG	CCTGTCGAC.TGTAGCAAG
CCTGTTAGC.AATAACTCC	CCTGTTAGC.AATAACTCC
CCTGTTAGC.ATAGCTTGC	CCTGTTAGC.ATAGCTTGC
CCTGTTAGC.GATGTAAGG	CCTGTTAGC.GATGTAAGG
CCTGTTAGC.GGATAATAC	CCTGTTAGC.GGATAATAC
CCTGTTAGC.TGTGGTCCT	CCTGTTAGC.TGTGGTCCT
CCTTAACAT.CCTCATAAC	CCTTAACAT.CCTCATAAC
CCTTAACAT.GTAGGACGC	CCTTAACAT.GTAGGACGC
CCTTAACAT.TGTGCTAAC	CCTTAACAT.TGTGCTAAC
CCTTAATTC.CTCTGTCAA	CCTTAATTC.CTCTGTCAA
CCTTAATTC.GCCGTCTTC	CCTTAATTC.GCCGTCTTC
CCTTAATTC.GTCAAGATC	CCTTAATTC.GTCAAGATC
CCTTATCCG.GGATACAAT	CCTTATCCG.GGATACAAT
CCTTCCTCA.ACTTCAGTA	CCTTCCTCA.ACTTCAGTA
CCTTCCTCA.CGTTAATGG	CCTTCCTCA.CGTTAATGG
CCTTCCTCA.CTCTGCGGT	CCTTCCTCA.CTCTGCGGT
CCTTCCTCA.GGTTCGCAA	CCTTCCTCA.GGTTCGCAA
CCTTCGAGC.ACTCTAGGA	CCTTCGAGC.ACTCTAGGA
CCTTCGAGC.AGGAGCAAT	CCTTCGAGC.AGGAGCAAT
CCTTCGAGC.CAAGAGGAG	CCTTCGAGC.CAAGAGGAG
CCTTCGAGC.CATGTCCTG	CCTTCGAGC.CATGTCCTG
CCTTCGAGC.CTAACTAAG	CCTTCGAGC.CTAACTAAG
CCTTCGAGC.CTAGAGTCG	CCTTCGAGC.CTAGAGTCG
CCTTCGAGC.GTAACTCAT	CCTTCGAGC.GTAACTCAT
CCTTCGAGC.TCGACGTTG	CCTTCGAGC.TCGACGTTG
CCTTCGAGC.TCTAGTGAC	CCTTCGAGC.TCTAGTGAC
CCTTCGAGC.TTGCCGTAG	CCTTCGAGC.TTGCCGTAG
CCTTGACGG.AACCATGGT	CCTTGACGG.AACCATGGT
CCTTGACGG.AGTACTACA	CCTTGACGG.AGTACTACA
CCTTGACGG.AGTCGTCCG	CCTTGACGG.AGTCGTCCG
CCTTGACGG.CCTTATCCG	CCTTGACGG.CCTTATCCG
CCTTGACGG.TACAACACC	CCTTGACGG.TACAACACC
CCTTGCTTG.CGTCTGCTG	CCTTGCTTG.CGTCTGCTG
CCTTGCTTG.GCGTAACAA	CCTTGCTTG.GCGTAACAA
CCTTGCTTG.GTTGACGTG	CCTTGCTTG.GTTGACGTG
CCTTGCTTG.TATTGCTAC	CCTTGCTTG.TATTGCTAC
CCTTGTTGC.CCTCTCTAG	CCTTGTTGC.CCTCTCTAG
CCTTGTTGC.GCAATGAGA	CCTTGTTGC.GCAATGAGA
CCTTGTTGC.TAGCTAAGA	CCTTGTTGC.TAGCTAAGA
CCTTGTTGC.TTATCGCAC	CCTTGTTGC.TTATCGCAC
CGAACAATC.GACAGGTTA	CGAACAATC.GACAGGTTA
CGAACAATC.TACGGTCGT	CGAACAATC.TACGGTCGT
CGAACAGAG.CACTACAGG	CGAACAGAG.CACTACAGG
CGAACAGAG.CAGCTTCGA	CGAACAGAG.CAGCTTCGA
CGAACAGAG.CGTAATGAC	CGAACAGAG.CGTAATGAC
CGAACAGAG.GAGACTCGA	CGAACAGAG.GAGACTCGA
CGAACAGAG.GCTCAGCCA	CGAACAGAG.GCTCAGCCA
CGAACAGAG.TGAGCAGAT	CGAACAGAG.TGAGCAGAT
CGAAGAGGT.AAGTACAGA	CGAAGAGGT.AAGTACAGA
CGAAGAGGT.ACCATGTCT	CGAAGAGGT.ACCATGTCT
CGAAGAGGT.ACCTCCTAG	CGAAGAGGT.ACCTCCTAG
CGAAGAGGT.TTCACTGGA	CGAAGAGGT.TTCACTGGA
CGAATCCTG.CCAAGTCGA	CGAATCCTG.CCAAGTCGA
CGAATGAGT.AGTAATGGT	CGAATGAGT.AGTAATGGT
CGAATGAGT.ATCTTACAG	CGAATGAGT.ATCTTACAG
CGAATGAGT.CGTGTCCGA	CGAATGAGT.CGTGTCCGA
CGAATGAGT.CTCATTAGT	CGAATGAGT.CTCATTAGT
CGAATGAGT.GATGCAGAA	CGAATGAGT.GATGCAGAA
CGAATGAGT.GCCATCGCT	CGAATGAGT.GCCATCGCT
CGAATGAGT.GGTAACTAC	CGAATGAGT.GGTAACTAC
CGACAGACC.ACTCTAGGA	CGACAGACC.ACTCTAGGA
CGACAGACC.AGATACGTT	CGACAGACC.AGATACGTT
CGACAGACC.AGCACCAGC	CGACAGACC.AGCACCAGC
CGACAGACC.ATGAACTAG	CGACAGACC.ATGAACTAG
CGACAGACC.CCAGTACTC	CGACAGACC.CCAGTACTC
CGACAGACC.CCTGACCTC	CGACAGACC.CCTGACCTC
CGACAGACC.CGCGATGTA	CGACAGACC.CGCGATGTA
CGACAGGAA.ACGACGATT	CGACAGGAA.ACGACGATT
CGACAGGAA.CACAGCGAA	CGACAGGAA.CACAGCGAA
CGACAGGAA.CTTCTCATC	CGACAGGAA.CTTCTCATC
CGACAGGAA.TCAAGGAGT	CGACAGGAA.TCAAGGAGT
CGACCACTT.CTGCGATTC	CGACCACTT.CTGCGATTC
CGACCACTT.TGATTATCG	CGACCACTT.TGATTATCG
CGACCATCA.CTATTCCGT	CGACCATCA.CTATTCCGT
CGACCATCA.CTTAATCGT	CGACCATCA.CTTAATCGT
CGACCATCA.GTGGACTGG	CGACCATCA.GTGGACTGG
CGACCTAGC.AATTGGATC	CGACCTAGC.AATTGGATC
CGACCTAGC.ACAGAGATG	CGACCTAGC.ACAGAGATG
CGACCTAGC.AGCACACCT	CGACCTAGC.AGCACACCT
CGACCTAGC.CTCATGCCA	CGACCTAGC.CTCATGCCA
CGACCTAGC.TTCGTGATG	CGACCTAGC.TTCGTGATG
CGACCTGTA.AAGTAGGAC	CGACCTGTA.AAGTAGGAC
CGACCTGTA.ACAGGAACT	CGACCTGTA.ACAGGAACT
CGACCTGTA.ATCCATTAG	CGACCTGTA.ATCCATTAG
CGACCTGTA.CAGCTCTTC	CGACCTGTA.CAGCTCTTC
CGACCTGTA.CCTAGAGTA	CGACCTGTA.CCTAGAGTA
CGACCTGTA.GTGTACCGT	CGACCTGTA.GTGTACCGT
CGACCTGTA.TACTTCCAG	CGACCTGTA.TACTTCCAG
CGACCTGTA.TCTTAGCGA	CGACCTGTA.TCTTAGCGA
CGACGTACG.ACCATGTCT	CGACGTACG.ACCATGTCT
CGACGTACG.ACGACATCT	CGACGTACG.ACGACATCT
CGACGTGAT.AACAGATCG	CGACGTGAT.AACAGATCG
CGACGTGAT.ACTCGTCTA	CGACGTGAT.ACTCGTCTA
CGACGTGAT.TATCAGTGC	CGACGTGAT.TATCAGTGC
CGACGTGAT.TCTAGGATG	CGACGTGAT.TCTAGGATG
CGAGCCGTT.ACTATCCTG	CGAGCCGTT.ACTATCCTG
CGAGCCGTT.AGTAATCAG	CGAGCCGTT.AGTAATCAG
CGAGCCGTT.CTGTTACCA	CGAGCCGTT.CTGTTACCA
CGAGCCGTT.GCTGGTAAC	CGAGCCGTT.GCTGGTAAC
CGAGCCGTT.TAACCGTGA	CGAGCCGTT.TAACCGTGA
CGAGCCGTT.TAGCACACG	CGAGCCGTT.TAGCACACG
CGAGCTTAC.GCGTCGTCT	CGAGCTTAC.GCGTCGTCT
CGAGTAGCA.TCAAGCGTA	CGAGTAGCA.TCAAGCGTA
CGAGTAGCA.TCCTTCAAC	CGAGTAGCA.TCCTTCAAC
CGAGTAGCA.TTGACCTGA	CGAGTAGCA.TTGACCTGA
CGATACTCT.ATCCTCCGA	CGATACTCT.ATCCTCCGA
CGATACTCT.GCCAATGAA	CGATACTCT.GCCAATGAA
CGATACTCT.GCGACCTGT	CGATACTCT.GCGACCTGT
CGATAGGTG.TCAATCTAG	CGATAGGTG.TCAATCTAG
CGATCCAGA.AGCGGAACA	CGATCCAGA.AGCGGAACA
CGATCCAGA.CCACTACCA	CGATCCAGA.CCACTACCA
CGATCCAGA.CCGCACTCA	CGATCCAGA.CCGCACTCA
CGATCCAGA.TTCCGAGCG	CGATCCAGA.TTCCGAGCG
CGATTCGAG.TGCAACTCT	CGATTCGAG.TGCAACTCT
CGATTGAAC.AATAACTCC	CGATTGAAC.AATAACTCC
CGATTGAAC.CCTATTCAA	CGATTGAAC.CCTATTCAA
CGATTGAAC.CGCGATGTA	CGATTGAAC.CGCGATGTA
CGATTGAAC.GCAACCAAC	CGATTGAAC.GCAACCAAC
CGATTGAAC.TATTACAGC	CGATTGAAC.TATTACAGC
CGATTGAAC.TCAAGCGTA	CGATTGAAC.TCAAGCGTA
CGATTGAAC.TCGGAACGA	CGATTGAAC.TCGGAACGA
CGATTGAAC.TTGGTAACT	CGATTGAAC.TTGGTAACT
CGCAACCTC.CCTTGTTGC	CGCAACCTC.CCTTGTTGC
CGCAATCGA.ATAGTCAGT	CGCAATCGA.ATAGTCAGT
CGCAATCGA.CCTAGCAAT	CGCAATCGA.CCTAGCAAT
CGCACTCTT.AATAGACGC	CGCACTCTT.AATAGACGC
CGCACTCTT.ATCACCGCA	CGCACTCTT.ATCACCGCA
CGCACTCTT.CGTATAGCG	CGCACTCTT.CGTATAGCG
CGCACTCTT.CGTTAATGG	CGCACTCTT.CGTTAATGG
CGCACTCTT.GCACAACTC	CGCACTCTT.GCACAACTC
CGCACTGAA.AGAGCGGAG	CGCACTGAA.AGAGCGGAG
CGCACTGAA.AGCTTCGAT	CGCACTGAA.AGCTTCGAT
CGCACTGAA.CGCGTACTA	CGCACTGAA.CGCGTACTA
CGCAGTGTC.AGATCGAGT	CGCAGTGTC.AGATCGAGT
CGCAGTGTC.CCTGTTAGC	CGCAGTGTC.CCTGTTAGC
CGCAGTGTC.GTTGCTCAG	CGCAGTGTC.GTTGCTCAG
CGCATAACT.AGTGAACGG	CGCATAACT.AGTGAACGG
CGCATAACT.CAACGTCTT	CGCATAACT.CAACGTCTT
CGCATAACT.CGTCGTCAA	CGCATAACT.CGTCGTCAA
CGCATCTAC.GTCTCCAGG	CGCATCTAC.GTCTCCAGG
CGCCACCAT.ATGAACTAG	CGCCACCAT.ATGAACTAG
CGCCACCAT.GCAATGAGA	CGCCACCAT.GCAATGAGA
CGCCACCAT.TCTACGCAA	CGCCACCAT.TCTACGCAA
CGCCATTAC.AAGCAATCG	CGCCATTAC.AAGCAATCG
CGCCATTAC.GTCTCCAGG	CGCCATTAC.GTCTCCAGG
CGCCTGCAA.ACTACCATC	CGCCTGCAA.ACTACCATC
CGCCTGCAA.GTACCACAA	CGCCTGCAA.GTACCACAA
CGCCTGCAA.GTATTACTG	CGCCTGCAA.GTATTACTG
CGCGAGTGT.CACCTTCCT	CGCGAGTGT.CACCTTCCT
CGCGAGTGT.CGAGCCGTT	CGCGAGTGT.CGAGCCGTT
CGCGAGTGT.TATGATGTG	CGCGAGTGT.TATGATGTG
CGCGATGTA.GATCTGAAT	CGCGATGTA.GATCTGAAT
CGCGATGTA.TCACACTGC	CGCGATGTA.TCACACTGC
CGCGATGTA.TGTTGTCGA	CGCGATGTA.TGTTGTCGA
CGCGCACAT.ACGTAGTAT	CGCGCACAT.ACGTAGTAT
CGCGCACAT.AGGATCTCA	CGCGCACAT.AGGATCTCA
CGCGCACAT.CGGATTCTC	CGCGCACAT.CGGATTCTC
CGCGCACAT.GCGATATGA	CGCGCACAT.GCGATATGA
CGCGCACAT.GTCCACAAC	CGCGCACAT.GTCCACAAC
CGCGTACTA.AATTAGAGG	CGCGTACTA.AATTAGAGG
CGCGTACTA.AGTTGAGCG	CGCGTACTA.AGTTGAGCG
CGCGTACTA.CCAGTACTC	CGCGTACTA.CCAGTACTC
CGCGTGAGA.ACGCTAGTG	CGCGTGAGA.ACGCTAGTG
CGCGTGAGA.GACATAACG	CGCGTGAGA.GACATAACG
CGCGTGAGA.GCATACTCC	CGCGTGAGA.GCATACTCC
CGCGTGAGA.TATTACTCG	CGCGTGAGA.TATTACTCG
CGCGTGAGA.TGTGGTCCT	CGCGTGAGA.TGTGGTCCT
CGCTGTAGT.CAAGTACGA	CGCTGTAGT.CAAGTACGA
CGCTGTAGT.CGCACTGAA	CGCTGTAGT.CGCACTGAA
CGCTGTAGT.CTGGAGCGA	CGCTGTAGT.CTGGAGCGA
CGCTGTAGT.GACGCTTGC	CGCTGTAGT.GACGCTTGC
CGCTGTAGT.GAGTGCATA	CGCTGTAGT.GAGTGCATA
CGCTGTAGT.GATCTTCGC	CGCTGTAGT.GATCTTCGC
CGCTGTAGT.TCGTAGGAA	CGCTGTAGT.TCGTAGGAA
CGCTTATGA.AAGTCATGA	CGCTTATGA.AAGTCATGA
CGCTTATGA.ACACCACAT	CGCTTATGA.ACACCACAT
CGCTTATGA.AGTACGAAT	CGCTTATGA.AGTACGAAT
CGCTTATGA.CACTTCCTT	CGCTTATGA.CACTTCCTT
CGCTTATGA.CATAGTATG	CGCTTATGA.CATAGTATG
CGCTTATGA.CATGGTTAC	CGCTTATGA.CATGGTTAC
CGCTTATGA.CGTTAATGG	CGCTTATGA.CGTTAATGG
CGCTTATGA.CTCGCAAGA	CGCTTATGA.CTCGCAAGA
CGCTTATGA.CTGTGCTCA	CGCTTATGA.CTGTGCTCA
CGCTTATGA.GGAAGAAGC	CGCTTATGA.GGAAGAAGC
CGCTTATGA.TCCTTCGTA	CGCTTATGA.TCCTTCGTA
CGCTTCACG.AGAAGTAAC	CGCTTCACG.AGAAGTAAC
CGCTTCACG.CCATTCTGC	CGCTTCACG.CCATTCTGC
CGCTTCACG.GAGACTCGA	CGCTTCACG.GAGACTCGA
CGCTTCACG.TACGACTTG	CGCTTCACG.TACGACTTG
CGCTTCACG.TCAAGGAGT	CGCTTCACG.TCAAGGAGT
CGCTTGTAG.AAGGAAGTC	CGCTTGTAG.AAGGAAGTC
CGCTTGTAG.ACAAGAATG	CGCTTGTAG.ACAAGAATG
CGCTTGTAG.AGGTCACGT	CGCTTGTAG.AGGTCACGT
CGCTTGTAG.ATATCCGAT	CGCTTGTAG.ATATCCGAT
CGCTTGTAG.ATCCAGCTG	CGCTTGTAG.ATCCAGCTG
CGCTTGTAG.CCAGGAGTT	CGCTTGTAG.CCAGGAGTT
CGCTTGTAG.CCTCCAATC	CGCTTGTAG.CCTCCAATC
CGCTTGTAG.GTGTCACAC	CGCTTGTAG.GTGTCACAC
CGCTTGTAG.TCCTTAGGT	CGCTTGTAG.TCCTTAGGT
CGGAACGAG.AAGCAGCAT	CGGAACGAG.AAGCAGCAT
CGGAACGAG.AGTGTCTCT	CGGAACGAG.AGTGTCTCT
CGGAACGAG.TGGAAGATT	CGGAACGAG.TGGAAGATT
CGGAAGACG.ACAACCGGA	CGGAAGACG.ACAACCGGA
CGGAAGACG.ACCACGCTA	CGGAAGACG.ACCACGCTA
CGGAAGACG.ACTCTGCTC	CGGAAGACG.ACTCTGCTC
CGGAAGACG.CGTTACACC	CGGAAGACG.CGTTACACC
CGGAATGCA.AGGATTGAG	CGGAATGCA.AGGATTGAG
CGGAATGCA.CGTCGTCAA	CGGAATGCA.CGTCGTCAA
CGGAATGCA.CTAACTAAG	CGGAATGCA.CTAACTAAG
CGGAATGCA.GCTGACAGA	CGGAATGCA.GCTGACAGA
CGGACAAGT.AAGCCAAGT	CGGACAAGT.AAGCCAAGT
CGGACAAGT.CGTGAGACT	CGGACAAGT.CGTGAGACT
CGGACAAGT.CTTAGAAGG	CGGACAAGT.CTTAGAAGG
CGGACAAGT.TGAGAGGAC	CGGACAAGT.TGAGAGGAC
CGGACAAGT.TTGCGAACA	CGGACAAGT.TTGCGAACA
CGGAGACTT.AACCGCTGA	CGGAGACTT.AACCGCTGA
CGGAGACTT.AGAGCGCGA	CGGAGACTT.AGAGCGCGA
CGGAGACTT.CGGTGTTAC	CGGAGACTT.CGGTGTTAC
CGGAGACTT.TATCGAGCC	CGGAGACTT.TATCGAGCC
CGGAGACTT.TGAAGACCA	CGGAGACTT.TGAAGACCA
CGGAGACTT.TGATTATCG	CGGAGACTT.TGATTATCG
CGGATTCTC.AATGCGTGC	CGGATTCTC.AATGCGTGC
CGGATTCTC.ACAACGAGC	CGGATTCTC.ACAACGAGC
CGGATTCTC.TCTTGGTAG	CGGATTCTC.TCTTGGTAG
CGGTAGCTT.AGTCAGTTG	CGGTAGCTT.AGTCAGTTG
CGGTAGCTT.CAGGTTGTC	CGGTAGCTT.CAGGTTGTC
CGGTAGCTT.TTATTCGAC	CGGTAGCTT.TTATTCGAC
CGGTCGACA.GGATCAGGT	CGGTCGACA.GGATCAGGT
CGGTGAGTC.AGCAAGTCC	CGGTGAGTC.AGCAAGTCC
CGGTGAGTC.CAGTCCTAA	CGGTGAGTC.CAGTCCTAA
CGGTGAGTC.TGTGAGTAT	CGGTGAGTC.TGTGAGTAT
CGGTGTTAC.CTATGGATG	CGGTGTTAC.CTATGGATG
CGGTGTTAC.CTCGACGAT	CGGTGTTAC.CTCGACGAT
CGGTTCGTA.CACACCACA	CGGTTCGTA.CACACCACA
CGGTTCGTA.CATACGCAG	CGGTTCGTA.CATACGCAG
CGGTTCGTA.CGTTCGTAC	CGGTTCGTA.CGTTCGTAC
CGGTTCGTA.CTGCGTCAC	CGGTTCGTA.CTGCGTCAC
CGGTTCGTA.GAGCCGTTA	CGGTTCGTA.GAGCCGTTA
CGGTTCGTA.TGATCTCGG	CGGTTCGTA.TGATCTCGG
CGGTTCGTA.TTCCGCCAG	CGGTTCGTA.TTCCGCCAG
CGGTTCTAT.ATCTGCGTA	CGGTTCTAT.ATCTGCGTA
CGGTTCTAT.CAACGATCG	CGGTTCTAT.CAACGATCG
CGGTTCTAT.GAACTATGG	CGGTTCTAT.GAACTATGG
CGGTTCTAT.GAGACATTG	CGGTTCTAT.GAGACATTG
CGGTTCTAT.GAGCATACA	CGGTTCTAT.GAGCATACA
CGGTTCTAT.GCTGATGTC	CGGTTCTAT.GCTGATGTC
CGGTTCTAT.TTAGGAAGG	CGGTTCTAT.TTAGGAAGG
CGGTTGCGA.CCATACGAT	CGGTTGCGA.CCATACGAT
CGGTTGCGA.CCGTACGGA	CGGTTGCGA.CCGTACGGA
CGGTTGCGA.CTGTCACTT	CGGTTGCGA.CTGTCACTT
CGGTTGCGA.GGTGTTCAT	CGGTTGCGA.GGTGTTCAT
CGGTTGCGA.GGTTCTATC	CGGTTGCGA.GGTTCTATC
CGTAATGAC.ACAAGGTAC	CGTAATGAC.ACAAGGTAC
CGTAATGAC.AGCATATGG	CGTAATGAC.AGCATATGG
CGTAATGAC.AGTCAGTTG	CGTAATGAC.AGTCAGTTG
CGTAATGAC.CTATGGATG	CGTAATGAC.CTATGGATG
CGTAATGAC.GCGTGATAC	CGTAATGAC.GCGTGATAC
CGTAATGAC.GGTAGACAT	CGTAATGAC.GGTAGACAT
CGTAATGAC.TGTAGCAAG	CGTAATGAC.TGTAGCAAG
CGTACACAC.ACGAATCGC	CGTACACAC.ACGAATCGC
CGTACACAC.ATCCAATGA	CGTACACAC.ATCCAATGA
CGTACACAC.CATACGCAG	CGTACACAC.CATACGCAG
CGTACACAC.CGTCTGTCC	CGTACACAC.CGTCTGTCC
CGTACACAC.TATAGTGCG	CGTACACAC.TATAGTGCG
CGTACATCT.CCGCAATGG	CGTACATCT.CCGCAATGG
CGTACATCT.CTCCGCATT	CGTACATCT.CTCCGCATT
CGTACATCT.CTTGATCTA	CGTACATCT.CTTGATCTA
CGTACATCT.GTACCACAA	CGTACATCT.GTACCACAA
CGTATAGCG.CATAAGATC	CGTATAGCG.CATAAGATC
CGTATAGCG.CCGAATATG	CGTATAGCG.CCGAATATG
CGTATAGCG.TAACGGATA	CGTATAGCG.TAACGGATA
CGTATAGCG.TTAGGAAGG	CGTATAGCG.TTAGGAAGG
CGTATCGAA.CACACTGCC	CGTATCGAA.CACACTGCC
CGTATCGAA.CAGCTAGTT	CGTATCGAA.CAGCTAGTT
CGTATTCCT.CATTGTTCA	CGTATTCCT.CATTGTTCA
CGTATTCCT.GTAAGTGAG	CGTATTCCT.GTAAGTGAG
CGTATTCCT.GTCGTGTTA	CGTATTCCT.GTCGTGTTA
CGTATTCCT.TCAGGACTG	CGTATTCCT.TCAGGACTG
CGTCAGCAC.ACTCTGCTC	CGTCAGCAC.ACTCTGCTC
CGTCAGCAC.AGCAACATT	CGTCAGCAC.AGCAACATT
CGTCAGCAC.AGTGTTCTG	CGTCAGCAC.AGTGTTCTG
CGTCAGCAC.CACGTAGAC	CGTCAGCAC.CACGTAGAC
CGTCAGCAC.CGCGTACTA	CGTCAGCAC.CGCGTACTA
CGTCATGGA.ATTGACACG	CGTCATGGA.ATTGACACG
CGTCATGGA.CATCCAGGA	CGTCATGGA.CATCCAGGA
CGTCATGGA.CCATAAGTA	CGTCATGGA.CCATAAGTA
CGTCATGGA.CCGCATCCT	CGTCATGGA.CCGCATCCT
CGTCATGGA.TGGTCCTAG	CGTCATGGA.TGGTCCTAG
CGTCATGGA.TTGTATCAC	CGTCATGGA.TTGTATCAC
CGTCGTCAA.AGGATCATG	CGTCGTCAA.AGGATCATG
CGTCGTCAA.ATAAGTTCG	CGTCGTCAA.ATAAGTTCG
CGTCGTCAA.ATGTGAGAC	CGTCGTCAA.ATGTGAGAC
CGTCGTCAA.CTCCTGACG	CGTCGTCAA.CTCCTGACG
CGTCGTCAA.GTTGCTCAG	CGTCGTCAA.GTTGCTCAG
CGTCTGCTG.CGATCCAGA	CGTCTGCTG.CGATCCAGA
CGTCTGCTG.TGACGGTTG	CGTCTGCTG.TGACGGTTG
CGTCTGTCC.ACCGGAAGG	CGTCTGTCC.ACCGGAAGG
CGTCTGTCC.GGAGTTAGC	CGTCTGTCC.GGAGTTAGC
CGTCTGTCC.GTCACTATG	CGTCTGTCC.GTCACTATG
CGTCTGTCC.TGAACTTGC	CGTCTGTCC.TGAACTTGC
CGTGACCAG.ACACACGTC	CGTGACCAG.ACACACGTC
CGTGACCAG.CACTGTATC	CGTGACCAG.CACTGTATC
CGTGACCAG.GTAATCAGC	CGTGACCAG.GTAATCAGC
CGTGACCAG.TAGCTAAGA	CGTGACCAG.TAGCTAAGA
CGTGACCAG.TCTGCAACA	CGTGACCAG.TCTGCAACA
CGTGACCAG.TGACGGTTG	CGTGACCAG.TGACGGTTG
CGTGAGACT.AATGCGTGC	CGTGAGACT.AATGCGTGC
CGTGAGACT.GGTAAGGAT	CGTGAGACT.GGTAAGGAT
CGTGAGACT.TAGCGAGAA	CGTGAGACT.TAGCGAGAA
CGTGCAAGG.AGCAACATT	CGTGCAAGG.AGCAACATT
CGTGCAAGG.CTATGGATG	CGTGCAAGG.CTATGGATG
CGTGCAAGG.CTTCGTGCA	CGTGCAAGG.CTTCGTGCA
CGTGCCTAT.GCCTGCATC	CGTGCCTAT.GCCTGCATC
CGTGCCTAT.GGTAAGTGA	CGTGCCTAT.GGTAAGTGA
CGTGCCTAT.TCCTGTGGA	CGTGCCTAT.TCCTGTGGA
CGTGCTTGA.AATGAGTCG	CGTGCTTGA.AATGAGTCG
CGTGCTTGA.ATCTAGGTT	CGTGCTTGA.ATCTAGGTT
CGTGCTTGA.ATGCTGTCG	CGTGCTTGA.ATGCTGTCG
CGTGCTTGA.GATATGGAC	CGTGCTTGA.GATATGGAC
CGTGCTTGA.TCTTAAGTG	CGTGCTTGA.TCTTAAGTG
CGTGCTTGA.TTAGATCGG	CGTGCTTGA.TTAGATCGG
CGTGGTACC.AGAGAGTGG	CGTGGTACC.AGAGAGTGG
CGTGGTACC.AGCACCAGC	CGTGGTACC.AGCACCAGC
CGTGGTACC.ATTAGCCAC	CGTGGTACC.ATTAGCCAC
CGTGGTACC.CACTCACTA	CGTGGTACC.CACTCACTA
CGTGGTACC.TCCGGAGCT	CGTGGTACC.TCCGGAGCT
CGTGGTACC.TGAACTTGC	CGTGGTACC.TGAACTTGC
CGTGGTACC.TGACCTATG	CGTGGTACC.TGACCTATG
CGTGGTACC.TGAGCAGAT	CGTGGTACC.TGAGCAGAT
CGTGTATTC.CAACACCTA	CGTGTATTC.CAACACCTA
CGTGTATTC.CGGAACGAG	CGTGTATTC.CGGAACGAG
CGTGTATTC.TTGGTAACT	CGTGTATTC.TTGGTAACT
CGTGTCCGA.ACCACGGAT	CGTGTCCGA.ACCACGGAT
CGTGTCCGA.AGATGTTGG	CGTGTCCGA.AGATGTTGG
CGTGTCCGA.CCGTTCCAA	CGTGTCCGA.CCGTTCCAA
CGTGTCCGA.TGCTTACGG	CGTGTCCGA.TGCTTACGG
CGTGTGTGG.ACATTCCAC	CGTGTGTGG.ACATTCCAC
CGTGTGTGG.GAATCAACC	CGTGTGTGG.GAATCAACC
CGTGTGTGG.GAGACGATC	CGTGTGTGG.GAGACGATC
CGTGTGTGG.GCGATATGA	CGTGTGTGG.GCGATATGA
CGTGTGTGG.GGTAGCATC	CGTGTGTGG.GGTAGCATC
CGTGTGTGG.TGTAACAGT	CGTGTGTGG.TGTAACAGT
CGTGTGTGG.TTGCGAACA	CGTGTGTGG.TTGCGAACA
CGTTAATGG.AAGCCAAGT	CGTTAATGG.AAGCCAAGT
CGTTAATGG.ACAGCGGTC	CGTTAATGG.ACAGCGGTC
CGTTAATGG.CGCACTGAA	CGTTAATGG.CGCACTGAA
CGTTAATGG.CTCTAGTAA	CGTTAATGG.CTCTAGTAA
CGTTAATGG.TCGAATAGA	CGTTAATGG.TCGAATAGA
CGTTACACC.ATGACACAA	CGTTACACC.ATGACACAA
CGTTACACC.CGAAGAGGT	CGTTACACC.CGAAGAGGT
CGTTACACC.CGCGAGTGT	CGTTACACC.CGCGAGTGT
CGTTACACC.GCCTTATCT	CGTTACACC.GCCTTATCT
CGTTACACC.GCGGTAGTC	CGTTACACC.GCGGTAGTC
CGTTCGTAC.AGTGTCTCT	CGTTCGTAC.AGTGTCTCT
CGTTCGTAC.CCACTTCGC	CGTTCGTAC.CCACTTCGC
CGTTCGTAC.CCTCTTGTA	CGTTCGTAC.CCTCTTGTA
CGTTCGTAC.CTGTTACCA	CGTTCGTAC.CTGTTACCA
CGTTCGTAC.GAAGAGCAC	CGTTCGTAC.GAAGAGCAC
CGTTGATCC.ATCAAGCAT	CGTTGATCC.ATCAAGCAT
CGTTGATCC.CAAGCCTCG	CGTTGATCC.CAAGCCTCG
CGTTGATCC.TAGCACACG	CGTTGATCC.TAGCACACG
CTAACACTG.AGACATCCA	CTAACACTG.AGACATCCA
CTAACACTG.CAAGCGCAT	CTAACACTG.CAAGCGCAT
CTAACCGGT.AAGCAGCAT	CTAACCGGT.AAGCAGCAT
CTAACCGGT.ACTGCTAGT	CTAACCGGT.ACTGCTAGT
CTAACCGGT.ATCATAGAC	CTAACCGGT.ATCATAGAC
CTAACCGGT.ATGCCTGTC	CTAACCGGT.ATGCCTGTC
CTAACCGGT.CAATGCATT	CTAACCGGT.CAATGCATT
CTAACCGGT.CCATAGCCA	CTAACCGGT.CCATAGCCA
CTAACCGGT.CTGAGATAG	CTAACCGGT.CTGAGATAG
CTAACCGGT.GAGAATCAG	CTAACCGGT.GAGAATCAG
CTAACTAAG.TGATTGCTG	CTAACTAAG.TGATTGCTG
CTAATACGC.AATTCGGAA	CTAATACGC.AATTCGGAA
CTAATACGC.CTCGACGAT	CTAATACGC.CTCGACGAT
CTAATACGC.TATCCTCAG	CTAATACGC.TATCCTCAG
CTAATACGC.TGATGACAG	CTAATACGC.TGATGACAG
CTACCTGCG.GATACTGTG	CTACCTGCG.GATACTGTG
CTACCTGCG.GCAGATCCG	CTACCTGCG.GCAGATCCG
CTACCTGCG.GCATGTGGT	CTACCTGCG.GCATGTGGT
CTACGAGAA.AGCAGACAA	CTACGAGAA.AGCAGACAA
CTACGAGAA.CACAACGCT	CTACGAGAA.CACAACGCT
CTACGAGAA.CCGAGCTGA	CTACGAGAA.CCGAGCTGA
CTACGGTAT.AACTTCTGC	CTACGGTAT.AACTTCTGC
CTACGGTAT.AAGACTGGT	CTACGGTAT.AAGACTGGT
CTACGGTAT.CTTGGATCA	CTACGGTAT.CTTGGATCA
CTACGGTAT.GACTTGATT	CTACGGTAT.GACTTGATT
CTACGGTAT.TAGCGCAGC	CTACGGTAT.TAGCGCAGC
CTACGGTAT.TGTCACATA	CTACGGTAT.TGTCACATA
CTACGTTGG.ACATGACTA	CTACGTTGG.ACATGACTA
CTACGTTGG.ATATGTCCA	CTACGTTGG.ATATGTCCA
CTACGTTGG.CTAGGTACT	CTACGTTGG.CTAGGTACT
CTACGTTGG.CTGTACGAC	CTACGTTGG.CTGTACGAC
CTACGTTGG.GCTAGTGGA	CTACGTTGG.GCTAGTGGA
CTACGTTGG.GGAAGTATG	CTACGTTGG.GGAAGTATG
CTACGTTGG.TAGAGCGTC	CTACGTTGG.TAGAGCGTC
CTACGTTGG.TCCAGCAGC	CTACGTTGG.TCCAGCAGC
CTACTGTCA.AATACCTTG	CTACTGTCA.AATACCTTG
CTACTGTCA.CCAGGAGTT	CTACTGTCA.CCAGGAGTT
CTACTGTCA.CCGACGTCA	CTACTGTCA.CCGACGTCA
CTACTGTCA.CCGGATTGC	CTACTGTCA.CCGGATTGC
CTACTGTCA.CTTCCGGTA	CTACTGTCA.CTTCCGGTA
CTACTGTCA.GACGTTCAG	CTACTGTCA.GACGTTCAG
CTACTGTCA.GTGCCATGA	CTACTGTCA.GTGCCATGA
CTACTGTCA.TAGTGATCC	CTACTGTCA.TAGTGATCC
CTAGACATG.ACACGTTGC	CTAGACATG.ACACGTTGC
CTAGACATG.AGAAGAGTC	CTAGACATG.AGAAGAGTC
CTAGACATG.GAGGTCACG	CTAGACATG.GAGGTCACG
CTAGACATG.GTACGCGAT	CTAGACATG.GTACGCGAT
CTAGACATG.TCAGGACTG	CTAGACATG.TCAGGACTG
CTAGAGGTA.ACGCTAGTG	CTAGAGGTA.ACGCTAGTG
CTAGAGGTA.ATGCTGTCG	CTAGAGGTA.ATGCTGTCG
CTAGAGGTA.GCTGACAGA	CTAGAGGTA.GCTGACAGA
CTAGAGGTA.GGAGCTCAA	CTAGAGGTA.GGAGCTCAA
CTAGAGGTA.GGTGAGCGT	CTAGAGGTA.GGTGAGCGT
CTAGAGGTA.GTGTTCCAG	CTAGAGGTA.GTGTTCCAG
CTAGAGGTA.TCGGATGTT	CTAGAGGTA.TCGGATGTT
CTAGAGGTA.TGGAATCGT	CTAGAGGTA.TGGAATCGT
CTAGAGGTA.TGTAGCAAG	CTAGAGGTA.TGTAGCAAG
CTAGAGTCG.AAGACGAAG	CTAGAGTCG.AAGACGAAG
CTAGAGTCG.AATCGCCAT	CTAGAGTCG.AATCGCCAT
CTAGAGTCG.TGCCAATGG	CTAGAGTCG.TGCCAATGG
CTAGGTACT.CACGTAGAC	CTAGGTACT.CACGTAGAC
CTAGGTACT.CATAGGTGT	CTAGGTACT.CATAGGTGT
CTAGGTACT.CTGTACGAC	CTAGGTACT.CTGTACGAC
CTAGGTACT.CTTAAGTTG	CTAGGTACT.CTTAAGTTG
CTAGGTACT.GCCTGGAAT	CTAGGTACT.GCCTGGAAT
CTAGGTACT.GTCATTCTA	CTAGGTACT.GTCATTCTA
CTAGGTACT.TAGTAGTCT	CTAGGTACT.TAGTAGTCT
CTAGTATAG.ACATTCCAC	CTAGTATAG.ACATTCCAC
CTAGTATAG.CATGGTCGA	CTAGTATAG.CATGGTCGA
CTAGTATAG.GATTATGCG	CTAGTATAG.GATTATGCG
CTAGTATAG.GCAATGAGA	CTAGTATAG.GCAATGAGA
CTAGTCGTC.GAGACTCGA	CTAGTCGTC.GAGACTCGA
CTAGTCGTC.TCAGCTCAG	CTAGTCGTC.TCAGCTCAG
CTAGTCGTC.TTACAGTGT	CTAGTCGTC.TTACAGTGT
CTAGTGCTG.GCCATTAAG	CTAGTGCTG.GCCATTAAG
CTAGTTCCA.AGAGCGGAG	CTAGTTCCA.AGAGCGGAG
CTATACTAG.GCGAAGACA	CTATACTAG.GCGAAGACA
CTATACTAG.GCTACCTTA	CTATACTAG.GCTACCTTA
CTATACTAG.TCTAGGATG	CTATACTAG.TCTAGGATG
CTATAGCTC.TGCGCACTG	CTATAGCTC.TGCGCACTG
CTATCCATC.GTAACAGTC	CTATCCATC.GTAACAGTC
CTATCCATC.GTGAGGACG	CTATCCATC.GTGAGGACG
CTATCCATC.GTTGCTCAG	CTATCCATC.GTTGCTCAG
CTATCTTGA.ACACTAACG	CTATCTTGA.ACACTAACG
CTATCTTGA.CAACCGGTC	CTATCTTGA.CAACCGGTC
CTATCTTGA.TGCCACCGA	CTATCTTGA.TGCCACCGA
CTATGGATG.AAGACGAAG	CTATGGATG.AAGACGAAG
CTATGGATG.AAGTCATGA	CTATGGATG.AAGTCATGA
CTATGGATG.CCTGCAGAT	CTATGGATG.CCTGCAGAT
CTATGGATG.GCCTTCCAT	CTATGGATG.GCCTTCCAT
CTATGGATG.TACGAACTC	CTATGGATG.TACGAACTC
CTATGGATG.TACTTCCAG	CTATGGATG.TACTTCCAG
CTATGGATG.TCACCGAGG	CTATGGATG.TCACCGAGG
CTATGGATG.TCGCTTAAC	CTATGGATG.TCGCTTAAC
CTATGGATG.TCTGATGAA	CTATGGATG.TCTGATGAA
CTATGGATG.TTCGGAGTC	CTATGGATG.TTCGGAGTC
CTATTAAGG.AGCATATGG	CTATTAAGG.AGCATATGG
CTATTAAGG.CTATTCCGT	CTATTAAGG.CTATTCCGT
CTATTAAGG.TGATCTCGG	CTATTAAGG.TGATCTCGG
CTATTCCGT.AACTCCATG	CTATTCCGT.AACTCCATG
CTATTCCGT.AGTGTGCAC	CTATTCCGT.AGTGTGCAC
CTATTCCGT.CAAGCTGCA	CTATTCCGT.CAAGCTGCA
CTATTCCGT.CCTAAGAAG	CTATTCCGT.CCTAAGAAG
CTATTCCGT.GCCTTCCAT	CTATTCCGT.GCCTTCCAT
CTATTCCGT.TGTTGTCGA	CTATTCCGT.TGTTGTCGA
CTCAGCTGG.ACTGGTGCT	CTCAGCTGG.ACTGGTGCT
CTCAGCTGG.AGGTACCAA	CTCAGCTGG.AGGTACCAA
CTCAGCTGG.ATAGTCTCC	CTCAGCTGG.ATAGTCTCC
CTCAGCTGG.ATGCGTGGA	CTCAGCTGG.ATGCGTGGA
CTCAGCTGG.GGATAGTCA	CTCAGCTGG.GGATAGTCA
CTCAGGTAC.AGCGTCGTC	CTCAGGTAC.AGCGTCGTC
CTCAGGTAC.ATTCTCTGG	CTCAGGTAC.ATTCTCTGG
CTCAGGTAC.GACGGTGCT	CTCAGGTAC.GACGGTGCT
CTCAGGTAC.GGTACGAGC	CTCAGGTAC.GGTACGAGC
CTCAGGTAC.TCGATTCAG	CTCAGGTAC.TCGATTCAG
CTCAGGTAC.TCGCGTCAT	CTCAGGTAC.TCGCGTCAT
CTCAGTGAT.CTTACCTAG	CTCAGTGAT.CTTACCTAG
CTCAGTGAT.TTAGTCGGA	CTCAGTGAT.TTAGTCGGA
CTCATGCCA.AGCCTCGCA	CTCATGCCA.AGCCTCGCA
CTCATGCCA.GGAGTTAGC	CTCATGCCA.GGAGTTAGC
CTCATGCCA.TTGATCGTA	CTCATGCCA.TTGATCGTA
CTCATTAGT.AGTGATGCG	CTCATTAGT.AGTGATGCG
CTCATTAGT.CACGACTCA	CTCATTAGT.CACGACTCA
CTCATTAGT.CCGCAACAC	CTCATTAGT.CCGCAACAC
CTCATTAGT.CCTGCGTTA	CTCATTAGT.CCTGCGTTA
CTCATTAGT.CTGCAGAGC	CTCATTAGT.CTGCAGAGC
CTCATTAGT.GACGTAGCA	CTCATTAGT.GACGTAGCA
CTCATTAGT.GTAGCATAC	CTCATTAGT.GTAGCATAC
CTCATTAGT.TAACATTGG	CTCATTAGT.TAACATTGG
CTCCACGTC.CGATTGAAC	CTCCACGTC.CGATTGAAC
