AACAACCTA.TCCTTAGGT	AACAACCTA.TCCTTAGGT
AACAACTGG.ACAAGTACA	AACAACTGG.ACAAGTACA
AACAACTGG.AGGTCCGTC	AACAACTGG.AGGTCCGTC
AACAACTGG.GCGCTTCTC	AACAACTGG.GCGCTTCTC
AACAACTGG.GGTCGGTCT	AACAACTGG.GGTCGGTCT
AACAACTGG.GTGACTCTC	AACAACTGG.GTGACTCTC
AACAATGCA.ACTGGACCA	AACAATGCA.ACTGGACCA
AACAATGCA.ATGCTGTCG	AACAATGCA.ATGCTGTCG
AACAATGCA.CAACTAATC	AACAATGCA.CAACTAATC
AACAATGCA.CTCGCTACG	AACAATGCA.CTCGCTACG
AACAATGCA.GAGCCGTTA	AACAATGCA.GAGCCGTTA
AACACACTC.CGACCATCA	AACACACTC.CGACCATCA
AACACACTC.CGCGTGAGA	AACACACTC.CGCGTGAGA
AACACACTC.GATGCGGTT	AACACACTC.GATGCGGTT
AACAGATCG.CGACCATCA	AACAGATCG.CGACCATCA
AACAGATCG.GATCGATAC	AACAGATCG.GATCGATAC
AACAGATCG.TAATGTAGC	AACAGATCG.TAATGTAGC
AACAGATCG.TCTGAGATA	AACAGATCG.TCTGAGATA
AACAGCAGT.AGACCACGC	AACAGCAGT.AGACCACGC
AACAGCAGT.ATCGAATCG	AACAGCAGT.ATCGAATCG
AACAGCAGT.CCGATACCG	AACAGCAGT.CCGATACCG
AACAGCAGT.CTTGTAACG	AACAGCAGT.CTTGTAACG
AACAGCAGT.GTAGCCTTG	AACAGCAGT.GTAGCCTTG
AACCATGGT.ACGATGACC	AACCATGGT.ACGATGACC
AACCGCTGA.GTCGACATT	AACCGCTGA.GTCGACATT
AACCGCTGA.GTCGTGTTA	AACCGCTGA.GTCGTGTTA
AACCGTGAG.TCTTGGTAG	AACCGTGAG.TCTTGGTAG
AACGAGAAT.ACCACTAGG	AACGAGAAT.ACCACTAGG
AACGAGAAT.CCATCTAGG	AACGAGAAT.CCATCTAGG
AACGAGGTG.CTCGAACTG	AACGAGGTG.CTCGAACTG
AACGAGGTG.GATCTAGAG	AACGAGGTG.GATCTAGAG
AACGAGGTG.GCGAAGCTC	AACGAGGTG.GCGAAGCTC
AACGAGGTG.GCGGTAGTC	AACGAGGTG.GCGGTAGTC
AACGATGAC.GCAACACCT	AACGATGAC.GCAACACCT
AACGCATTG.ACAGAGATG	AACGCATTG.ACAGAGATG
AACGCATTG.CAACGATCG	AACGCATTG.CAACGATCG
AACGCATTG.CTATTAAGG	AACGCATTG.CTATTAAGG
AACGCATTG.TAAGGTCCG	AACGCATTG.TAAGGTCCG
AACGCCTAC.AGACATATC	AACGCCTAC.AGACATATC
AACGCCTAC.AGCGGTCTA	AACGCCTAC.AGCGGTCTA
AACGCCTAC.GGATACAAT	AACGCCTAC.GGATACAAT
AACGCCTAC.GTATGATCT	AACGCCTAC.GTATGATCT
AACGCCTAC.TAGCTAAGA	AACGCCTAC.TAGCTAAGA
AACGCTCAA.AATTAGAGG	AACGCTCAA.AATTAGAGG
AACGCTCAA.ACCGCTGTG	AACGCTCAA.ACCGCTGTG
AACGCTCAA.ATTAGCCAC	AACGCTCAA.ATTAGCCAC
AACGCTCAA.CACTTCCTT	AACGCTCAA.CACTTCCTT
AACGCTCAA.CCTATTCAA	AACGCTCAA.CCTATTCAA
AACGCTCAA.CTATTAAGG	AACGCTCAA.CTATTAAGG
AACGGAGAT.AATGTGCGT	AACGGAGAT.AATGTGCGT
AACGGAGAT.ATTAGCCAC	AACGGAGAT.ATTAGCCAC
AACGGAGAT.CAACCGGTC	AACGGAGAT.CAACCGGTC
AACGGAGAT.GGAGATGAG	AACGGAGAT.GGAGATGAG
AACGGAGAT.GGTTCTATC	AACGGAGAT.GGTTCTATC
AACGGAGAT.TATCACCTG	AACGGAGAT.TATCACCTG
AACGGAGAT.TCGCTGATT	AACGGAGAT.TCGCTGATT
AACGGTAGC.AACTTGTCG	AACGGTAGC.AACTTGTCG
AACGGTAGC.ACCGGTTAC	AACGGTAGC.ACCGGTTAC
AACGGTAGC.CCTCGCGTT	AACGGTAGC.CCTCGCGTT
AACGGTAGC.GACTCTCAC	AACGGTAGC.GACTCTCAC
AACGGTAGC.GTCTTATGC	AACGGTAGC.GTCTTATGC
AACGGTAGC.TTATGAGGA	AACGGTAGC.TTATGAGGA
AACGGTAGC.TTGAGCTCT	AACGGTAGC.TTGAGCTCT
AACGTCGAG.GCGCTCTAT	AACGTCGAG.GCGCTCTAT
AACGTCGAG.GTGACTCTC	AACGTCGAG.GTGACTCTC
AACGTCGAG.TATTCAACG	AACGTCGAG.TATTCAACG
AACGTCGAG.TCGGTATCA	AACGTCGAG.TCGGTATCA
AACGTTCTT.AGCATATGG	AACGTTCTT.AGCATATGG
AACGTTCTT.GACGTTCAG	AACGTTCTT.GACGTTCAG
AACTAACTG.GAATTGTTG	AACTAACTG.GAATTGTTG
AACTAACTG.TTATCGCAC	AACTAACTG.TTATCGCAC
AACTCCATG.ACCATTCAC	AACTCCATG.ACCATTCAC
AACTCCATG.AGAGGTGAA	AACTCCATG.AGAGGTGAA
AACTCCATG.CTTCTATGA	AACTCCATG.CTTCTATGA
AACTCCATG.GTTGACGTG	AACTCCATG.GTTGACGTG
AACTCCATG.TCGCTGTAA	AACTCCATG.TCGCTGTAA
AACTCCATG.TTACGGACC	AACTCCATG.TTACGGACC
AACTGATTC.CCACGCCAT	AACTGATTC.CCACGCCAT
AACTGATTC.TGCCAGACG	AACTGATTC.TGCCAGACG
AACTGCGAC.AGTCAGTTG	AACTGCGAC.AGTCAGTTG
AACTGCGAC.CATGTGAAC	AACTGCGAC.CATGTGAAC
AACTGCGAC.CCGCAATGG	AACTGCGAC.CCGCAATGG
AACTGCGAC.CCTGCTCCA	AACTGCGAC.CCTGCTCCA
AACTGCGAC.CTTCCGTGG	AACTGCGAC.CTTCCGTGG
AACTGCGAC.GACCGTAGT	AACTGCGAC.GACCGTAGT
AACTGCGAC.TGAACGTCA	AACTGCGAC.TGAACGTCA
AACTGCGAC.TTCCGAGCG	AACTGCGAC.TTCCGAGCG
AACTTAGCT.CGTGAGACT	AACTTAGCT.CGTGAGACT
AACTTAGCT.CTCATTAGT	AACTTAGCT.CTCATTAGT
AACTTAGCT.GAATTCAGT	AACTTAGCT.GAATTCAGT
AACTTAGCT.GCTCAATGA	AACTTAGCT.GCTCAATGA
AACTTCTGC.AGTTCGATA	AACTTCTGC.AGTTCGATA
AACTTCTGC.GCGACACAG	AACTTCTGC.GCGACACAG
AACTTGTCG.ATCAGAAGC	AACTTGTCG.ATCAGAAGC
AACTTGTCG.ATCTACATC	AACTTGTCG.ATCTACATC
AACTTGTCG.GCTTAGAAC	AACTTGTCG.GCTTAGAAC
AACTTGTCG.GTCACTATG	AACTTGTCG.GTCACTATG
AACTTGTCG.TAGGAGGAT	AACTTGTCG.TAGGAGGAT
AACTTGTCG.TATGGTTGG	AACTTGTCG.TATGGTTGG
AACTTGTCG.TCCTTCAAC	AACTTGTCG.TCCTTCAAC
AACTTGTCG.TGATGACAG	AACTTGTCG.TGATGACAG
AAGACGAAG.ATAGACCGA	AAGACGAAG.ATAGACCGA
AAGACGAAG.CTCTTCAGC	AAGACGAAG.CTCTTCAGC
AAGACGAAG.GGAACTGCT	AAGACGAAG.GGAACTGCT
AAGACGAAG.TAGATCTGT	AAGACGAAG.TAGATCTGT
AAGACTACC.CATGGTCGA	AAGACTACC.CATGGTCGA
AAGACTGGT.AGGAATTGG	AAGACTGGT.AGGAATTGG
AAGACTGGT.GTAATCAGC	AAGACTGGT.GTAATCAGC
AAGAGAACT.ACAAGTACA	AAGAGAACT.ACAAGTACA
AAGAGAACT.ACCGAGACA	AAGAGAACT.ACCGAGACA
AAGAGAACT.AGATCTTCA	AAGAGAACT.AGATCTTCA
AAGAGAACT.ATAGCACGG	AAGAGAACT.ATAGCACGG
AAGAGAACT.ATCCAGCTG	AAGAGAACT.ATCCAGCTG
AAGAGAACT.CGCACTGAA	AAGAGAACT.CGCACTGAA
AAGAGAACT.TTATTCGAC	AAGAGAACT.TTATTCGAC
AAGAGAGAG.AGGATCTCA	AAGAGAGAG.AGGATCTCA
AAGAGAGAG.CTCTCAGTC	AAGAGAGAG.CTCTCAGTC
AAGAGAGAG.GAGATACAC	AAGAGAGAG.GAGATACAC
AAGAGAGAG.GTGGATAAG	AAGAGAGAG.GTGGATAAG
AAGAGAGAG.TATACGTGG	AAGAGAGAG.TATACGTGG
AAGAGAGAG.TGGAGAACC	AAGAGAGAG.TGGAGAACC
AAGCAACTA.AAGACGAAG	AAGCAACTA.AAGACGAAG
AAGCAACTA.AGACTTCGT	AAGCAACTA.AGACTTCGT
AAGCAACTA.CGTGTGTGG	AAGCAACTA.CGTGTGTGG
AAGCAACTA.GCTGAGCAG	AAGCAACTA.GCTGAGCAG
AAGCAACTA.TTCTGGTGC	AAGCAACTA.TTCTGGTGC
AAGCAACTA.TTGCGAACA	AAGCAACTA.TTGCGAACA
AAGCAATCG.ATCATTACG	AAGCAATCG.ATCATTACG
AAGCAATCG.CCTAGTCTC	AAGCAATCG.CCTAGTCTC
AAGCAATCG.CTCGACTGC	AAGCAATCG.CTCGACTGC
AAGCAATCG.TCACATACT	AAGCAATCG.TCACATACT
AAGCACAAC.GCCGAACCA	AAGCACAAC.GCCGAACCA
AAGCACAAC.GTGTCACAC	AAGCACAAC.GTGTCACAC
AAGCAGCAT.ACATGACTA	AAGCAGCAT.ACATGACTA
AAGCAGCAT.ATCCACAGT	AAGCAGCAT.ATCCACAGT
AAGCAGCAT.CAACCTGGT	AAGCAGCAT.CAACCTGGT
AAGCAGCAT.CCGCAGCTA	AAGCAGCAT.CCGCAGCTA
AAGCATTGC.ACTAACCGA	AAGCATTGC.ACTAACCGA
AAGCATTGC.GGTCCTGGT	AAGCATTGC.GGTCCTGGT
AAGCATTGC.GTGACGTAA	AAGCATTGC.GTGACGTAA
AAGCATTGC.TCCTCTAGT	AAGCATTGC.TCCTCTAGT
AAGCATTGC.TGAGCAGAT	AAGCATTGC.TGAGCAGAT
AAGCCAAGT.AACTGATTC	AAGCCAAGT.AACTGATTC
AAGCCAAGT.ACGACATCT	AAGCCAAGT.ACGACATCT
AAGCCAAGT.AGCGTCGTC	AAGCCAAGT.AGCGTCGTC
AAGCCAAGT.ATGGATATC	AAGCCAAGT.ATGGATATC
AAGCCAAGT.GAATTCAGT	AAGCCAAGT.GAATTCAGT
AAGCCAAGT.TAGCCAGTG	AAGCCAAGT.TAGCCAGTG
AAGCCACAC.AGTACTACA	AAGCCACAC.AGTACTACA
AAGCCACAC.AGTGGAATG	AAGCCACAC.AGTGGAATG
AAGCCACAC.GAACTATGG	AAGCCACAC.GAACTATGG
AAGCCACAC.GACTGCCTG	AAGCCACAC.GACTGCCTG
AAGCCACAC.GCCTTAGAG	AAGCCACAC.GCCTTAGAG
AAGCCACAC.GTATCGTCG	AAGCCACAC.GTATCGTCG
AAGCCACAC.GTCTCCAGG	AAGCCACAC.GTCTCCAGG
AAGCTGAGG.AGGTGCGAG	AAGCTGAGG.AGGTGCGAG
AAGCTGAGG.CAGGAGCCT	AAGCTGAGG.CAGGAGCCT
AAGCTGAGG.TCGCATTCG	AAGCTGAGG.TCGCATTCG
AAGCTGGTC.ACTTCTTGG	AAGCTGGTC.ACTTCTTGG
AAGCTTGCA.AATGCACTT	AAGCTTGCA.AATGCACTT
AAGCTTGCA.CCGATGTTC	AAGCTTGCA.CCGATGTTC
AAGCTTGCA.GAGGTCACG	AAGCTTGCA.GAGGTCACG
AAGCTTGCA.GTCTTCATA	AAGCTTGCA.GTCTTCATA
AAGGAACAG.ACCATGTCT	AAGGAACAG.ACCATGTCT
AAGGAACAG.ACGACATCT	AAGGAACAG.ACGACATCT
AAGGAACAG.CCTAGTCTC	AAGGAACAG.CCTAGTCTC
AAGGAACAG.CCTCAGGTG	AAGGAACAG.CCTCAGGTG
AAGGAACAG.CCTGACCTC	AAGGAACAG.CCTGACCTC
AAGGAACAG.CGACCTAGC	AAGGAACAG.CGACCTAGC
AAGGAACAG.TCCACCGGT	AAGGAACAG.TCCACCGGT
AAGGAACAG.TCCTTAGGT	AAGGAACAG.TCCTTAGGT
AAGGAAGTC.AAGCTTGCA	AAGGAAGTC.AAGCTTGCA
AAGGAAGTC.ACGCGACAG	AAGGAAGTC.ACGCGACAG
AAGGAAGTC.CTAGAGGTA	AAGGAAGTC.CTAGAGGTA
AAGGAAGTC.TCGATTCAG	AAGGAAGTC.TCGATTCAG
AAGGAAGTC.TGCCGCTAC	AAGGAAGTC.TGCCGCTAC
AAGGATACG.AGAAGTCCT	AAGGATACG.AGAAGTCCT
AAGGATACG.ATATGCAGC	AAGGATACG.ATATGCAGC
AAGGATACG.GAACTATGG	AAGGATACG.GAACTATGG
AAGGATCGT.AGTAATGGT	AAGGATCGT.AGTAATGGT
AAGGATCGT.CCTCGACCT	AAGGATCGT.CCTCGACCT
AAGGATCGT.GACTAGCAT	AAGGATCGT.GACTAGCAT
AAGGATCGT.GCACATGTT	AAGGATCGT.GCACATGTT
AAGGATCGT.GGAGACACA	AAGGATCGT.GGAGACACA
AAGGTCTGA.ACCGATCGA	AAGGTCTGA.ACCGATCGA
AAGGTCTGA.CAGCACGTG	AAGGTCTGA.CAGCACGTG
AAGGTCTGA.CGAATGAGT	AAGGTCTGA.CGAATGAGT
AAGGTCTGA.GGACGAGCA	AAGGTCTGA.GGACGAGCA
AAGGTCTGA.TATGACCGA	AAGGTCTGA.TATGACCGA
AAGGTGCTG.CTCCGCATT	AAGGTGCTG.CTCCGCATT
AAGGTGCTG.TACAAGAGG	AAGGTGCTG.TACAAGAGG
AAGGTGCTG.TTGCCAGAT	AAGGTGCTG.TTGCCAGAT
AAGTACAGA.AAGCAATCG	AAGTACAGA.AAGCAATCG
AAGTACAGA.AGATCTTCA	AAGTACAGA.AGATCTTCA
AAGTACAGA.GAACCAGTT	AAGTACAGA.GAACCAGTT
AAGTACAGA.GGATACCTA	AAGTACAGA.GGATACCTA
AAGTACAGA.GTCAGACCG	AAGTACAGA.GTCAGACCG
AAGTACAGA.TCTGCGCTG	AAGTACAGA.TCTGCGCTG
AAGTAGGAC.AATACCTTG	AAGTAGGAC.AATACCTTG
AAGTAGGAC.GACAATGTT	AAGTAGGAC.GACAATGTT
AAGTAGGAC.GCTATGTAA	AAGTAGGAC.GCTATGTAA
AAGTAGGAC.TACCAGCCA	AAGTAGGAC.TACCAGCCA
AAGTAGGAC.TCATCTGTC	AAGTAGGAC.TCATCTGTC
AAGTAGGAC.TGCCATCTC	AAGTAGGAC.TGCCATCTC
AAGTCATGA.AATACGTCT	AAGTCATGA.AATACGTCT
AAGTCATGA.GTGAATGCC	AAGTCATGA.GTGAATGCC
AAGTCATGA.TTGTATCAC	AAGTCATGA.TTGTATCAC
AAGTTCTCT.ACACGTTGC	AAGTTCTCT.ACACGTTGC
AAGTTCTCT.GCCGAGTCT	AAGTTCTCT.GCCGAGTCT
AAGTTCTCT.GGACTCCTT	AAGTTCTCT.GGACTCCTT
AAGTTCTCT.GGAGATGAG	AAGTTCTCT.GGAGATGAG
AAGTTCTCT.TGCCTGGTT	AAGTTCTCT.TGCCTGGTT
AAGTTGCCA.AATGCCTCA	AAGTTGCCA.AATGCCTCA
AAGTTGCCA.TATCACCTG	AAGTTGCCA.TATCACCTG
AATAACTCC.GGACTCCTT	AATAACTCC.GGACTCCTT
AATAACTCC.GTCTGACGT	AATAACTCC.GTCTGACGT
AATAACTCC.TAACACATC	AATAACTCC.TAACACATC
AATAACTCC.TCCTTAGGT	AATAACTCC.TCCTTAGGT
AATAACTCC.TGTCGTACA	AATAACTCC.TGTCGTACA
AATACCTTG.AGGAAGGTG	AATACCTTG.AGGAAGGTG
AATACCTTG.CTTAACAGC	AATACCTTG.CTTAACAGC
AATACCTTG.TCAAGGTCG	AATACCTTG.TCAAGGTCG
AATACGTCT.CACTTCCTT	AATACGTCT.CACTTCCTT
AATACGTCT.GCCTGGAAT	AATACGTCT.GCCTGGAAT
AATACGTCT.GCTCTGTGT	AATACGTCT.GCTCTGTGT
AATACGTCT.TCCGGAGCT	AATACGTCT.TCCGGAGCT
AATACTCCG.GCTAGCTCC	AATACTCCG.GCTAGCTCC
AATACTCCG.TATCTAGGT	AATACTCCG.TATCTAGGT
AATACTCCG.TCTACGCAA	AATACTCCG.TCTACGCAA
AATACTCCG.TTCCTAAGG	AATACTCCG.TTCCTAAGG
AATAGACGC.ATATGTCCA	AATAGACGC.ATATGTCCA
AATAGACGC.ATTAGCACA	AATAGACGC.ATTAGCACA
AATAGACGC.GCGAAGACA	AATAGACGC.GCGAAGACA
AATAGACGC.GTCTACCAA	AATAGACGC.GTCTACCAA
AATATCAGC.ATCCAATGA	AATATCAGC.ATCCAATGA
AATATCAGC.CCTGCTCCA	AATATCAGC.CCTGCTCCA
AATATCAGC.TACCATGTA	AATATCAGC.TACCATGTA
AATATCAGC.TCCGATCTG	AATATCAGC.TCCGATCTG
AATATCAGC.TCCTCGTCG	AATATCAGC.TCCTCGTCG
AATATCGCT.ATCACCGCA	AATATCGCT.ATCACCGCA
AATATCGCT.GCCTTAGAG	AATATCGCT.GCCTTAGAG
AATCAGGAG.ACACAGAAC	AATCAGGAG.ACACAGAAC
AATCAGGAG.ACTTCGCAG	AATCAGGAG.ACTTCGCAG
AATCAGGAG.CAGCCGCAA	AATCAGGAG.CAGCCGCAA
AATCAGGAG.CATGTCCTG	AATCAGGAG.CATGTCCTG
AATCAGGAG.CATTATGTC	AATCAGGAG.CATTATGTC
AATCAGGAG.GACTTGATT	AATCAGGAG.GACTTGATT
AATCAGGAG.TCAATGGAC	AATCAGGAG.TCAATGGAC
AATCAGGAG.TCGCCAAGC	AATCAGGAG.TCGCCAAGC
AATCAGGAG.TGAGCAGAT	AATCAGGAG.TGAGCAGAT
AATCAGGAG.TGCCACCGA	AATCAGGAG.TGCCACCGA
AATCCGCTG.AGCCACTTC	AATCCGCTG.AGCCACTTC
AATCCGCTG.AGTGAACGG	AATCCGCTG.AGTGAACGG
AATCCGCTG.CGCATCTAC	AATCCGCTG.CGCATCTAC
AATCCGCTG.GCTGACAGA	AATCCGCTG.GCTGACAGA
AATCCGCTG.GTATGTATC	AATCCGCTG.GTATGTATC
AATCCTCGT.AAGTAGGAC	AATCCTCGT.AAGTAGGAC
AATCCTCGT.CAATCATAC	AATCCTCGT.CAATCATAC
AATCCTCGT.CGCAATCGA	AATCCTCGT.CGCAATCGA
AATCCTCGT.CTCTCGATA	AATCCTCGT.CTCTCGATA
AATCCTCGT.CTTATCTCA	AATCCTCGT.CTTATCTCA
AATCCTCGT.GCGTGAGCT	AATCCTCGT.GCGTGAGCT
AATCCTCGT.GCTAGCTCC	AATCCTCGT.GCTAGCTCC
AATCCTCGT.GTCCTTCAT	AATCCTCGT.GTCCTTCAT
AATCGCCAT.CCATCACGA	AATCGCCAT.CCATCACGA
AATCGCCAT.GATTGGAAG	AATCGCCAT.GATTGGAAG
AATCGCCAT.GTGTCTGGA	AATCGCCAT.GTGTCTGGA
AATCGTGTT.ATACGAGGT	AATCGTGTT.ATACGAGGT
AATCGTGTT.CCAGTCTCA	AATCGTGTT.CCAGTCTCA
AATCGTGTT.TGCTATGAA	AATCGTGTT.TGCTATGAA
AATCGTGTT.TTAAGTGGT	AATCGTGTT.TTAAGTGGT
AATCTCCTA.ACAGTATTG	AATCTCCTA.ACAGTATTG
AATCTCCTA.GGATTACGC	AATCTCCTA.GGATTACGC
AATCTCCTA.GTACGAACG	AATCTCCTA.GTACGAACG
AATCTCCTA.TCGTTCTCC	AATCTCCTA.TCGTTCTCC
AATCTGACC.ACCGTCACG	AATCTGACC.ACCGTCACG
AATCTGACC.CTATGGATG	AATCTGACC.CTATGGATG
AATCTGACC.GATGCGGTT	AATCTGACC.GATGCGGTT
AATCTGACC.TGCTCACAC	AATCTGACC.TGCTCACAC
AATGAGTCG.ACCGAGTAG	AATGAGTCG.ACCGAGTAG
AATGAGTCG.ATATAGCGT	AATGAGTCG.ATATAGCGT
AATGAGTCG.CGCAACCTC	AATGAGTCG.CGCAACCTC
AATGAGTCG.TGCGTCTTA	AATGAGTCG.TGCGTCTTA
AATGAGTCG.TTAGCGTCT	AATGAGTCG.TTAGCGTCT
AATGCACTT.CAATACCAC	AATGCACTT.CAATACCAC
AATGCACTT.GTCAGCGTC	AATGCACTT.GTCAGCGTC
AATGCACTT.GTGTATCTG	AATGCACTT.GTGTATCTG
AATGCACTT.TTGTATCAC	AATGCACTT.TTGTATCAC
AATGCAGCG.AGTGGAATG	AATGCAGCG.AGTGGAATG
AATGCAGCG.GATAGTTCT	AATGCAGCG.GATAGTTCT
AATGCAGCG.TATAATCGC	AATGCAGCG.TATAATCGC
AATGCAGCG.TCAGAGCGT	AATGCAGCG.TCAGAGCGT
AATGCCTCA.AAGCCAAGT	AATGCCTCA.AAGCCAAGT
AATGCCTCA.AAGCTGAGG	AATGCCTCA.AAGCTGAGG
AATGCCTCA.ACATCGTCC	AATGCCTCA.ACATCGTCC
AATGCCTCA.ATCCAATGA	AATGCCTCA.ATCCAATGA
AATGCCTCA.CTCTGTCAA	AATGCCTCA.CTCTGTCAA
AATGCCTCA.GTGCTCTTG	AATGCCTCA.GTGCTCTTG
AATGCCTCA.GTTGATGCA	AATGCCTCA.GTTGATGCA
AATGCCTCA.TAAGGTCCG	AATGCCTCA.TAAGGTCCG
AATGCGTGC.CGCAACCTC	AATGCGTGC.CGCAACCTC
AATGCGTGC.TAGAGCGTC	AATGCGTGC.TAGAGCGTC
AATGCGTGC.TCCAGCAGC	AATGCGTGC.TCCAGCAGC
AATGCTATC.AGATCTGAC	AATGCTATC.AGATCTGAC
AATGCTATC.AGGAGCAAT	AATGCTATC.AGGAGCAAT
AATGCTATC.TCAATCTAG	AATGCTATC.TCAATCTAG
AATGCTGAT.ACCGGTTAC	AATGCTGAT.ACCGGTTAC
AATGCTGAT.ATCCTGCCT	AATGCTGAT.ATCCTGCCT
AATGCTGAT.ATGCTTCAG	AATGCTGAT.ATGCTTCAG
AATGCTGAT.CCAATATAC	AATGCTGAT.CCAATATAC
AATGCTGAT.TCGTGACGT	AATGCTGAT.TCGTGACGT
AATGTGCGT.AGTTGAGCG	AATGTGCGT.AGTTGAGCG
AATGTGCGT.ATCATGTTC	AATGTGCGT.ATCATGTTC
AATGTGCGT.ATCTCGTGA	AATGTGCGT.ATCTCGTGA
AATGTGCGT.TATCCTCAG	AATGTGCGT.TATCCTCAG
AATGTGCGT.TGTGCCATG	AATGTGCGT.TGTGCCATG
AATTAGAGG.CTGATCCGA	AATTAGAGG.CTGATCCGA
AATTAGAGG.TGCCACCGA	AATTAGAGG.TGCCACCGA
AATTCGGAA.CAAGCGCAT	AATTCGGAA.CAAGCGCAT
AATTCGGAA.CATAGTATG	AATTCGGAA.CATAGTATG
AATTCGGAA.GCGTGAGCT	AATTCGGAA.GCGTGAGCT
AATTGGATC.CTCTAGTAA	AATTGGATC.CTCTAGTAA
AATTGGATC.GAACAACCA	AATTGGATC.GAACAACCA
AATTGGATC.GTGTTGGAA	AATTGGATC.GTGTTGGAA
ACAACCGGA.AGTCGCGAC	ACAACCGGA.AGTCGCGAC
ACAACCGGA.GAACGCTGT	ACAACCGGA.GAACGCTGT
ACAACCGGA.GCAATGAGA	ACAACCGGA.GCAATGAGA
ACAACGAGC.ACGACGATT	ACAACGAGC.ACGACGATT
ACAACGAGC.CACCAAGAT	ACAACGAGC.CACCAAGAT
ACAAGAATG.CTCGCTACG	ACAAGAATG.CTCGCTACG
ACAAGAATG.GATCCGCAC	ACAAGAATG.GATCCGCAC
ACAAGGTAC.GGTAGTGTT	ACAAGGTAC.GGTAGTGTT
ACAAGGTAC.TACCATGTA	ACAAGGTAC.TACCATGTA
ACAAGTACA.AGGAGGTGA	ACAAGTACA.AGGAGGTGA
ACAAGTACA.CATATGCGA	ACAAGTACA.CATATGCGA
ACAAGTACA.CCGAGTACT	ACAAGTACA.CCGAGTACT
ACAAGTACA.GCGCTCTAT	ACAAGTACA.GCGCTCTAT
ACAAGTACA.GGAAGTATG	ACAAGTACA.GGAAGTATG
ACAAGTACA.GTGGTTACC	ACAAGTACA.GTGGTTACC
ACAAGTACA.TACGAGTGA	ACAAGTACA.TACGAGTGA
ACAATAGGT.ACGTGAATC	ACAATAGGT.ACGTGAATC
ACAATAGGT.CCAGTTACG	ACAATAGGT.CCAGTTACG
ACAATAGGT.CCGTAGTTG	ACAATAGGT.CCGTAGTTG
ACAATAGGT.TACTCGACC	ACAATAGGT.TACTCGACC
ACAATTCGG.ACGTGCTCG	ACAATTCGG.ACGTGCTCG
ACAATTCGG.TAATCACGC	ACAATTCGG.TAATCACGC
ACAATTCGG.TGAGCTAGA	ACAATTCGG.TGAGCTAGA
ACACACCGT.AACTCCATG	ACACACCGT.AACTCCATG
ACACACCGT.AGTCCGTGT	ACACACCGT.AGTCCGTGT
ACACACCGT.ATTAGCACA	ACACACCGT.ATTAGCACA
ACACACCGT.CACTTCCTT	ACACACCGT.CACTTCCTT
ACACACCGT.CGAACAATC	ACACACCGT.CGAACAATC
ACACACCGT.CTGAGATAG	ACACACCGT.CTGAGATAG
ACACACGTC.AGTGAACGG	ACACACGTC.AGTGAACGG
ACACACGTC.CACCTCGGA	ACACACGTC.CACCTCGGA
ACACACGTC.CAGCTTCGA	ACACACGTC.CAGCTTCGA
ACACACGTC.CTAGAGTCG	ACACACGTC.CTAGAGTCG
ACACACGTC.GGTAAGGAT	ACACACGTC.GGTAAGGAT
ACACACGTC.GTAGAGAGC	ACACACGTC.GTAGAGAGC
ACACAGAAC.CCAACGGAA	ACACAGAAC.CCAACGGAA
ACACAGAAC.GCGACCTGT	ACACAGAAC.GCGACCTGT
ACACAGAAC.GTTGACCAT	ACACAGAAC.GTTGACCAT
ACACATCTG.TAGTAGTCT	ACACATCTG.TAGTAGTCT
ACACCACAT.AAGCAGCAT	ACACCACAT.AAGCAGCAT
ACACCACAT.GACCGTAGT	ACACCACAT.GACCGTAGT
ACACCACAT.TACTACTGT	ACACCACAT.TACTACTGT
ACACCGCCA.ATGTCCTCC	ACACCGCCA.ATGTCCTCC
ACACCGCCA.CACACCACA	ACACCGCCA.CACACCACA
ACACCGCCA.CCTTGTTGC	ACACCGCCA.CCTTGTTGC
ACACCGCCA.GGTGGAGCT	ACACCGCCA.GGTGGAGCT
ACACCGCCA.TGGTGGATC	ACACCGCCA.TGGTGGATC
ACACCGCCA.TTCTGCCGA	ACACCGCCA.TTCTGCCGA
ACACGTTGC.AGCCTCTAG	ACACGTTGC.AGCCTCTAG
ACACGTTGC.CGCGAGTGT	ACACGTTGC.CGCGAGTGT
ACACGTTGC.TACCTCACT	ACACGTTGC.TACCTCACT
ACACTAACG.CAAGAGGAG	ACACTAACG.CAAGAGGAG
ACACTAACG.CTGTGGTGG	ACACTAACG.CTGTGGTGG
ACACTAACG.GAATTGTTG	ACACTAACG.GAATTGTTG
ACACTAACG.GCCAACAAT	ACACTAACG.GCCAACAAT
ACACTAACG.GGTGAGTTC	ACACTAACG.GGTGAGTTC
ACACTAACG.TAGCACACG	ACACTAACG.TAGCACACG
ACACTGTGA.AACAACCTA	ACACTGTGA.AACAACCTA
ACACTGTGA.ATTGCGCTA	ACACTGTGA.ATTGCGCTA
ACACTGTGA.GACTAGCAT	ACACTGTGA.GACTAGCAT
ACACTGTGA.TGAGGTCTC	ACACTGTGA.TGAGGTCTC
ACAGAAGAG.GATATGGAC	ACAGAAGAG.GATATGGAC
ACAGAAGAG.GCGCTTCTC	ACAGAAGAG.GCGCTTCTC
ACAGAAGAG.GTTAGATTG	ACAGAAGAG.GTTAGATTG
ACAGAAGAG.TCACAGGTA	ACAGAAGAG.TCACAGGTA
ACAGAAGAG.TCACCGAGG	ACAGAAGAG.TCACCGAGG
ACAGAGATG.AACGGTAGC	ACAGAGATG.AACGGTAGC
ACAGAGATG.AGTCGATCA	ACAGAGATG.AGTCGATCA
ACAGAGATG.CGGTAGCTT	ACAGAGATG.CGGTAGCTT
ACAGAGATG.CTAGGTACT	ACAGAGATG.CTAGGTACT
ACAGAGATG.GCTTACTAG	ACAGAGATG.GCTTACTAG
ACAGCATCA.ACACCGCCA	ACAGCATCA.ACACCGCCA
ACAGCATCA.CACCTAGCG	ACAGCATCA.CACCTAGCG
ACAGCATCA.CCTCGAGAG	ACAGCATCA.CCTCGAGAG
ACAGCATCA.CGGAACGAG	ACAGCATCA.CGGAACGAG
ACAGCATCA.CTATAGCTC	ACAGCATCA.CTATAGCTC
ACAGCATCA.GAACCAGTT	ACAGCATCA.GAACCAGTT
ACAGCATCA.GTCTACCAA	ACAGCATCA.GTCTACCAA
ACAGCGGTC.ACCGGAAGG	ACAGCGGTC.ACCGGAAGG
ACAGCGGTC.GCCATTAAG	ACAGCGGTC.GCCATTAAG
ACAGCGTAT.AGCTATATG	ACAGCGTAT.AGCTATATG
ACAGCGTAT.GATGTTACA	ACAGCGTAT.GATGTTACA
ACAGGAACT.GATAACGTC	ACAGGAACT.GATAACGTC
ACAGGAACT.TCACACTGC	ACAGGAACT.TCACACTGC
ACAGGAACT.TCACAGGTA	ACAGGAACT.TCACAGGTA
ACAGGTATC.CAGGAGCCT	ACAGGTATC.CAGGAGCCT
ACAGGTATC.CTGAGTAGC	ACAGGTATC.CTGAGTAGC
ACAGGTATC.GCAATCACG	ACAGGTATC.GCAATCACG
ACAGGTATC.TCCTTAGGT	ACAGGTATC.TCCTTAGGT
ACAGTATTG.ATTGATTGG	ACAGTATTG.ATTGATTGG
ACAGTATTG.CTGCGTCAC	ACAGTATTG.CTGCGTCAC
ACAGTATTG.GCCGCCTAA	ACAGTATTG.GCCGCCTAA
ACAGTATTG.GTAGGACGC	ACAGTATTG.GTAGGACGC
ACAGTATTG.TTAGGAAGG	ACAGTATTG.TTAGGAAGG
ACATCGTCC.AACAGCAGT	ACATCGTCC.AACAGCAGT
ACATCGTCC.AGCTATATG	ACATCGTCC.AGCTATATG
ACATCGTCC.ATCGCCTCT	ACATCGTCC.ATCGCCTCT
ACATCGTCC.CCAACGGAA	ACATCGTCC.CCAACGGAA
ACATCGTCC.CCATAGCCA	ACATCGTCC.CCATAGCCA
ACATCGTCC.GCTACAATG	ACATCGTCC.GCTACAATG
ACATCGTCC.GTAGAGAGC	ACATCGTCC.GTAGAGAGC
ACATCGTCC.TTACTTACG	ACATCGTCC.TTACTTACG
ACATGACTA.ATCTACATC	ACATGACTA.ATCTACATC
ACATGACTA.ATGTCCTCC	ACATGACTA.ATGTCCTCC
ACATGACTA.CGTGCCTAT	ACATGACTA.CGTGCCTAT
ACATGACTA.CTGGACACT	ACATGACTA.CTGGACACT
ACATGACTA.CTTGATCTA	ACATGACTA.CTTGATCTA
ACATGGATT.ACCGACGGT	ACATGGATT.ACCGACGGT
ACATGGATT.CGACGTGAT	ACATGGATT.CGACGTGAT
ACATGGATT.CGTGTATTC	ACATGGATT.CGTGTATTC
ACATGGATT.CTTGCGACC	ACATGGATT.CTTGCGACC
ACATGGATT.TGTCAACCT	ACATGGATT.TGTCAACCT
ACATGGATT.TGTGTAGAG	ACATGGATT.TGTGTAGAG
ACATTCCAC.GGTCGGTCT	ACATTCCAC.GGTCGGTCT
ACATTCCAC.GTCTGACGT	ACATTCCAC.GTCTGACGT
ACCACGCTA.AGAAGCTGC	ACCACGCTA.AGAAGCTGC
ACCACGCTA.CCGTAGTTG	ACCACGCTA.CCGTAGTTG
ACCACGGAT.ATGAGTGTG	ACCACGGAT.ATGAGTGTG
ACCACGGAT.CTACGTTGG	ACCACGGAT.CTACGTTGG
ACCACGGAT.GGTGAGCGT	ACCACGGAT.GGTGAGCGT
ACCACTAGG.CACTTCCTT	ACCACTAGG.CACTTCCTT
ACCACTAGG.CGACCTAGC	ACCACTAGG.CGACCTAGC
ACCAGCGTT.CGGATTCTC	ACCAGCGTT.CGGATTCTC
ACCAGCGTT.CTATCTTGA	ACCAGCGTT.CTATCTTGA
ACCATACTT.ATCATAGAC	ACCATACTT.ATCATAGAC
ACCATACTT.ATGAGATCC	ACCATACTT.ATGAGATCC
ACCATACTT.CAACTCCAG	ACCATACTT.CAACTCCAG
ACCATACTT.CACGGAAGT	ACCATACTT.CACGGAAGT
ACCATACTT.CTACGGTAT	ACCATACTT.CTACGGTAT
ACCATACTT.GATTATGCG	ACCATACTT.GATTATGCG
ACCATACTT.GCATACATG	ACCATACTT.GCATACATG
ACCATACTT.GTTGCATGG	ACCATACTT.GTTGCATGG
ACCATGTCT.ACTTCTAAC	ACCATGTCT.ACTTCTAAC
ACCATTCAC.AGAGGACGT	ACCATTCAC.AGAGGACGT
ACCATTCAC.CTCTGCAAG	ACCATTCAC.CTCTGCAAG
ACCATTCAC.TAACACGAG	ACCATTCAC.TAACACGAG
ACCATTCAC.TCACGCGAC	ACCATTCAC.TCACGCGAC
ACCGACGGT.AACAACCTA	ACCGACGGT.AACAACCTA
ACCGACGGT.ATTAGCACA	ACCGACGGT.ATTAGCACA
ACCGACGGT.CTAGAGTCG	ACCGACGGT.CTAGAGTCG
ACCGACGGT.CTGACGATG	ACCGACGGT.CTGACGATG
ACCGACGGT.GGTCCTAAG	ACCGACGGT.GGTCCTAAG
ACCGACGGT.GTCAATACA	ACCGACGGT.GTCAATACA
ACCGACGGT.TTCCATACC	ACCGACGGT.TTCCATACC
ACCGAGACA.ACCGTACGC	ACCGAGACA.ACCGTACGC
ACCGAGACA.AGTAATCAG	ACCGAGACA.AGTAATCAG
ACCGAGACA.ATATAGCGT	ACCGAGACA.ATATAGCGT
ACCGAGACA.GCTTCTGAA	ACCGAGACA.GCTTCTGAA
ACCGAGTAG.ATCTCGAAC	ACCGAGTAG.ATCTCGAAC
ACCGAGTAG.CGGATTCTC	ACCGAGTAG.CGGATTCTC
ACCGAGTAG.CTATCTTGA	ACCGAGTAG.CTATCTTGA
ACCGAGTAG.CTCGTCTTG	ACCGAGTAG.CTCGTCTTG
ACCGAGTAG.GGAGCATCT	ACCGAGTAG.GGAGCATCT
ACCGAGTAG.TAATGTAGC	ACCGAGTAG.TAATGTAGC
ACCGATCGA.CTGATGCAC	ACCGATCGA.CTGATGCAC
ACCGATCGA.GATCGCGAA	ACCGATCGA.GATCGCGAA
ACCGATCGA.GCAGCTTGA	ACCGATCGA.GCAGCTTGA
ACCGATCGA.GTAGGACGC	ACCGATCGA.GTAGGACGC
ACCGATCGA.TAAGTACAC	ACCGATCGA.TAAGTACAC
ACCGATCGA.TAGTCAGAC	ACCGATCGA.TAGTCAGAC
ACCGCTGTG.TCAAGGTCG	ACCGCTGTG.TCAAGGTCG
ACCGGAGTA.ACGCTAGTG	ACCGGAGTA.ACGCTAGTG
ACCGGAGTA.GTACCTAAC	ACCGGAGTA.GTACCTAAC
ACCGGAGTA.GTGCTCGGA	ACCGGAGTA.GTGCTCGGA
ACCGGTTAC.CTAGGTACT	ACCGGTTAC.CTAGGTACT
ACCGGTTAC.GCATTGATC	ACCGGTTAC.GCATTGATC
ACCGGTTAC.GGTTAACAG	ACCGGTTAC.GGTTAACAG
ACCGGTTAC.GTGGATAAG	ACCGGTTAC.GTGGATAAG
ACCGGTTAC.TCGGTATCA	ACCGGTTAC.TCGGTATCA
ACCGGTTAC.TGAGAGGAC	ACCGGTTAC.TGAGAGGAC
ACCGTCACG.AGCATTCCA	ACCGTCACG.AGCATTCCA
ACCGTCACG.ATCATGTTC	ACCGTCACG.ATCATGTTC
ACCGTCACG.CACATGTGC	ACCGTCACG.CACATGTGC
ACCGTCACG.CGTGAGACT	ACCGTCACG.CGTGAGACT
ACCGTCACG.GTCACAGAG	ACCGTCACG.GTCACAGAG
ACCGTCCTA.AGCCAGGAC	ACCGTCCTA.AGCCAGGAC
