CTCCACGTC.TATCACCTG	CTCCACGTC.TATCACCTG
CTCCAGCGT.CGTCAGCAC	CTCCAGCGT.CGTCAGCAC
CTCCAGCGT.GAATTCAGT	CTCCAGCGT.GAATTCAGT
CTCCGCATT.ACCACGGAT	CTCCGCATT.ACCACGGAT
CTCCGCATT.ACTAAGTTC	CTCCGCATT.ACTAAGTTC
CTCCGCATT.AGACCACGC	CTCCGCATT.AGACCACGC
CTCCGCATT.CTCGTGTCC	CTCCGCATT.CTCGTGTCC
CTCCGCATT.GCGCTACCT	CTCCGCATT.GCGCTACCT
CTCCGCATT.GGACTATTC	CTCCGCATT.GGACTATTC
CTCCGCATT.GGTACGAGC	CTCCGCATT.GGTACGAGC
CTCCTATCT.AGGTATTCC	CTCCTATCT.AGGTATTCC
CTCCTATCT.CATCCACCG	CTCCTATCT.CATCCACCG
CTCCTATCT.GAATTGTTG	CTCCTATCT.GAATTGTTG
CTCCTATCT.GTCCACAAC	CTCCTATCT.GTCCACAAC
CTCCTATCT.TGAGTGACT	CTCCTATCT.TGAGTGACT
CTCCTGACG.AACTTAGCT	CTCCTGACG.AACTTAGCT
CTCCTGACG.CATCTCACG	CTCCTGACG.CATCTCACG
CTCCTGACG.CCATGCGTC	CTCCTGACG.CCATGCGTC
CTCCTGACG.CGATACTCT	CTCCTGACG.CGATACTCT
CTCCTGACG.CGTGTCCGA	CTCCTGACG.CGTGTCCGA
CTCGAACTG.GTTGATGCA	CTCGAACTG.GTTGATGCA
CTCGAACTG.TAGACACGT	CTCGAACTG.TAGACACGT
CTCGAACTG.TCGCCAAGC	CTCGAACTG.TCGCCAAGC
CTCGACGAT.ACTGCTAGT	CTCGACGAT.ACTGCTAGT
CTCGACGAT.CCTTAACAT	CTCGACGAT.CCTTAACAT
CTCGACGAT.GCTTACTAG	CTCGACGAT.GCTTACTAG
CTCGACGAT.GGTGAGTTC	CTCGACGAT.GGTGAGTTC
CTCGACGAT.TCTCGATGC	CTCGACGAT.TCTCGATGC
CTCGACGAT.TGCGATACT	CTCGACGAT.TGCGATACT
CTCGACTGC.CCGAGCTGA	CTCGACTGC.CCGAGCTGA
CTCGACTGC.GTACGAACG	CTCGACTGC.GTACGAACG
CTCGCAAGA.AACGTCGAG	CTCGCAAGA.AACGTCGAG
CTCGCAAGA.AATACGTCT	CTCGCAAGA.AATACGTCT
CTCGCAAGA.AGATACGTT	CTCGCAAGA.AGATACGTT
CTCGCAAGA.AGCTTGGTG	CTCGCAAGA.AGCTTGGTG
CTCGCAAGA.ATCCAGCTG	CTCGCAAGA.ATCCAGCTG
CTCGCAAGA.CGCCACCAT	CTCGCAAGA.CGCCACCAT
CTCGCAAGA.GATACACTA	CTCGCAAGA.GATACACTA
CTCGCAAGA.GTGACTCTC	CTCGCAAGA.GTGACTCTC
CTCGCAAGA.TCTGCGCTG	CTCGCAAGA.TCTGCGCTG
CTCGCAAGA.TGCCTGGTT	CTCGCAAGA.TGCCTGGTT
CTCGCAAGA.TGTCGTACA	CTCGCAAGA.TGTCGTACA
CTCGCTACG.ACGTCGCTC	CTCGCTACG.ACGTCGCTC
CTCGCTACG.CTACTGTCA	CTCGCTACG.CTACTGTCA
CTCGCTACG.GAGTGCATA	CTCGCTACG.GAGTGCATA
CTCGCTACG.TCGTCCGAT	CTCGCTACG.TCGTCCGAT
CTCGTCTTG.ATTGATCAC	CTCGTCTTG.ATTGATCAC
CTCGTCTTG.GCATACATG	CTCGTCTTG.GCATACATG
CTCGTCTTG.TCGGACAGT	CTCGTCTTG.TCGGACAGT
CTCGTCTTG.TGCTTACGG	CTCGTCTTG.TGCTTACGG
CTCGTGTCC.ACCGAGACA	CTCGTGTCC.ACCGAGACA
CTCGTGTCC.GCACATGTT	CTCGTGTCC.GCACATGTT
CTCGTTCAC.GATCTACTT	CTCGTTCAC.GATCTACTT
CTCGTTCAC.GCTGGTTCG	CTCGTTCAC.GCTGGTTCG
CTCGTTCAC.TCACAGGTA	CTCGTTCAC.TCACAGGTA
CTCGTTCAC.TTGCGAACA	CTCGTTCAC.TTGCGAACA
CTCTAAGAG.CCGCAGCTA	CTCTAAGAG.CCGCAGCTA
CTCTAAGAG.CGCCACCAT	CTCTAAGAG.CGCCACCAT
CTCTAAGAG.TAGTACGTA	CTCTAAGAG.TAGTACGTA
CTCTAAGAG.TCAACACTC	CTCTAAGAG.TCAACACTC
CTCTAAGAG.TCGGATGTT	CTCTAAGAG.TCGGATGTT
CTCTACGCA.AGCCTCTAG	CTCTACGCA.AGCCTCTAG
CTCTACGCA.CAACTCCAG	CTCTACGCA.CAACTCCAG
CTCTACGCA.TAACTCCGA	CTCTACGCA.TAACTCCGA
CTCTACGCA.TCAGTGCAA	CTCTACGCA.TCAGTGCAA
CTCTACGCA.TGCTCACAC	CTCTACGCA.TGCTCACAC
CTCTAGTAA.ACCGTCCTA	CTCTAGTAA.ACCGTCCTA
CTCTAGTAA.ACGGTGTAC	CTCTAGTAA.ACGGTGTAC
CTCTAGTAA.CTTATTGAG	CTCTAGTAA.CTTATTGAG
CTCTAGTAA.GCACCATCG	CTCTAGTAA.GCACCATCG
CTCTAGTAA.GCGTATAGG	CTCTAGTAA.GCGTATAGG
CTCTCAGTC.ACTCATTCA	CTCTCAGTC.ACTCATTCA
CTCTCAGTC.ATCGAATCG	CTCTCAGTC.ATCGAATCG
CTCTCAGTC.CCTGTCATT	CTCTCAGTC.CCTGTCATT
CTCTCAGTC.CGATACTCT	CTCTCAGTC.CGATACTCT
CTCTCAGTC.CGTATCGAA	CTCTCAGTC.CGTATCGAA
CTCTCGATA.CATCGCTGG	CTCTCGATA.CATCGCTGG
CTCTGCAAG.GGTCTTGCA	CTCTGCAAG.GGTCTTGCA
CTCTGCAAG.TTACTTACG	CTCTGCAAG.TTACTTACG
CTCTGCGGT.CGGAACGAG	CTCTGCGGT.CGGAACGAG
CTCTGCGGT.TAATCTGGA	CTCTGCGGT.TAATCTGGA
CTCTGCGGT.TACAACACC	CTCTGCGGT.TACAACACC
CTCTGTCAA.CTGCAAGCC	CTCTGTCAA.CTGCAAGCC
CTCTGTCAA.GTGGAGGTC	CTCTGTCAA.GTGGAGGTC
CTCTTCAGC.ATATGTCCA	CTCTTCAGC.ATATGTCCA
CTCTTCAGC.CTATAGCTC	CTCTTCAGC.CTATAGCTC
CTGACAGCA.AGATATGGA	CTGACAGCA.AGATATGGA
CTGACAGCA.ATATGCAGC	CTGACAGCA.ATATGCAGC
CTGACAGCA.CACACTGCC	CTGACAGCA.CACACTGCC
CTGACAGCA.CCGCACTCA	CTGACAGCA.CCGCACTCA
CTGACAGCA.TTCCGAGCG	CTGACAGCA.TTCCGAGCG
CTGACGATG.CTTCTGAGT	CTGACGATG.CTTCTGAGT
CTGACGGAT.CACTGTATC	CTGACGGAT.CACTGTATC
CTGAGATAG.CTCAGCTGG	CTGAGATAG.CTCAGCTGG
CTGAGATAG.CTGGTGACA	CTGAGATAG.CTGGTGACA
CTGAGATAG.GGATAGTCA	CTGAGATAG.GGATAGTCA
CTGAGATAG.TAGCACTAT	CTGAGATAG.TAGCACTAT
CTGAGGTTA.ACAAGGTAC	CTGAGGTTA.ACAAGGTAC
CTGAGGTTA.ATATGTCCA	CTGAGGTTA.ATATGTCCA
CTGAGGTTA.CAACGATCG	CTGAGGTTA.CAACGATCG
CTGAGGTTA.CTGACAGCA	CTGAGGTTA.CTGACAGCA
CTGAGTAGC.AGTATGACG	CTGAGTAGC.AGTATGACG
CTGAGTAGC.CCATAGCCA	CTGAGTAGC.CCATAGCCA
CTGAGTAGC.GGAGACACA	CTGAGTAGC.GGAGACACA
CTGAGTAGC.TCGCTGTAA	CTGAGTAGC.TCGCTGTAA
CTGAGTAGC.TGCTCACAC	CTGAGTAGC.TGCTCACAC
CTGAGTAGC.TTCCTCGGT	CTGAGTAGC.TTCCTCGGT
CTGAGTCCA.GGACTCCTT	CTGAGTCCA.GGACTCCTT
CTGAGTCCA.GTACCACAA	CTGAGTCCA.GTACCACAA
CTGAGTCCA.TAATCACGC	CTGAGTCCA.TAATCACGC
CTGAGTCCA.TCACTACGT	CTGAGTCCA.TCACTACGT
CTGAGTCCA.TCCGGAGCT	CTGAGTCCA.TCCGGAGCT
CTGAGTCCA.TCGTTCTCC	CTGAGTCCA.TCGTTCTCC
CTGAGTCCA.TGTAGGTTA	CTGAGTCCA.TGTAGGTTA
CTGATCAAG.CATCCGACA	CTGATCAAG.CATCCGACA
CTGATCAAG.GCTCTGTGT	CTGATCAAG.GCTCTGTGT
CTGATCAAG.GGATTACGC	CTGATCAAG.GGATTACGC
CTGATCAAG.TCGTAATAG	CTGATCAAG.TCGTAATAG
CTGATCCGA.GCCTGGAAT	CTGATCCGA.GCCTGGAAT
CTGATCCGA.TTCCTGCTA	CTGATCCGA.TTCCTGCTA
CTGATGCAC.ACCGTACGC	CTGATGCAC.ACCGTACGC
CTGATGCAC.CCAGTTACG	CTGATGCAC.CCAGTTACG
CTGATGCAC.GCAACCAAC	CTGATGCAC.GCAACCAAC
CTGATGCAC.TTACTTACG	CTGATGCAC.TTACTTACG
CTGCAAGCC.AATGCGTGC	CTGCAAGCC.AATGCGTGC
CTGCAAGCC.CTTAACAGC	CTGCAAGCC.CTTAACAGC
CTGCAGAGC.CCGATGTTC	CTGCAGAGC.CCGATGTTC
CTGCAGAGC.GTCTTCATA	CTGCAGAGC.GTCTTCATA
CTGCAGAGC.TTGGTAACT	CTGCAGAGC.TTGGTAACT
CTGCATGTT.CAACGATCG	CTGCATGTT.CAACGATCG
CTGCATGTT.CTGATGCAC	CTGCATGTT.CTGATGCAC
CTGCATGTT.CTGGACACT	CTGCATGTT.CTGGACACT
CTGCATGTT.CTTACCTAG	CTGCATGTT.CTTACCTAG
CTGCGATTC.ACCATACTT	CTGCGATTC.ACCATACTT
CTGCGATTC.CTGTCTAGT	CTGCGATTC.CTGTCTAGT
CTGCGATTC.GTTATCGAT	CTGCGATTC.GTTATCGAT
CTGCGTCAC.CCAGTCTCA	CTGCGTCAC.CCAGTCTCA
CTGCGTCAC.CTTAAGTTG	CTGCGTCAC.CTTAAGTTG
CTGCGTCAC.GTAGAAGTT	CTGCGTCAC.GTAGAAGTT
CTGCGTCAC.TAGGTCAAC	CTGCGTCAC.TAGGTCAAC
CTGCGTCAC.TGGAGAGTG	CTGCGTCAC.TGGAGAGTG
CTGCTGCTT.CGCGAGTGT	CTGCTGCTT.CGCGAGTGT
CTGCTGCTT.CGTACACAC	CTGCTGCTT.CGTACACAC
CTGCTTAGG.CACGACTCA	CTGCTTAGG.CACGACTCA
CTGCTTAGG.CACTGCTTA	CTGCTTAGG.CACTGCTTA
CTGCTTAGG.CTGCATGTT	CTGCTTAGG.CTGCATGTT
CTGCTTAGG.GGAAGAAGC	CTGCTTAGG.GGAAGAAGC
CTGCTTAGG.GTTGCTCAG	CTGCTTAGG.GTTGCTCAG
CTGGACACT.CATCTCACG	CTGGACACT.CATCTCACG
CTGGACACT.CCGCAATGG	CTGGACACT.CCGCAATGG
CTGGACACT.GCAACCAAC	CTGGACACT.GCAACCAAC
CTGGACACT.GTCGTTAGA	CTGGACACT.GTCGTTAGA
CTGGACACT.GTGTTGGAA	CTGGACACT.GTGTTGGAA
CTGGACACT.GTTGACCAT	CTGGACACT.GTTGACCAT
CTGGACTAA.CACCTAGCG	CTGGACTAA.CACCTAGCG
CTGGACTAA.CCATAGCCA	CTGGACTAA.CCATAGCCA
CTGGACTAA.CGCACTGAA	CTGGACTAA.CGCACTGAA
CTGGACTAA.CTAGTATAG	CTGGACTAA.CTAGTATAG
CTGGAGCGA.AGTCTGGAA	CTGGAGCGA.AGTCTGGAA
CTGGAGCGA.CGTGTGTGG	CTGGAGCGA.CGTGTGTGG
CTGGAGCGA.GCCGCCTAA	CTGGAGCGA.GCCGCCTAA
CTGGAGCGA.GGAGCATCT	CTGGAGCGA.GGAGCATCT
CTGGTAATC.ACCACTAGG	CTGGTAATC.ACCACTAGG
CTGGTAATC.ACGAGAGCA	CTGGTAATC.ACGAGAGCA
CTGGTAATC.ATCAGGATG	CTGGTAATC.ATCAGGATG
CTGGTAATC.CGGAAGACG	CTGGTAATC.CGGAAGACG
CTGGTAATC.CGTACATCT	CTGGTAATC.CGTACATCT
CTGGTAATC.CTTCCGTGG	CTGGTAATC.CTTCCGTGG
CTGGTAATC.GAGATGTAT	CTGGTAATC.GAGATGTAT
CTGGTAATC.GTCGCAGGT	CTGGTAATC.GTCGCAGGT
CTGGTAATC.TGCAGTCGG	CTGGTAATC.TGCAGTCGG
CTGGTACAT.AACACACTC	CTGGTACAT.AACACACTC
CTGGTACAT.ATGCCTGTC	CTGGTACAT.ATGCCTGTC
CTGGTACAT.CACCTTCCT	CTGGTACAT.CACCTTCCT
CTGGTACAT.GCTTGGTTC	CTGGTACAT.GCTTGGTTC
CTGGTACAT.GGTCCTAAG	CTGGTACAT.GGTCCTAAG
CTGGTACAT.GTGCTGACT	CTGGTACAT.GTGCTGACT
CTGGTACAT.TGTTGTCGA	CTGGTACAT.TGTTGTCGA
CTGGTCGGT.AAGGAACAG	CTGGTCGGT.AAGGAACAG
CTGGTCGGT.ATAGAGCAG	CTGGTCGGT.ATAGAGCAG
CTGGTCGGT.CCATAAGTA	CTGGTCGGT.CCATAAGTA
CTGGTCGGT.CCGGATTGC	CTGGTCGGT.CCGGATTGC
CTGGTCGGT.CGGTGAGTC	CTGGTCGGT.CGGTGAGTC
CTGGTCGGT.GCTGGTAAC	CTGGTCGGT.GCTGGTAAC
CTGGTCGGT.GTAGTTGGT	CTGGTCGGT.GTAGTTGGT
CTGGTCGGT.TGGTGGTAA	CTGGTCGGT.TGGTGGTAA
CTGGTGACA.AGGTGCGAG	CTGGTGACA.AGGTGCGAG
CTGGTGACA.CACAACCAG	CTGGTGACA.CACAACCAG
CTGGTGACA.CTCCTGACG	CTGGTGACA.CTCCTGACG
CTGGTGACA.TGTCGTGAG	CTGGTGACA.TGTCGTGAG
CTGTACGAC.ACAAGGTAC	CTGTACGAC.ACAAGGTAC
CTGTACGAC.CGATACTCT	CTGTACGAC.CGATACTCT
CTGTACGAC.CGTCTGTCC	CTGTACGAC.CGTCTGTCC
CTGTACGAC.GTACGAACG	CTGTACGAC.GTACGAACG
CTGTAGAAG.ATCCGACCA	CTGTAGAAG.ATCCGACCA
CTGTAGAAG.CCTCTCTAG	CTGTAGAAG.CCTCTCTAG
CTGTAGAAG.GATCTGAAT	CTGTAGAAG.GATCTGAAT
CTGTAGAAG.GGTGCGTAG	CTGTAGAAG.GGTGCGTAG
CTGTAGAAG.TCGCTGATT	CTGTAGAAG.TCGCTGATT
CTGTAGAAG.TGAGTGACT	CTGTAGAAG.TGAGTGACT
CTGTCACTT.ATATCAGCC	CTGTCACTT.ATATCAGCC
CTGTCACTT.CCAAGTCGA	CTGTCACTT.CCAAGTCGA
CTGTCACTT.CTACTGTCA	CTGTCACTT.CTACTGTCA
CTGTCACTT.GGTGCGTAG	CTGTCACTT.GGTGCGTAG
CTGTCACTT.TCCAGCAGC	CTGTCACTT.TCCAGCAGC
CTGTCTAGT.ATCAGAAGC	CTGTCTAGT.ATCAGAAGC
CTGTCTAGT.CAAGAACCG	CTGTCTAGT.CAAGAACCG
CTGTGCTCA.ACCGGAGTA	CTGTGCTCA.ACCGGAGTA
CTGTGCTCA.ATATGCAGC	CTGTGCTCA.ATATGCAGC
CTGTGCTCA.GACGTTCAG	CTGTGCTCA.GACGTTCAG
CTGTGCTCA.GTTGCATGG	CTGTGCTCA.GTTGCATGG
CTGTGGTGG.CCAACAACA	CTGTGGTGG.CCAACAACA
CTGTGGTGG.CCGGTTGAG	CTGTGGTGG.CCGGTTGAG
CTGTGGTGG.CGCATCTAC	CTGTGGTGG.CGCATCTAC
CTGTGGTGG.TAGCCAGTG	CTGTGGTGG.TAGCCAGTG
CTGTGGTGG.TAGTCGCAT	CTGTGGTGG.TAGTCGCAT
CTGTGGTGG.TCTTAGCGA	CTGTGGTGG.TCTTAGCGA
CTGTGGTGG.TGGAACTAA	CTGTGGTGG.TGGAACTAA
CTGTTACCA.AAGCAACTA	CTGTTACCA.AAGCAACTA
CTGTTACCA.TAACTCCGA	CTGTTACCA.TAACTCCGA
CTGTTACCA.TAAGGTCCG	CTGTTACCA.TAAGGTCCG
CTGTTACCA.TTCCTAAGG	CTGTTACCA.TTCCTAAGG
CTTAACAGC.CTCGTTCAC	CTTAACAGC.CTCGTTCAC
CTTAACAGC.CTGATGCAC	CTTAACAGC.CTGATGCAC
CTTAACAGC.TGATGACAG	CTTAACAGC.TGATGACAG
CTTAAGTTG.ACGCTATGT	CTTAAGTTG.ACGCTATGT
CTTAAGTTG.AGAAGTCCT	CTTAAGTTG.AGAAGTCCT
CTTAAGTTG.CATACGCAG	CTTAAGTTG.CATACGCAG
CTTAAGTTG.CCATGATGT	CTTAAGTTG.CCATGATGT
CTTAATCGT.TAGTCAGAC	CTTAATCGT.TAGTCAGAC
CTTAATCGT.TATACGGAT	CTTAATCGT.TATACGGAT
CTTAATCGT.TGATTGCTG	CTTAATCGT.TGATTGCTG
CTTACATGC.TAAGCCATT	CTTACATGC.TAAGCCATT
CTTACCTAG.ACACTAACG	CTTACCTAG.ACACTAACG
CTTACCTAG.ACTCGCTGT	CTTACCTAG.ACTCGCTGT
CTTAGAAGG.ATGTCGCCT	CTTAGAAGG.ATGTCGCCT
CTTAGAAGG.CCAATGCCT	CTTAGAAGG.CCAATGCCT
CTTAGAAGG.CTCGCTACG	CTTAGAAGG.CTCGCTACG
CTTAGGACT.AACACACTC	CTTAGGACT.AACACACTC
CTTAGGACT.CATCGAAGC	CTTAGGACT.CATCGAAGC
CTTAGGACT.GGTAATCTA	CTTAGGACT.GGTAATCTA
CTTATCTCA.GCAACTCGC	CTTATCTCA.GCAACTCGC
CTTATCTCA.TAGATAGCC	CTTATCTCA.TAGATAGCC
CTTATCTCA.TCCAGAACG	CTTATCTCA.TCCAGAACG
CTTATTGAG.AGATCTTCA	CTTATTGAG.AGATCTTCA
CTTATTGAG.AGCTGCACT	CTTATTGAG.AGCTGCACT
CTTATTGAG.CAAGCTGCA	CTTATTGAG.CAAGCTGCA
CTTATTGAG.CTGACAGCA	CTTATTGAG.CTGACAGCA
CTTATTGAG.GCCGTTGTT	CTTATTGAG.GCCGTTGTT
CTTATTGAG.TAACATTGG	CTTATTGAG.TAACATTGG
CTTATTGAG.TATCGGAAC	CTTATTGAG.TATCGGAAC
CTTCACTGT.CCATGCGTC	CTTCACTGT.CCATGCGTC
CTTCACTGT.CTGAGTAGC	CTTCACTGT.CTGAGTAGC
CTTCCGGTA.ACAGCATCA	CTTCCGGTA.ACAGCATCA
CTTCCGGTA.AGCACCGTG	CTTCCGGTA.AGCACCGTG
CTTCCGGTA.AGTCGCCGA	CTTCCGGTA.AGTCGCCGA
CTTCCGGTA.CGGTCGACA	CTTCCGGTA.CGGTCGACA
CTTCCGGTA.CTAACTAAG	CTTCCGGTA.CTAACTAAG
CTTCCGGTA.GAATAAGAG	CTTCCGGTA.GAATAAGAG
CTTCCGGTA.GGATTCGTC	CTTCCGGTA.GGATTCGTC
CTTCCGGTA.TTGCCGTAG	CTTCCGGTA.TTGCCGTAG
CTTCCGTGG.AAGCCACAC	CTTCCGTGG.AAGCCACAC
CTTCCGTGG.AAGGTGCTG	CTTCCGTGG.AAGGTGCTG
CTTCCGTGG.ATCGGTGGT	CTTCCGTGG.ATCGGTGGT
CTTCCGTGG.ATTGCGCTA	CTTCCGTGG.ATTGCGCTA
CTTCCGTGG.CCGATCAGC	CTTCCGTGG.CCGATCAGC
CTTCCGTGG.CTGGACTAA	CTTCCGTGG.CTGGACTAA
CTTCCGTGG.GAGGTGAGC	CTTCCGTGG.GAGGTGAGC
CTTCCGTGG.TCCGATAAC	CTTCCGTGG.TCCGATAAC
CTTCCGTGG.TGCCGCTAC	CTTCCGTGG.TGCCGCTAC
CTTCCTGAT.ACCGTCACG	CTTCCTGAT.ACCGTCACG
CTTCCTGAT.CCATGATGT	CTTCCTGAT.CCATGATGT
CTTCCTGAT.GAGTCTTCG	CTTCCTGAT.GAGTCTTCG
CTTCCTGAT.GCCTAACGG	CTTCCTGAT.GCCTAACGG
CTTCCTGAT.GGTCCTAAG	CTTCCTGAT.GGTCCTAAG
CTTCCTGAT.TAGCGCAGC	CTTCCTGAT.TAGCGCAGC
CTTCCTGAT.TGATACCGT	CTTCCTGAT.TGATACCGT
CTTCGACTG.AGTAAGCCA	CTTCGACTG.AGTAAGCCA
CTTCGACTG.TAATCTGGA	CTTCGACTG.TAATCTGGA
CTTCGACTG.TGACAAGTT	CTTCGACTG.TGACAAGTT
CTTCGTGCA.ATCTCTGCT	CTTCGTGCA.ATCTCTGCT
CTTCGTGCA.GCAACTCGC	CTTCGTGCA.GCAACTCGC
CTTCTATGA.TTGATGCTG	CTTCTATGA.TTGATGCTG
CTTCTGAGT.AGCATTCCA	CTTCTGAGT.AGCATTCCA
CTTCTGAGT.ATATAGCGT	CTTCTGAGT.ATATAGCGT
CTTCTGAGT.CATGACGTT	CTTCTGAGT.CATGACGTT
CTTCTGAGT.CGACCACTT	CTTCTGAGT.CGACCACTT
CTTCTGAGT.GTGCTGACT	CTTCTGAGT.GTGCTGACT
CTTCTGAGT.TACGAACTC	CTTCTGAGT.TACGAACTC
CTTCTGAGT.TATCGAGCC	CTTCTGAGT.TATCGAGCC
CTTGATCTA.AACAACCTA	CTTGATCTA.AACAACCTA
CTTGATCTA.CGACCTAGC	CTTGATCTA.CGACCTAGC
CTTGATCTA.TCCTTCGTA	CTTGATCTA.TCCTTCGTA
CTTGATCTA.TGGTGCCTG	CTTGATCTA.TGGTGCCTG
CTTGATCTA.TGTGTCTAC	CTTGATCTA.TGTGTCTAC
CTTGCACAA.AGTTACAAG	CTTGCACAA.AGTTACAAG
CTTGCACAA.ATTAGCACA	CTTGCACAA.ATTAGCACA
CTTGCACAA.GTACGAACG	CTTGCACAA.GTACGAACG
CTTGCACAA.TCTAATACC	CTTGCACAA.TCTAATACC
CTTGCACAA.TGGTGGTAA	CTTGCACAA.TGGTGGTAA
CTTGGATCA.AAGCTGGTC	CTTGGATCA.AAGCTGGTC
CTTGGATCA.ACCGTACGC	CTTGGATCA.ACCGTACGC
CTTGGATCA.CCTGACCTC	CTTGGATCA.CCTGACCTC
CTTGGATCA.GGACAGATT	CTTGGATCA.GGACAGATT
CTTGGATCA.GGTGATAGG	CTTGGATCA.GGTGATAGG
CTTGGTCAT.CTACGAGAA	CTTGGTCAT.CTACGAGAA
CTTGGTCAT.TCAGCTCAG	CTTGGTCAT.TCAGCTCAG
CTTGTAACG.AACTAACTG	CTTGTAACG.AACTAACTG
CTTGTAACG.CAGCTCTTC	CTTGTAACG.CAGCTCTTC
CTTGTAACG.GATCTGAAT	CTTGTAACG.GATCTGAAT
CTTGTAACG.TATCGGAAC	CTTGTAACG.TATCGGAAC
GAACAACCA.ACATTGACA	GAACAACCA.ACATTGACA
GAACAACCA.ATCATAGAC	GAACAACCA.ATCATAGAC
GAACAACCA.CCTGCGTTA	GAACAACCA.CCTGCGTTA
GAACAACCA.TGAGACAGC	GAACAACCA.TGAGACAGC
GAACATGAC.ACTCTAGGA	GAACATGAC.ACTCTAGGA
GAACATGAC.ATATAGCGT	GAACATGAC.ATATAGCGT
GAACCAGTT.ATAGTCTCC	GAACCAGTT.ATAGTCTCC
GAACCAGTT.GTAGTTGGT	GAACCAGTT.GTAGTTGGT
GAACCTTCA.ACCATTCAC	GAACCTTCA.ACCATTCAC
GAACCTTCA.CCATATGCC	GAACCTTCA.CCATATGCC
GAACCTTCA.TCCTGTGGA	GAACCTTCA.TCCTGTGGA
GAACCTTCA.TCTAGTGAC	GAACCTTCA.TCTAGTGAC
GAACGCTGT.ACATTCCAC	GAACGCTGT.ACATTCCAC
GAACGCTGT.GAACTCGTA	GAACGCTGT.GAACTCGTA
GAACGCTGT.GTCAGCGTC	GAACGCTGT.GTCAGCGTC
GAACGCTGT.TGCTATGAA	GAACGCTGT.TGCTATGAA
GAACTATGG.AATACCTTG	GAACTATGG.AATACCTTG
GAACTCGTA.CAACCGGTC	GAACTCGTA.CAACCGGTC
GAACTCGTA.CATCCTCTC	GAACTCGTA.CATCCTCTC
GAACTCGTA.CTCGACGAT	GAACTCGTA.CTCGACGAT
GAACTCGTA.TGCAACTCT	GAACTCGTA.TGCAACTCT
GAACTGCAA.AACTGCGAC	GAACTGCAA.AACTGCGAC
GAACTGCAA.AGATATGGA	GAACTGCAA.AGATATGGA
GAACTGCAA.AGTGACGAT	GAACTGCAA.AGTGACGAT
GAAGAGCAC.AGTCTAAGC	GAAGAGCAC.AGTCTAAGC
GAAGAGCAC.ATAATGTGG	GAAGAGCAC.ATAATGTGG
GAAGAGCAC.ATGCTGTCG	GAAGAGCAC.ATGCTGTCG
GAAGAGCAC.GATGCAGAA	GAAGAGCAC.GATGCAGAA
GAAGAGCAC.TCAGAGCGT	GAAGAGCAC.TCAGAGCGT
GAAGAGCAC.TGCATCGGA	GAAGAGCAC.TGCATCGGA
GAAGGATCA.GACCGTAGT	GAAGGATCA.GACCGTAGT
GAAGTGTGA.GCTGAGCAG	GAAGTGTGA.GCTGAGCAG
GAAGTGTGA.GGATTACGC	GAAGTGTGA.GGATTACGC
GAAGTGTGA.GGTCGGATA	GAAGTGTGA.GGTCGGATA
GAAGTGTGA.GTACGAACG	GAAGTGTGA.GTACGAACG
GAAGTGTGA.GTTGCTCAG	GAAGTGTGA.GTTGCTCAG
GAAGTGTGA.TGACGATGA	GAAGTGTGA.TGACGATGA
GAAGTGTGA.TTGCCAGAT	GAAGTGTGA.TTGCCAGAT
GAATAAGAG.GAGAATCAG	GAATAAGAG.GAGAATCAG
GAATAAGAG.GCTACCGAG	GAATAAGAG.GCTACCGAG
GAATAAGAG.TCATGCTCA	GAATAAGAG.TCATGCTCA
GAATAAGAG.TCGTGCCAC	GAATAAGAG.TCGTGCCAC
GAATCAACC.ACTGGACCA	GAATCAACC.ACTGGACCA
GAATCAACC.TAATTCGTG	GAATCAACC.TAATTCGTG
GAATCAACC.TCTTAAGTG	GAATCAACC.TCTTAAGTG
GAATCACAT.CTGCAGAGC	GAATCACAT.CTGCAGAGC
GAATCACAT.TACAGGACT	GAATCACAT.TACAGGACT
GAATCGAGA.ACGCAAGAT	GAATCGAGA.ACGCAAGAT
GAATCGAGA.CGAGCCGTT	GAATCGAGA.CGAGCCGTT
GAATCGAGA.CGCTGTAGT	GAATCGAGA.CGCTGTAGT
GAATCGAGA.CTCGTCTTG	GAATCGAGA.CTCGTCTTG
GAATCGAGA.GATACTGTG	GAATCGAGA.GATACTGTG
GAATCGAGA.TATTGACTG	GAATCGAGA.TATTGACTG
GAATCGAGA.TCCAATCAT	GAATCGAGA.TCCAATCAT
GAATCGAGA.TCCGATAAC	GAATCGAGA.TCCGATAAC
GAATTCAGT.AGCACCAGC	GAATTCAGT.AGCACCAGC
GAATTCAGT.GCCTAACGG	GAATTCAGT.GCCTAACGG
GAATTCAGT.TAATTCGTG	GAATTCAGT.TAATTCGTG
GAATTCAGT.TGGAAGATT	GAATTCAGT.TGGAAGATT
GAATTGTTG.AAGCCAAGT	GAATTGTTG.AAGCCAAGT
GAATTGTTG.ACAGCGGTC	GAATTGTTG.ACAGCGGTC
GAATTGTTG.TCAGGACTG	GAATTGTTG.TCAGGACTG
GACAATGTT.CCATACGAT	GACAATGTT.CCATACGAT
GACAATGTT.GTCCGCTCA	GACAATGTT.GTCCGCTCA
GACAATGTT.GTTATCGAT	GACAATGTT.GTTATCGAT
GACAATGTT.TAACACATC	GACAATGTT.TAACACATC
GACACCGAT.CCGATCAGC	GACACCGAT.CCGATCAGC
GACACCGAT.GGACTCCTT	GACACCGAT.GGACTCCTT
GACACCGAT.TCAAGGAGT	GACACCGAT.TCAAGGAGT
GACACGCAA.AATTAGAGG	GACACGCAA.AATTAGAGG
GACACGCAA.CTCGACGAT	GACACGCAA.CTCGACGAT
GACACGCAA.GACAATGTT	GACACGCAA.GACAATGTT
GACACGCAA.TAAGGTCCG	GACACGCAA.TAAGGTCCG
GACAGGTTA.GGAAGGTAT	GACAGGTTA.GGAAGGTAT
GACAGGTTA.TAAGGTCCG	GACAGGTTA.TAAGGTCCG
GACAGGTTA.TACCGATTG	GACAGGTTA.TACCGATTG
GACATAACG.CGTTACACC	GACATAACG.CGTTACACC
GACATAACG.GTAACAGTC	GACATAACG.GTAACAGTC
GACATATGT.AGTACTCTC	GACATATGT.AGTACTCTC
GACATATGT.AGTTACAAG	GACATATGT.AGTTACAAG
GACATATGT.CCAAGCGAG	GACATATGT.CCAAGCGAG
GACATATGT.CGCCACCAT	GACATATGT.CGCCACCAT
GACCAACAG.AAGCTTGCA	GACCAACAG.AAGCTTGCA
GACCACTCG.AGATGTTGG	GACCACTCG.AGATGTTGG
GACCACTCG.CTGCTGCTT	GACCACTCG.CTGCTGCTT
GACCAGAGA.GAGTCCAAT	GACCAGAGA.GAGTCCAAT
GACCGCTTC.AATGCAGCG	GACCGCTTC.AATGCAGCG
GACCGCTTC.ACATTCCAC	GACCGCTTC.ACATTCCAC
GACCGCTTC.ACTCACGAA	GACCGCTTC.ACTCACGAA
GACCGCTTC.CTGTACGAC	GACCGCTTC.CTGTACGAC
GACCGCTTC.GAATTGTTG	GACCGCTTC.GAATTGTTG
GACCGCTTC.GCAGCTCTT	GACCGCTTC.GCAGCTCTT
GACCGCTTC.TCCACCGGT	GACCGCTTC.TCCACCGGT
GACCGCTTC.TTCAGTGCC	GACCGCTTC.TTCAGTGCC
GACCGGTAG.ATGATAGCT	GACCGGTAG.ATGATAGCT
GACCGGTAG.CCACGAAGG	GACCGGTAG.CCACGAAGG
GACCGGTAG.CTCTTCAGC	GACCGGTAG.CTCTTCAGC
GACCGGTAG.GCAACCAAC	GACCGGTAG.GCAACCAAC
GACCGTAGT.AGCAAGTCC	GACCGTAGT.AGCAAGTCC
GACCGTAGT.AGCGCATGA	GACCGTAGT.AGCGCATGA
GACCGTAGT.CAATCAAGT	GACCGTAGT.CAATCAAGT
GACCGTAGT.CGGTGTTAC	GACCGTAGT.CGGTGTTAC
GACCTTGTG.CAAGCCTCG	GACCTTGTG.CAAGCCTCG
GACCTTGTG.CCTAGAGTA	GACCTTGTG.CCTAGAGTA
GACGCCGTA.CCTGCTCCA	GACGCCGTA.CCTGCTCCA
GACGCTTGC.AATCCGCTG	GACGCTTGC.AATCCGCTG
GACGCTTGC.ATCAGAAGC	GACGCTTGC.ATCAGAAGC
GACGCTTGC.CGCAGTGTC	GACGCTTGC.CGCAGTGTC
GACGCTTGC.CTCGTGTCC	GACGCTTGC.CTCGTGTCC
GACGCTTGC.GCGATATGA	GACGCTTGC.GCGATATGA
GACGCTTGC.GGATGCTCG	GACGCTTGC.GGATGCTCG
GACGCTTGC.TCGTACCTT	GACGCTTGC.TCGTACCTT
GACGGACTA.ATCGTAGTG	GACGGACTA.ATCGTAGTG
GACGGACTA.CCGCTATCC	GACGGACTA.CCGCTATCC
GACGGACTA.CGGAGACTT	GACGGACTA.CGGAGACTT
GACGGACTA.GCTTGTCCT	GACGGACTA.GCTTGTCCT
GACGGTGCT.ATAAGTTCG	GACGGTGCT.ATAAGTTCG
GACGGTGCT.GATACTGTG	GACGGTGCT.GATACTGTG
GACGGTGCT.GGACAGATT	GACGGTGCT.GGACAGATT
GACGGTGCT.TAGAGCCAG	GACGGTGCT.TAGAGCCAG
GACGGTGCT.TAGTAACGG	GACGGTGCT.TAGTAACGG
GACGTAGCA.ACTCGTAGG	GACGTAGCA.ACTCGTAGG
GACGTAGCA.CCGTAGTTG	GACGTAGCA.CCGTAGTTG
GACGTAGCA.GACCGGTAG	GACGTAGCA.GACCGGTAG
GACGTAGCA.TCATATCGC	GACGTAGCA.TCATATCGC
GACGTAGCA.TGCAACTCT	GACGTAGCA.TGCAACTCT
GACGTCAAT.AGGTGCGAG	GACGTCAAT.AGGTGCGAG
GACGTCAAT.CGCTTCACG	GACGTCAAT.CGCTTCACG
GACGTCAAT.GATACACTA	GACGTCAAT.GATACACTA
GACGTCAAT.TCCAAGTAA	GACGTCAAT.TCCAAGTAA
GACGTGGTC.TAACGGATA	GACGTGGTC.TAACGGATA
GACGTGGTC.TATGACCGA	GACGTGGTC.TATGACCGA
GACGTGGTC.TGATGGACA	GACGTGGTC.TGATGGACA
GACGTTCAG.CTCTCGATA	GACGTTCAG.CTCTCGATA
GACGTTCAG.GCTTGTCCT	GACGTTCAG.GCTTGTCCT
GACGTTCAG.TAGTGATCC	GACGTTCAG.TAGTGATCC
GACTAGCAT.ATTAAGACC	GACTAGCAT.ATTAAGACC
GACTAGCAT.TAGTTGACG	GACTAGCAT.TAGTTGACG
GACTAGCAT.TATACCACT	GACTAGCAT.TATACCACT
GACTAGCAT.TGAGCTAGA	GACTAGCAT.TGAGCTAGA
GACTATTGA.AGTGGAATG	GACTATTGA.AGTGGAATG
GACTCAGTG.AATTCGGAA	GACTCAGTG.AATTCGGAA
GACTCAGTG.CGCATAACT	GACTCAGTG.CGCATAACT
GACTCAGTG.GGTTCTATC	GACTCAGTG.GGTTCTATC
GACTCAGTG.GTACAATGC	GACTCAGTG.GTACAATGC
GACTCAGTG.TACGGTCGT	GACTCAGTG.TACGGTCGT
GACTCTCAC.AACAGATCG	GACTCTCAC.AACAGATCG
GACTCTCAC.AGATGAGAT	GACTCTCAC.AGATGAGAT
GACTCTCAC.ATAGCCTAA	GACTCTCAC.ATAGCCTAA
GACTCTCAC.CCATATCTT	GACTCTCAC.CCATATCTT
GACTCTCAC.GAGCACATT	GACTCTCAC.GAGCACATT
GACTCTCAC.GCGATGGTG	GACTCTCAC.GCGATGGTG
GACTCTCAC.GTACGCGAT	GACTCTCAC.GTACGCGAT
GACTCTCAC.TCACATACT	GACTCTCAC.TCACATACT
GACTCTGGT.AATCTGACC	GACTCTGGT.AATCTGACC
GACTCTGGT.CTCAGTGAT	GACTCTGGT.CTCAGTGAT
GACTCTGGT.CTGACAGCA	GACTCTGGT.CTGACAGCA
GACTCTGGT.TCCTGTGGA	GACTCTGGT.TCCTGTGGA
GACTCTGGT.TGCAGTTCA	GACTCTGGT.TGCAGTTCA
GACTGCCTG.AATATCAGC	GACTGCCTG.AATATCAGC
GACTGCCTG.CCGACTGTT	GACTGCCTG.CCGACTGTT
GACTGCCTG.GTCTGAGCC	GACTGCCTG.GTCTGAGCC
GACTGCCTG.TAGCAGAGT	GACTGCCTG.TAGCAGAGT
GACTGCCTG.TGGATTAGC	GACTGCCTG.TGGATTAGC
GACTGCGCA.AAGCAGCAT	GACTGCGCA.AAGCAGCAT
GACTGCGCA.ATAATGTGG	GACTGCGCA.ATAATGTGG
GACTGCGCA.ATGAACTAG	GACTGCGCA.ATGAACTAG
GACTGCGCA.CCTGCAGAT	GACTGCGCA.CCTGCAGAT
GACTGCGCA.CTTAGAAGG	GACTGCGCA.CTTAGAAGG
GACTGCGCA.GGTGAGCGT	GACTGCGCA.GGTGAGCGT
GACTGCGCA.TCGGAACGA	GACTGCGCA.TCGGAACGA
GACTTCACC.ATGCCTGTC	GACTTCACC.ATGCCTGTC
GACTTCACC.CCTGTATCT	GACTTCACC.CCTGTATCT
GACTTCACC.GCATGTAAG	GACTTCACC.GCATGTAAG
GACTTCACC.TAGCAGAGT	GACTTCACC.TAGCAGAGT
GACTTCACC.TGCATCGGA	GACTTCACC.TGCATCGGA
GACTTGATT.CCACGCCAT	GACTTGATT.CCACGCCAT
GACTTGATT.TCCAATCAT	GACTTGATT.TCCAATCAT
GAGAACAGG.AACAGCAGT	GAGAACAGG.AACAGCAGT
GAGAACAGG.TCTCAGGAT	GAGAACAGG.TCTCAGGAT
GAGAACAGG.TGCTGCGTC	GAGAACAGG.TGCTGCGTC
GAGAATCAG.ACAAGTACA	GAGAATCAG.ACAAGTACA
GAGAATCAG.AGCGGTCTA	GAGAATCAG.AGCGGTCTA
GAGACATTG.CACCAAGAT	GAGACATTG.CACCAAGAT
GAGACATTG.CTGAGTCCA	GAGACATTG.CTGAGTCCA
GAGACATTG.GAACCTTCA	GAGACATTG.GAACCTTCA
GAGACGATC.AAGTACAGA	GAGACGATC.AAGTACAGA
GAGACGATC.CCATAGCCA	GAGACGATC.CCATAGCCA
GAGACGATC.CCGCAACAC	GAGACGATC.CCGCAACAC
