AACAACTGG.CAGTACATC	AACAACTGG.CAGTACATC
AACAACTGG.GGTTCTATC	AACAACTGG.GGTTCTATC
AACCATGGT.CGCGATGTA	AACCATGGT.CGCGATGTA
AACCGTGAG.AGCCACTTC	AACCGTGAG.AGCCACTTC
AACGAGAAT.TGAGAGGAC	AACGAGAAT.TGAGAGGAC
AACGAGGTG.GCGACAACC	AACGAGGTG.GCGACAACC
AACGCATTG.TACAAGAGG	AACGCATTG.TACAAGAGG
AACGGAGAT.ACGACTGCG	AACGGAGAT.ACGACTGCG
AACGGAGAT.CCTACTAGA	AACGGAGAT.CCTACTAGA
AACGGAGAT.GTCCACAAC	AACGGAGAT.GTCCACAAC
AACGTCGAG.ACTATCCTG	AACGTCGAG.ACTATCCTG
AACGTCGAG.GGAGTTAGC	AACGTCGAG.GGAGTTAGC
AACGTTCTT.AGCCACTTC	AACGTTCTT.AGCCACTTC
AACTCCATG.CTCGACGAT	AACTCCATG.CTCGACGAT
AAGACGAAG.TAAGTACAC	AAGACGAAG.TAAGTACAC
AAGCAATCG.ATAGAGCAG	AAGCAATCG.ATAGAGCAG
AAGCATTGC.CCGAATATG	AAGCATTGC.CCGAATATG
AAGCCACAC.ATGCTCACC	AAGCCACAC.ATGCTCACC
AAGCTGAGG.CTCTGCAAG	AAGCTGAGG.CTCTGCAAG
AAGCTGGTC.CCTCGGTCA	AAGCTGGTC.CCTCGGTCA
AAGCTTGCA.ACGACTGCG	AAGCTTGCA.ACGACTGCG
AAGCTTGCA.CTTGATCTA	AAGCTTGCA.CTTGATCTA
AAGGAACAG.CAGGTTGTC	AAGGAACAG.CAGGTTGTC
AAGGAAGTC.GAATAAGAG	AAGGAAGTC.GAATAAGAG
AAGGATACG.CAATGTGCT	AAGGATACG.CAATGTGCT
AAGGTCTGA.ACACATCTG	AAGGTCTGA.ACACATCTG
AAGGTGCTG.CCATATGCC	AAGGTGCTG.CCATATGCC
AATAACTCC.GTTGACGTG	AATAACTCC.GTTGACGTG
AATACCTTG.GTACGCGAT	AATACCTTG.GTACGCGAT
AATACCTTG.TTACTTACG	AATACCTTG.TTACTTACG
AATACGTCT.TGATAGAGG	AATACGTCT.TGATAGAGG
AATACTCCG.CCACATTAG	AATACTCCG.CCACATTAG
AATCAGGAG.CTAGAGTCG	AATCAGGAG.CTAGAGTCG
AATGCACTT.AACAACCTA	AATGCACTT.AACAACCTA
AATGCCTCA.GCGAGCAAG	AATGCCTCA.GCGAGCAAG
AATGCTATC.AAGTTGCCA	AATGCTATC.AAGTTGCCA
AATGCTATC.CCGATACCG	AATGCTATC.CCGATACCG
AATGCTGAT.TCGACGTTG	AATGCTGAT.TCGACGTTG
AATGTGCGT.TAGATAGCC	AATGTGCGT.TAGATAGCC
AATGTGCGT.TCTCAGGAT	AATGTGCGT.TCTCAGGAT
AATTAGAGG.GCTTACGTT	AATTAGAGG.GCTTACGTT
ACAACCGGA.ACCGTCACG	ACAACCGGA.ACCGTCACG
ACAACCGGA.TAAGTGTAG	ACAACCGGA.TAAGTGTAG
ACAAGAATG.TACTAGTAG	ACAAGAATG.TACTAGTAG
ACAAGGTAC.GCCGTGAAC	ACAAGGTAC.GCCGTGAAC
ACACACCGT.CGTCTGTCC	ACACACCGT.CGTCTGTCC
ACACACCGT.TTGTCAACC	ACACACCGT.TTGTCAACC
ACACCACAT.GAATCAACC	ACACCACAT.GAATCAACC
ACACCGCCA.AACGGTAGC	ACACCGCCA.AACGGTAGC
ACACGTTGC.CTTATTGAG	ACACGTTGC.CTTATTGAG
ACACGTTGC.TTCACCTTG	ACACGTTGC.TTCACCTTG
ACACTGTGA.CATGACGTT	ACACTGTGA.CATGACGTT
ACAGAGATG.CAAGTCACT	ACAGAGATG.CAAGTCACT
ACAGGTATC.ATACCGAAG	ACAGGTATC.ATACCGAAG
ACATCGTCC.TCTAGTGAC	ACATCGTCC.TCTAGTGAC
ACCATTCAC.AGTAGAGGA	ACCATTCAC.AGTAGAGGA
ACCGAGACA.TGAACGTCA	ACCGAGACA.TGAACGTCA
ACCGATCGA.CAACCTGGT	ACCGATCGA.CAACCTGGT
ACCGCTGTG.CCGAATATG	ACCGCTGTG.CCGAATATG
ACCGGTTAC.AATAACTCC	ACCGGTTAC.AATAACTCC
ACCGGTTAC.AGCTGCACT	ACCGGTTAC.AGCTGCACT
ACCGGTTAC.GATCTGAAT	ACCGGTTAC.GATCTGAAT
ACCGGTTAC.TGTTGTCGA	ACCGGTTAC.TGTTGTCGA
ACCTAGCAC.TACCTCCTC	ACCTAGCAC.TACCTCCTC
ACCTAGTTA.GGTTGCTAT	ACCTAGTTA.GGTTGCTAT
ACCTTGAAG.TGCATCGGA	ACCTTGAAG.TGCATCGGA
ACGACAGTC.AAGTTCTCT	ACGACAGTC.AAGTTCTCT
ACGATGGAA.TCATCAGAG	ACGATGGAA.TCATCAGAG
ACGCAAGAT.ACAAGTACA	ACGCAAGAT.ACAAGTACA
ACGCAAGAT.TCAAGCGTA	ACGCAAGAT.TCAAGCGTA
ACGCACACT.GTATTACTG	ACGCACACT.GTATTACTG
ACGCGTGAC.ATAAGACAG	ACGCGTGAC.ATAAGACAG
ACGCTATGT.GCTTCACTC	ACGCTATGT.GCTTCACTC
ACGCTATGT.TTAGGAAGG	ACGCTATGT.TTAGGAAGG
ACGCTCTTA.GTAACAGTC	ACGCTCTTA.GTAACAGTC
ACGGACCAT.TGGTTATAC	ACGGACCAT.TGGTTATAC
ACGGTGCCT.ACCGAGTAG	ACGGTGCCT.ACCGAGTAG
ACGGTGTAC.CTGCAGAGC	ACGGTGTAC.CTGCAGAGC
ACGTCGCTC.GTCGTCGAC	ACGTCGCTC.GTCGTCGAC
ACGTCTATG.TACTTCCAG	ACGTCTATG.TACTTCCAG
ACGTGAATC.GCTGATGTC	ACGTGAATC.GCTGATGTC
ACTACCATC.ACCGAGACA	ACTACCATC.ACCGAGACA
ACTACCATC.ACTCATTCA	ACTACCATC.ACTCATTCA
ACTACCATC.CAGTACATC	ACTACCATC.CAGTACATC
ACTACCATC.TATGATGTG	ACTACCATC.TATGATGTG
ACTACTCAT.CCTCCTTGT	ACTACTCAT.CCTCCTTGT
ACTATCCTG.TTCCAGATT	ACTATCCTG.TTCCAGATT
ACTCATTCA.TGGTCCTAG	ACTCATTCA.TGGTCCTAG
ACTCTGCTC.CGCATAACT	ACTCTGCTC.CGCATAACT
ACTGACTAC.CTCGAACTG	ACTGACTAC.CTCGAACTG
ACTGCTAGT.TCCATCATT	ACTGCTAGT.TCCATCATT
ACTGCTAGT.TCTGAGATA	ACTGCTAGT.TCTGAGATA
ACTGGACCA.CAGTCCTAA	ACTGGACCA.CAGTCCTAA
ACTGGACCA.TCTTGGTAG	ACTGGACCA.TCTTGGTAG
ACTGGTGCT.AGTTGTGTA	ACTGGTGCT.AGTTGTGTA
ACTGTAATC.CCATAAGTA	ACTGTAATC.CCATAAGTA
ACTGTGTCA.TCCTTCGTA	ACTGTGTCA.TCCTTCGTA
ACTTAGCTT.AGAGCGGAG	ACTTAGCTT.AGAGCGGAG
ACTTCTAAC.TACAACACC	ACTTCTAAC.TACAACACC
AGAAGAGTC.CTTACCTAG	AGAAGAGTC.CTTACCTAG
AGAAGAGTC.TTCTGAATG	AGAAGAGTC.TTCTGAATG
AGAAGTAAC.CGACGTGAT	AGAAGTAAC.CGACGTGAT
AGAATCAGA.ATGAGGTAT	AGAATCAGA.ATGAGGTAT
AGACATATC.GACGCCGTA	AGACATATC.GACGCCGTA
AGACATCCA.CTCCGCATT	AGACATCCA.CTCCGCATT
AGACCAGCT.AGTAAGCCA	AGACCAGCT.AGTAAGCCA
AGACCAGCT.GCGACACAG	AGACCAGCT.GCGACACAG
AGACGCCTG.CCAGATCAC	AGACGCCTG.CCAGATCAC
AGACGCCTG.CTCAGGTAC	AGACGCCTG.CTCAGGTAC
AGACGCTAT.CCATTCTGC	AGACGCTAT.CCATTCTGC
AGACGGAGG.CAAGCGCAT	AGACGGAGG.CAAGCGCAT
AGACTAGTA.CATCTCGAT	AGACTAGTA.CATCTCGAT
AGACTTCGT.TTGTTAGAG	AGACTTCGT.TTGTTAGAG
AGAGAGTGG.ATGCCTTCA	AGAGAGTGG.ATGCCTTCA
AGAGCCGCA.CCGAGCTGA	AGAGCCGCA.CCGAGCTGA
AGAGCGGAG.GTCCGCTCA	AGAGCGGAG.GTCCGCTCA
AGAGGACGT.CATCTCACG	AGAGGACGT.CATCTCACG
AGATGTTGG.CCTGCAGAT	AGATGTTGG.CCTGCAGAT
AGATGTTGG.GCTGATGTC	AGATGTTGG.GCTGATGTC
AGCAACATT.CGTTCGTAC	AGCAACATT.CGTTCGTAC
AGCAAGTCC.GATTAGACA	AGCAAGTCC.GATTAGACA
AGCACACCT.CCATATCTT	AGCACACCT.CCATATCTT
AGCATATGG.CCGAGTACT	AGCATATGG.CCGAGTACT
AGCATTCCA.ACTTCAGTA	AGCATTCCA.ACTTCAGTA
AGCATTCCA.AGCAGACAA	AGCATTCCA.AGCAGACAA
AGCATTCCA.CATCCAGGA	AGCATTCCA.CATCCAGGA
AGCATTCCA.CGTGTCCGA	AGCATTCCA.CGTGTCCGA
AGCATTCCA.GTAGACTCT	AGCATTCCA.GTAGACTCT
AGCATTGTT.ATGAACTAG	AGCATTGTT.ATGAACTAG
AGCCTCGCA.ACGCAAGAT	AGCCTCGCA.ACGCAAGAT
AGCGGAACA.GTTGCATGG	AGCGGAACA.GTTGCATGG
AGCGGAACA.TCACTCGCT	AGCGGAACA.TCACTCGCT
AGCGGTCTA.TTGGTAACT	AGCGGTCTA.TTGGTAACT
AGCGTAGAA.GATAACGTC	AGCGTAGAA.GATAACGTC
AGCGTCGTC.AGTTCAACC	AGCGTCGTC.AGTTCAACC
AGCGTCGTC.GGATACCTA	AGCGTCGTC.GGATACCTA
AGCTATATG.TAATGTAGC	AGCTATATG.TAATGTAGC
AGCTTCGAT.CCACGTTCT	AGCTTCGAT.CCACGTTCT
AGCTTCGAT.CTATTAAGG	AGCTTCGAT.CTATTAAGG
AGGAAGGTG.TGTCAACCT	AGGAAGGTG.TGTCAACCT
AGGAGGTGA.AGGTCCGTC	AGGAGGTGA.AGGTCCGTC
AGGAGGTGA.CAATGTGCT	AGGAGGTGA.CAATGTGCT
AGGATCATG.TAAGGTCCG	AGGATCATG.TAAGGTCCG
AGGTATTCC.TAGTTGACG	AGGTATTCC.TAGTTGACG
AGTAACGTA.TATACCACT	AGTAACGTA.TATACCACT
AGTAATCAG.AACGTCGAG	AGTAATCAG.AACGTCGAG
AGTAATCAG.AGATGAAGA	AGTAATCAG.AGATGAAGA
AGTAATGGT.AGACATATC	AGTAATGGT.AGACATATC
AGTAATGGT.TGTCTACAC	AGTAATGGT.TGTCTACAC
AGTCAGTTG.TACAGTTAG	AGTCAGTTG.TACAGTTAG
AGTCGCGAC.GGAGAATGA	AGTCGCGAC.GGAGAATGA
AGTCTAAGC.CACGTAGAC	AGTCTAAGC.CACGTAGAC
AGTGAGAGA.ACCGAGACA	AGTGAGAGA.ACCGAGACA
AGTGAGAGA.GGTTGCTAT	AGTGAGAGA.GGTTGCTAT
AGTGGAATG.GTAAGTGAG	AGTGGAATG.GTAAGTGAG
AGTTACAAG.GTTGCATGG	AGTTACAAG.GTTGCATGG
AGTTAGGTC.TTGAGCTCT	AGTTAGGTC.TTGAGCTCT
AGTTGAGCG.TTACAGTGT	AGTTGAGCG.TTACAGTGT
AGTTGTGTA.AGCTACTCA	AGTTGTGTA.AGCTACTCA
AGTTGTGTA.GAACATGAC	AGTTGTGTA.GAACATGAC
ATAACGACA.GGTTAGATG	ATAACGACA.GGTTAGATG
ATACCGAAG.CATTCCGAG	ATACCGAAG.CATTCCGAG
ATACGAGGT.GTGTCGAGC	ATACGAGGT.GTGTCGAGC
ATAGACCGA.AAGCACAAC	ATAGACCGA.AAGCACAAC
ATAGAGCAG.ACCATACTT	ATAGAGCAG.ACCATACTT
ATAGAGCAG.GTGCGAGTA	ATAGAGCAG.GTGCGAGTA
ATAGTCAGT.ATTCGAAGA	ATAGTCAGT.ATTCGAAGA
ATAGTGGTT.CCAGTTACG	ATAGTGGTT.CCAGTTACG
ATAGTGGTT.CGGAAGACG	ATAGTGGTT.CGGAAGACG
ATAGTGGTT.GCGTATAGG	ATAGTGGTT.GCGTATAGG
ATATAGCGT.GTGACTCTC	ATATAGCGT.GTGACTCTC
ATATCAGCC.TTGCTCTGC	ATATCAGCC.TTGCTCTGC
ATATTCGCA.GACGCCGTA	ATATTCGCA.GACGCCGTA
ATCAAGAGA.TGCGTCTTA	ATCAAGAGA.TGCGTCTTA
ATCAAGCAT.GCCTTGTGA	ATCAAGCAT.GCCTTGTGA
ATCACCGCA.GAGCACATT	ATCACCGCA.GAGCACATT
ATCACCGCA.TGCCAGACG	ATCACCGCA.TGCCAGACG
ATCACTTCC.GGATAATAC	ATCACTTCC.GGATAATAC
ATCAGAAGC.ATATGTCCA	ATCAGAAGC.ATATGTCCA
ATCAGAAGC.GACACCGAT	ATCAGAAGC.GACACCGAT
ATCAGAAGC.GCCAATGAA	ATCAGAAGC.GCCAATGAA
ATCATGTTC.GCCTTCCAT	ATCATGTTC.GCCTTCCAT
ATCATTACG.CTGAGATAG	ATCATTACG.CTGAGATAG
ATCCATTAG.AACGCATTG	ATCCATTAG.AACGCATTG
ATCCGACCA.CTTCTCATC	ATCCGACCA.CTTCTCATC
ATCCGGTCC.CTCTCAGTC	ATCCGGTCC.CTCTCAGTC
ATCCGTCTC.TCACTACGT	ATCCGTCTC.TCACTACGT
ATCCTGCCT.GCTACAATG	ATCCTGCCT.GCTACAATG
ATCGAATCG.ACAGGTATC	ATCGAATCG.ACAGGTATC
ATCGCCTCT.GAGTATCGC	ATCGCCTCT.GAGTATCGC
ATCGCCTCT.GCTTACGTT	ATCGCCTCT.GCTTACGTT
ATCGGTGGT.TATCCTCAG	ATCGGTGGT.TATCCTCAG
ATCTACATC.ATATAGCGT	ATCTACATC.ATATAGCGT
ATCTGCGTA.CATCCACCG	ATCTGCGTA.CATCCACCG
ATCTGGTAG.AAGTTCTCT	ATCTGGTAG.AAGTTCTCT
ATCTGGTAG.TTATCCAAG	ATCTGGTAG.TTATCCAAG
ATCTTACAG.TTCTGGTGC	ATCTTACAG.TTCTGGTGC
ATGACACAA.TGACTGAGA	ATGACACAA.TGACTGAGA
ATGATAGCT.ACGAGCTTC	ATGATAGCT.ACGAGCTTC
ATGCAGTTC.CGAGTAGCA	ATGCAGTTC.CGAGTAGCA
ATGCTGTCG.TATGATGTG	ATGCTGTCG.TATGATGTG
ATGCTTCAG.GTGCACGAG	ATGCTTCAG.GTGCACGAG
ATGGTTCGA.GATTCTCGG	ATGGTTCGA.GATTCTCGG
ATGTCCTCC.GGAGTACAG	ATGTCCTCC.GGAGTACAG
ATGTCGCCT.GCGACACAG	ATGTCGCCT.GCGACACAG
ATTAGCACA.CCGGTGGTT	ATTAGCACA.CCGGTGGTT
ATTATGCAG.TGTCATAGC	ATTATGCAG.TGTCATAGC
ATTCGCTTA.GGTCCTGGT	ATTCGCTTA.GGTCCTGGT
ATTGACACG.GTGGTACGG	ATTGACACG.GTGGTACGG
ATTGCCGAC.CGTACATCT	ATTGCCGAC.CGTACATCT
CAACACTCC.GAGAATCAG	CAACACTCC.GAGAATCAG
CAACCGGTC.TCTAGCTGG	CAACCGGTC.TCTAGCTGG
CAACCTGGT.CATCGAAGC	CAACCTGGT.CATCGAAGC
CAACGATCG.ACGCAAGAT	CAACGATCG.ACGCAAGAT
CAACGATCG.TCCTTAGGT	CAACGATCG.TCCTTAGGT
CAACGTCTT.CACAATAAC	CAACGTCTT.CACAATAAC
CAACGTCTT.CTTATTGAG	CAACGTCTT.CTTATTGAG
CAACTCCAG.GTAACAGTC	CAACTCCAG.GTAACAGTC
CAAGGTGTG.TAGACACGT	CAAGGTGTG.TAGACACGT
CAAGTACGA.TCAATGGAC	CAAGTACGA.TCAATGGAC
CAAGTCACT.CGACGTGAT	CAAGTCACT.CGACGTGAT
CAAGTCACT.TATGACCGA	CAAGTCACT.TATGACCGA
CAATACCAC.TTCAACTAC	CAATACCAC.TTCAACTAC
CAATCATAC.GCACAGTAA	CAATCATAC.GCACAGTAA
CAATTGTCT.CATCGAAGC	CAATTGTCT.CATCGAAGC
CACAACGCT.TGACCTCCT	CACAACGCT.TGACCTCCT
CACATGTGC.TGAGACAGC	CACATGTGC.TGAGACAGC
CACCAAGAT.ACGCGACAG	CACCAAGAT.ACGCGACAG
CACCTCAAC.AGCAGACAA	CACCTCAAC.AGCAGACAA
CACCTCGGA.TTCACTCCT	CACCTCGGA.TTCACTCCT
CACCTTCCT.TGCACGATG	CACCTTCCT.TGCACGATG
CACGATAGA.GTAGGACGC	CACGATAGA.GTAGGACGC
CACGTAGAC.CGACCATCA	CACGTAGAC.CGACCATCA
CACTAGACT.CAGCGACGT	CACTAGACT.CAGCGACGT
CACTCACTA.CATATGTCG	CACTCACTA.CATATGTCG
CACTGGTCC.CAGCGTAAG	CACTGGTCC.CAGCGTAAG
CAGAAGTGA.CCACAAGGT	CAGAAGTGA.CCACAAGGT
CAGAAGTGA.CTGTACGAC	CAGAAGTGA.CTGTACGAC
CAGATCATT.GCAGCAGTG	CAGATCATT.GCAGCAGTG
CAGCACGTG.ACCGTCACG	CAGCACGTG.ACCGTCACG
CAGCACGTG.CCTACTAGA	CAGCACGTG.CCTACTAGA
CAGCACGTG.GCTCTGTGT	CAGCACGTG.GCTCTGTGT
CAGCCGCAA.ACCGAGACA	CAGCCGCAA.ACCGAGACA
CAGCTAGTT.CACTCACTA	CAGCTAGTT.CACTCACTA
CAGCTCTTC.CCTGCAGAT	CAGCTCTTC.CCTGCAGAT
CAGCTTACC.CACGATAGA	CAGCTTACC.CACGATAGA
CAGCTTACC.GCATACATG	CAGCTTACC.GCATACATG
CAGCTTCGA.TGTTGTCGA	CAGCTTCGA.TGTTGTCGA
CAGTAATGT.AATCTGACC	CAGTAATGT.AATCTGACC
CAGTAATGT.TGAACTTGC	CAGTAATGT.TGAACTTGC
CAGTGAGGA.AAGCACAAC	CAGTGAGGA.AAGCACAAC
CAGTTACTG.GCATACTCC	CAGTTACTG.GCATACTCC
CAGTTGAGT.TTCCAGATT	CAGTTGAGT.TTCCAGATT
CATAGTATG.ACGATGGAA	CATAGTATG.ACGATGGAA
CATAGTATG.CTCCACGTC	CATAGTATG.CTCCACGTC
CATAGTATG.GCAATGAGA	CATAGTATG.GCAATGAGA
CATCCGACA.ACATCGTCC	CATCCGACA.ACATCGTCC
CATCGAAGC.TGTCAACCT	CATCGAAGC.TGTCAACCT
CATGACGTT.CTGACGATG	CATGACGTT.CTGACGATG
CATGGACTC.CACATGTGC	CATGGACTC.CACATGTGC
CATGGACTC.CGTTCCATT	CATGGACTC.CGTTCCATT
CATGGTCGA.ACAGCATCA	CATGGTCGA.ACAGCATCA
CATTATGTC.CATCCGACA	CATTATGTC.CATCCGACA
CATTCCGAG.CTAGACATG	CATTCCGAG.CTAGACATG
CATTCCGAG.GCGTATAGG	CATTCCGAG.GCGTATAGG
CATTCGAAT.CTTAATCGT	CATTCGAAT.CTTAATCGT
CATTGCAGA.CCGTACGGA	CATTGCAGA.CCGTACGGA
CATTGCAGA.CCTCCTTGT	CATTGCAGA.CCTCCTTGT
CCAAGTCGA.CCGGTTCTA	CCAAGTCGA.CCGGTTCTA
CCACAAGGT.AATAACTCC	CCACAAGGT.AATAACTCC
CCACCATGC.CAGGAGCCT	CCACCATGC.CAGGAGCCT
CCACGAAGG.ATCTCTGCT	CCACGAAGG.ATCTCTGCT
CCACGAAGG.GATTCCTCT	CCACGAAGG.GATTCCTCT
CCACGAAGG.TACCGCGTT	CCACGAAGG.TACCGCGTT
CCACGGATC.GTGTCACAC	CCACGGATC.GTGTCACAC
CCACTGAAG.GGATGCGAA	CCACTGAAG.GGATGCGAA
CCACTTCGC.TATCAGTGC	CCACTTCGC.TATCAGTGC
CCAGATCAC.CAAGGTGTG	CCAGATCAC.CAAGGTGTG
CCAGTACTC.GGATCAGGT	CCAGTACTC.GGATCAGGT
CCAGTCTCA.AATGCTGAT	CCAGTCTCA.AATGCTGAT
CCATAGCCA.AACAGATCG	CCATAGCCA.AACAGATCG
CCATCACGA.TGCGCACTG	CCATCACGA.TGCGCACTG
CCATGATGT.CTCAGTGAT	CCATGATGT.CTCAGTGAT
CCATGCGTC.ACAGCGTAT	CCATGCGTC.ACAGCGTAT
CCATTACAG.ACAAGAATG	CCATTACAG.ACAAGAATG
CCATTACAG.TATGTATGC	CCATTACAG.TATGTATGC
CCGAAGCGT.ATAGCCTAA	CCGAAGCGT.ATAGCCTAA
CCGAAGCGT.TGCCGCTAC	CCGAAGCGT.TGCCGCTAC
CCGACGTCA.TGTAGCAAG	CCGACGTCA.TGTAGCAAG
CCGACTGTT.GCTTGTCCT	CCGACTGTT.GCTTGTCCT
CCGAGCTGA.GTCGACATT	CCGAGCTGA.GTCGACATT
CCGATACCG.GAGCACATT	CCGATACCG.GAGCACATT
CCGATCAGC.AATACCTTG	CCGATCAGC.AATACCTTG
CCGATCAGC.AATATCAGC	CCGATCAGC.AATATCAGC
CCGATCAGC.GTGTACCGT	CCGATCAGC.GTGTACCGT
CCGATCAGC.TAGAGCCAG	CCGATCAGC.TAGAGCCAG
CCGATCTCT.CAGCGTAAG	CCGATCTCT.CAGCGTAAG
CCGATCTCT.GTAGCATAC	CCGATCTCT.GTAGCATAC
CCGCAACAC.ATGTGAGAC	CCGCAACAC.ATGTGAGAC
CCGCAGCTA.ATATCAGCC	CCGCAGCTA.ATATCAGCC
CCGGATTGC.CTTCGTGCA	CCGGATTGC.CTTCGTGCA
CCGTCAGGT.CATCTCACG	CCGTCAGGT.CATCTCACG
CCGTCCACT.CAGCTAGTT	CCGTCCACT.CAGCTAGTT
CCTAGAGTA.CTCTGCGGT	CCTAGAGTA.CTCTGCGGT
CCTCCAATC.CATCGAAGC	CCTCCAATC.CATCGAAGC
CCTCCTTGT.GTCCGTAAG	CCTCCTTGT.GTCCGTAAG
CCTCGCGTT.CTTAACAGC	CCTCGCGTT.CTTAACAGC
CCTCGGTCA.ATCAGGATG	CCTCGGTCA.ATCAGGATG
CCTCGGTCA.GTCTCCAGG	CCTCGGTCA.GTCTCCAGG
CCTCTGCAT.TGCAGCCTT	CCTCTGCAT.TGCAGCCTT
CCTGTCGAC.GACGCTTGC	CCTGTCGAC.GACGCTTGC
CCTGTCGAC.GAGTCTTCG	CCTGTCGAC.GAGTCTTCG
CCTGTCGAC.TCAGTGCAA	CCTGTCGAC.TCAGTGCAA
CCTTCCTCA.TGGATAGGT	CCTTCCTCA.TGGATAGGT
CCTTCGAGC.GTCTTCATA	CCTTCGAGC.GTCTTCATA
CGAAGAGGT.AGTCGCCGA	CGAAGAGGT.AGTCGCCGA
CGAAGAGGT.GTCTCCAGG	CGAAGAGGT.GTCTCCAGG
CGACAGGAA.TCGGATGTT	CGACAGGAA.TCGGATGTT
CGACCACTT.TCAGCGACC	CGACCACTT.TCAGCGACC
CGACCACTT.TTGATGCTG	CGACCACTT.TTGATGCTG
CGACCTGTA.ATAAGTTCG	CGACCTGTA.ATAAGTTCG
CGAGCCGTT.ATGATAGCT	CGAGCCGTT.ATGATAGCT
CGAGCCGTT.TCGATTCAG	CGAGCCGTT.TCGATTCAG
CGAGTAGCA.GACGCCGTA	CGAGTAGCA.GACGCCGTA
CGATCCAGA.TTACTTACG	CGATCCAGA.TTACTTACG
CGCAACCTC.TCGCTTAAC	CGCAACCTC.TCGCTTAAC
CGCACTGAA.CATCGAAGC	CGCACTGAA.CATCGAAGC
CGCAGTGTC.ACACAGAAC	CGCAGTGTC.ACACAGAAC
CGCATCTAC.CAACACTCC	CGCATCTAC.CAACACTCC
CGCATCTAC.TCAAGGTCG	CGCATCTAC.TCAAGGTCG
CGCGAGTGT.AGCCTCTAG	CGCGAGTGT.AGCCTCTAG
CGCGTACTA.CAGTAATGT	CGCGTACTA.CAGTAATGT
CGCTGTAGT.TTCCAGATT	CGCTGTAGT.TTCCAGATT
CGCTTATGA.GAATCACAT	CGCTTATGA.GAATCACAT
CGCTTATGA.TCAATGGAC	CGCTTATGA.TCAATGGAC
CGGAAGACG.GTTATCGAT	CGGAAGACG.GTTATCGAT
CGGAATGCA.TAGGATTAG	CGGAATGCA.TAGGATTAG
CGGACAAGT.AGTGTTCTG	CGGACAAGT.AGTGTTCTG
CGGAGACTT.TGTAGGTTA	CGGAGACTT.TGTAGGTTA
CGGATTCTC.CTGCTTAGG	CGGATTCTC.CTGCTTAGG
CGGTGTTAC.ATTAGCCAC	CGGTGTTAC.ATTAGCCAC
CGGTTCGTA.GGTCTCATG	CGGTTCGTA.GGTCTCATG
CGGTTCTAT.TGCATACAT	CGGTTCTAT.TGCATACAT
CGTCTGTCC.CGAGCCGTT	CGTCTGTCC.CGAGCCGTT
CGTGCCTAT.AGGAAGGTG	CGTGCCTAT.AGGAAGGTG
CGTGCCTAT.CATCTCGAT	CGTGCCTAT.CATCTCGAT
CGTGGTACC.CTGCGTCAC	CGTGGTACC.CTGCGTCAC
CGTGTGTGG.CCATAATCG	CGTGTGTGG.CCATAATCG
CGTGTGTGG.GTATGTATC	CGTGTGTGG.GTATGTATC
CGTTAATGG.ACGACGATT	CGTTAATGG.ACGACGATT
CGTTCGTAC.TGTAGGTTA	CGTTCGTAC.TGTAGGTTA
CTAACACTG.AATACGTCT	CTAACACTG.AATACGTCT
CTAACCGGT.AATCTGACC	CTAACCGGT.AATCTGACC
CTAATACGC.AGGTCACGT	CTAATACGC.AGGTCACGT
CTACGAGAA.GGACAGATT	CTACGAGAA.GGACAGATT
CTACGAGAA.GTCCGCTCA	CTACGAGAA.GTCCGCTCA
CTACGGTAT.CCATATCTT	CTACGGTAT.CCATATCTT
CTAGACATG.ACAGTATTG	CTAGACATG.ACAGTATTG
CTAGACATG.TCGGACAGT	CTAGACATG.TCGGACAGT
CTAGAGTCG.TGCATACAT	CTAGAGTCG.TGCATACAT
CTAGTCGTC.TGTATGTAG	CTAGTCGTC.TGTATGTAG
CTAGTTCCA.ACTATTGTC	CTAGTTCCA.ACTATTGTC
CTATAGCTC.CTGAGGTTA	CTATAGCTC.CTGAGGTTA
CTATCTTGA.TGAAGACCA	CTATCTTGA.TGAAGACCA
CTATGGATG.CCTTGCTTG	CTATGGATG.CCTTGCTTG
CTATTCCGT.ACACAGAAC	CTATTCCGT.ACACAGAAC
CTCAGGTAC.CTGAGTCCA	CTCAGGTAC.CTGAGTCCA
CTCCAGCGT.AATTAGAGG	CTCCAGCGT.AATTAGAGG
CTCCAGCGT.ATAACGACA	CTCCAGCGT.ATAACGACA
CTCCTATCT.GGACACTGG	CTCCTATCT.GGACACTGG
CTCCTATCT.TCATGCAGG	CTCCTATCT.TCATGCAGG
CTCGAACTG.GCACGTAGA	CTCGAACTG.GCACGTAGA
CTCGACGAT.GCTACCGAG	CTCGACGAT.GCTACCGAG
CTCGCAAGA.CATCTCACG	CTCGCAAGA.CATCTCACG
CTCGCAAGA.CTCTCAGTC	CTCGCAAGA.CTCTCAGTC
CTCGTCTTG.CACCTACGC	CTCGTCTTG.CACCTACGC
CTCGTGTCC.AACTTCTGC	CTCGTGTCC.AACTTCTGC
CTCGTGTCC.CTAACTAAG	CTCGTGTCC.CTAACTAAG
CTCGTTCAC.CTTGCGACC	CTCGTTCAC.CTTGCGACC
CTCTAGTAA.TACCTCCTC	CTCTAGTAA.TACCTCCTC
CTCTGCAAG.CCAGTTACG	CTCTGCAAG.CCAGTTACG
CTCTGCGGT.CACCAGAAG	CTCTGCGGT.CACCAGAAG
CTCTGTCAA.TCGCTGATT	CTCTGTCAA.TCGCTGATT
CTGACAGCA.ACTCTGCTC	CTGACAGCA.ACTCTGCTC
CTGACAGCA.CAGGATCAA	CTGACAGCA.CAGGATCAA
CTGACGATG.AAGACTGGT	CTGACGATG.AAGACTGGT
CTGACGATG.CTGCAAGCC	CTGACGATG.CTGCAAGCC
CTGACGATG.TAGTCAGAC	CTGACGATG.TAGTCAGAC
CTGACGGAT.CGGTAGCTT	CTGACGGAT.CGGTAGCTT
CTGAGTAGC.CCGATCTCT	CTGAGTAGC.CCGATCTCT
CTGATCAAG.GCGTAACAA	CTGATCAAG.GCGTAACAA
CTGATGCAC.GAGGTGAGC	CTGATGCAC.GAGGTGAGC
CTGCATGTT.TTAGCGTCT	CTGCATGTT.TTAGCGTCT
CTGCGTCAC.TCTAGGATG	CTGCGTCAC.TCTAGGATG
CTGCTGCTT.ATCCTCCGA	CTGCTGCTT.ATCCTCCGA
CTGCTGCTT.GAATCAACC	CTGCTGCTT.GAATCAACC
CTGCTGCTT.TGTGCCATG	CTGCTGCTT.TGTGCCATG
CTGCTTAGG.GGTAGCATC	CTGCTTAGG.GGTAGCATC
CTGGACACT.GTTATCGAT	CTGGACACT.GTTATCGAT
CTGGACTAA.ACGCAAGAT	CTGGACTAA.ACGCAAGAT
CTGGTAATC.AGCCGTTCT	CTGGTAATC.AGCCGTTCT
CTGGTGACA.CGTATAGCG	CTGGTGACA.CGTATAGCG
CTGTACGAC.ACGACATCT	CTGTACGAC.ACGACATCT
CTGTACGAC.TCATGCAGG	CTGTACGAC.TCATGCAGG
CTGTACGAC.TTCTGCCGA	CTGTACGAC.TTCTGCCGA
CTGTAGAAG.CAAGTACGA	CTGTAGAAG.CAAGTACGA
CTGTTACCA.TGGAACTAA	CTGTTACCA.TGGAACTAA
CTTACCTAG.GCCATCGCT	CTTACCTAG.GCCATCGCT
CTTACCTAG.TAGCCAGTG	CTTACCTAG.TAGCCAGTG
CTTAGAAGG.AGGAATTGG	CTTAGAAGG.AGGAATTGG
CTTCCGTGG.ATGGTTCGA	CTTCCGTGG.ATGGTTCGA
CTTCCGTGG.GTTAGAGAC	CTTCCGTGG.GTTAGAGAC
CTTCGACTG.CATAGTATG	CTTCGACTG.CATAGTATG
CTTCGACTG.CATCCACCG	CTTCGACTG.CATCCACCG
CTTCGTGCA.CCACGAAGG	CTTCGTGCA.CCACGAAGG
CTTCTATGA.CAACCTGGT	CTTCTATGA.CAACCTGGT
CTTCTCATC.GGATACAAT	CTTCTCATC.GGATACAAT
CTTCTGAGT.TCGTACCTT	CTTCTGAGT.TCGTACCTT
CTTGATCTA.CGAGCTTAC	CTTGATCTA.CGAGCTTAC
CTTGCGACC.GAGACGATC	CTTGCGACC.GAGACGATC
CTTGCGACC.GATACCGGA	CTTGCGACC.GATACCGGA
CTTGGATCA.CCAGGAGTT	CTTGGATCA.CCAGGAGTT
GAACCAGTT.TATTCAACG	GAACCAGTT.TATTCAACG
GAACTGCAA.CGGATTCTC	GAACTGCAA.CGGATTCTC
GACACCGAT.GTGGACTGG	GACACCGAT.GTGGACTGG
GACCAGAGA.AGAAGTCCT	GACCAGAGA.AGAAGTCCT
GACCGCTTC.TCAGACAAG	GACCGCTTC.TCAGACAAG
GACCGGTAG.ATAAGACAG	GACCGGTAG.ATAAGACAG
GACCGTAGT.CTATCTTGA	GACCGTAGT.CTATCTTGA
GACCTTGTG.ATCATGTTC	GACCTTGTG.ATCATGTTC
GACGCTTGC.CGTCGTCAA	GACGCTTGC.CGTCGTCAA
GACGGACTA.ATCTGGTAG	GACGGACTA.ATCTGGTAG
GACGGACTA.GCAGGAGAA	GACGGACTA.GCAGGAGAA
GACGTAGCA.CGTCAGCAC	GACGTAGCA.CGTCAGCAC
GACGTCAAT.AGAGGTGAA	GACGTCAAT.AGAGGTGAA
GACGTGGTC.CGGTTCGTA	GACGTGGTC.CGGTTCGTA
GACTCTGGT.TGCACGATG	GACTCTGGT.TGCACGATG
GACTTCACC.GATAGTTCT	GACTTCACC.GATAGTTCT
GACTTGATT.CCATAATCG	GACTTGATT.CCATAATCG
GACTTGATT.TATACCACT	GACTTGATT.TATACCACT
GAGCACATT.ATTCCGTAC	GAGCACATT.ATTCCGTAC
GAGCCATCC.AATGAGTCG	GAGCCATCC.AATGAGTCG
GAGCCGTTA.AGGATCATG	GAGCCGTTA.AGGATCATG
GAGGACTTA.CTGAGGTTA	GAGGACTTA.CTGAGGTTA
GAGTCACCA.ATACAACCG	GAGTCACCA.ATACAACCG
GAGTCCAAT.ATCGGTGGT	GAGTCCAAT.ATCGGTGGT
GAGTCTTCG.CTGCGATTC	GAGTCTTCG.CTGCGATTC
GAGTGCATA.CCTATTGGT	GAGTGCATA.CCTATTGGT
GAGTTAACT.GCACGTAGA	GAGTTAACT.GCACGTAGA
GATAAGCTG.GACTCTCAC	GATAAGCTG.GACTCTCAC
GATACCGGA.ACCATTCAC	GATACCGGA.ACCATTCAC
GATACCGGA.CCGACTGTT	GATACCGGA.CCGACTGTT
GATATATCC.CACCAAGAT	GATATATCC.CACCAAGAT
GATCCGCAC.ATTAGCCAC	GATCCGCAC.ATTAGCCAC
GATCGATAC.CACTTCCTT	GATCGATAC.CACTTCCTT
GATCGCGAA.CATGTGAAC	GATCGCGAA.CATGTGAAC
GATCTGAAT.TATCGAGCC	GATCTGAAT.TATCGAGCC
GATCTGTTC.ACAGAGATG	GATCTGTTC.ACAGAGATG
GATCTTCGC.GTAACCATA	GATCTTCGC.GTAACCATA
GATGCGACG.ATGTCCTCC	GATGCGACG.ATGTCCTCC
GATGTTACA.AATAGACGC	GATGTTACA.AATAGACGC
GATGTTACA.CAGTCCTAA	GATGTTACA.CAGTCCTAA
GATGTTACA.CTAGTCGTC	GATGTTACA.CTAGTCGTC
GATTGGAAG.GGAGCATCT	GATTGGAAG.GGAGCATCT
GCAACCAAC.CCATATGCC	GCAACCAAC.CCATATGCC
GCAACTCGC.TACACGGTC	GCAACTCGC.TACACGGTC
GCACAACTC.AATGCGTGC	GCACAACTC.AATGCGTGC
GCACAGTAA.CTGCTGCTT	GCACAGTAA.CTGCTGCTT
GCACGTAGA.AGCCACTTC	GCACGTAGA.AGCCACTTC
GCACGTAGA.CGGTTCTAT	GCACGTAGA.CGGTTCTAT
GCACTGGAT.CATTGTTCA	GCACTGGAT.CATTGTTCA
GCAGATCCG.CGTACACAC	GCAGATCCG.CGTACACAC
GCAGCAGTG.AGTATGACG	GCAGCAGTG.AGTATGACG
GCAGCGATA.ACCACGGAT	GCAGCGATA.ACCACGGAT
GCAGCGATA.GTCCGTAAG	GCAGCGATA.GTCCGTAAG
GCAGCTTGA.CACGCGTAA	GCAGCTTGA.CACGCGTAA
GCAGCTTGA.TAGAGACTA	GCAGCTTGA.TAGAGACTA
GCAGGAGAA.CATAGGTGT	GCAGGAGAA.CATAGGTGT
GCAGGAGAA.TCTTAAGTG	GCAGGAGAA.TCTTAAGTG
GCATACATG.TAGATCTGT	GCATACATG.TAGATCTGT
GCATGTGGT.ATGGAGAGT	GCATGTGGT.ATGGAGAGT
GCCAACAAT.ATACTTGCT	GCCAACAAT.ATACTTGCT
GCCATTAAG.CGTGTGTGG	GCCATTAAG.CGTGTGTGG
GCCGAGTCT.GTCCTAGTT	GCCGAGTCT.GTCCTAGTT
GCCGAGTCT.GTTCAGAAG	GCCGAGTCT.GTTCAGAAG
GCCGTCTTC.CCGATACCG	GCCGTCTTC.CCGATACCG
GCCTAACGG.AACACACTC	GCCTAACGG.AACACACTC
GCCTAACGG.ACGGTGTAC	GCCTAACGG.ACGGTGTAC
GCCTAACGG.AGAGCGGAG	GCCTAACGG.AGAGCGGAG
GCCTGGAAT.CTAGGTACT	GCCTGGAAT.CTAGGTACT
GCCTTATCT.CGCATAACT	GCCTTATCT.CGCATAACT
GCCTTGTGA.TGATACCGT	GCCTTGTGA.TGATACCGT
GCGAAGACA.ACATTCCAC	GCGAAGACA.ACATTCCAC
GCGACAACC.GACTCAGTG	GCGACAACC.GACTCAGTG
GCGAGCAAG.TGGAGAACC	GCGAGCAAG.TGGAGAACC
GCGAGTCTA.ACGACAGTC	GCGAGTCTA.ACGACAGTC
GCGATATGA.GACGCTTGC	GCGATATGA.GACGCTTGC
GCGATATGA.GATAACGTC	GCGATATGA.GATAACGTC
GCGCATTAC.CTAACTAAG	GCGCATTAC.CTAACTAAG
GCGCATTAC.CTCTTCAGC	GCGCATTAC.CTCTTCAGC
