GCGCATTAC.GAGCAGGAA	GCGCATTAC.GAGCAGGAA
GCGCTCTAT.CCATCTAGG	GCGCTCTAT.CCATCTAGG
GCGCTCTAT.TCCACCGGT	GCGCTCTAT.TCCACCGGT
GCGCTTCTC.CAAGGTGTG	GCGCTTCTC.CAAGGTGTG
GCGGTAAGT.CCAATATAC	GCGGTAAGT.CCAATATAC
GCGTATAGG.CCTCCTTGT	GCGTATAGG.CCTCCTTGT
GCGTGAGCT.GATTAGTGT	GCGTGAGCT.GATTAGTGT
GCGTTCAGA.AGTTGCCTT	GCGTTCAGA.AGTTGCCTT
GCGTTCAGA.GGAGTACAG	GCGTTCAGA.GGAGTACAG
GCTAGTGGA.AAGGATCGT	GCTAGTGGA.AAGGATCGT
GCTATGTAA.AGCTGCACT	GCTATGTAA.AGCTGCACT
GCTCCTAGC.CGCCTGCAA	GCTCCTAGC.CGCCTGCAA
GCTGATGTC.ATATGCAGC	GCTGATGTC.ATATGCAGC
GCTGATGTC.TACTCGACC	GCTGATGTC.TACTCGACC
GCTGGTAAC.TCTTAGCGA	GCTGGTAAC.TCTTAGCGA
GCTGGTAAC.TTCATTCGC	GCTGGTAAC.TTCATTCGC
GCTTACTAG.ACCGAGACA	GCTTACTAG.ACCGAGACA
GCTTACTAG.GGATTCGTC	GCTTACTAG.GGATTCGTC
GCTTACTAG.TTCCAGATT	GCTTACTAG.TTCCAGATT
GCTTAGAAC.AGGATCTCA	GCTTAGAAC.AGGATCTCA
GCTTAGAAC.CTAACCGGT	GCTTAGAAC.CTAACCGGT
GCTTCACTC.ACCGTACGC	GCTTCACTC.ACCGTACGC
GCTTCACTC.CTCAGGTAC	GCTTCACTC.CTCAGGTAC
GCTTGGTTC.GACACCGAT	GCTTGGTTC.GACACCGAT
GCTTGGTTC.TAGTGCACT	GCTTGGTTC.TAGTGCACT
GGAACCTAG.GGTGAGCGT	GGAACCTAG.GGTGAGCGT
GGAAGAAGC.CTAACTAAG	GGAAGAAGC.CTAACTAAG
GGAAGTATG.CTAGTATAG	GGAAGTATG.CTAGTATAG
GGAATTCAC.CAGCTTACC	GGAATTCAC.CAGCTTACC
GGACGAGCA.AAGAGAGAG	GGACGAGCA.AAGAGAGAG
GGACTCCTT.ATTCGAAGA	GGACTCCTT.ATTCGAAGA
GGAGACACA.CTGCTGCTT	GGAGACACA.CTGCTGCTT
GGAGATGAG.GATCTAGAG	GGAGATGAG.GATCTAGAG
GGAGATGAG.TCGCGTCAT	GGAGATGAG.TCGCGTCAT
GGAGCTCAA.ACGCACACT	GGAGCTCAA.ACGCACACT
GGAGCTCAA.CCATTACAG	GGAGCTCAA.CCATTACAG
GGAGTACAG.CACATATCA	GGAGTACAG.CACATATCA
GGATAATAC.CATTGTTCA	GGATAATAC.CATTGTTCA
GGATAATAC.CGGTGAGTC	GGATAATAC.CGGTGAGTC
GGATCAATG.GGTCTTGCA	GGATCAATG.GGTCTTGCA
GGATCAGGT.CGACCTGTA	GGATCAGGT.CGACCTGTA
GGATCGTTC.GCGAGCAAG	GGATCGTTC.GCGAGCAAG
GGATGCGAA.TGATGGACA	GGATGCGAA.TGATGGACA
GGTAACTAC.TACCTCCTC	GGTAACTAC.TACCTCCTC
GGTAATCTA.AATACTCCG	GGTAATCTA.AATACTCCG
GGTAATCTA.TTCTGAATG	GGTAATCTA.TTCTGAATG
GGTACGAGC.ACTACTCAT	GGTACGAGC.ACTACTCAT
GGTACGAGC.ACTCCTGAG	GGTACGAGC.ACTCCTGAG
GGTAGTGTT.AGTCTGGAA	GGTAGTGTT.AGTCTGGAA
GGTCCTAAG.ACTAAGTTC	GGTCCTAAG.ACTAAGTTC
GGTCGGATA.ATCTCGTGA	GGTCGGATA.ATCTCGTGA
GGTCGGTCT.GCTCTGTGT	GGTCGGTCT.GCTCTGTGT
GGTCTTGCA.TGAGAATCC	GGTCTTGCA.TGAGAATCC
GGTGAGCGT.GGATCAATG	GGTGAGCGT.GGATCAATG
GGTGAGCGT.GTAGACTCT	GGTGAGCGT.GTAGACTCT
GGTGATAGG.CCGCACTCA	GGTGATAGG.CCGCACTCA
GGTGCGTAG.TACATGCAC	GGTGCGTAG.TACATGCAC
GGTGTTCAT.AAGCAATCG	GGTGTTCAT.AAGCAATCG
GGTTAACAG.ATTCCGTAC	GGTTAACAG.ATTCCGTAC
GGTTACGCA.ACGACATCT	GGTTACGCA.ACGACATCT
GGTTACGCA.GTTCACTCC	GGTTACGCA.GTTCACTCC
GGTTCAGAC.GACGGACTA	GGTTCAGAC.GACGGACTA
GGTTCAGAC.GACTCTGGT	GGTTCAGAC.GACTCTGGT
GGTTCAGAC.TGATGGACA	GGTTCAGAC.TGATGGACA
GGTTCGCAA.GAACTGCAA	GGTTCGCAA.GAACTGCAA
GGTTCTATC.ACGTAGTAT	GGTTCTATC.ACGTAGTAT
GGTTGAAGG.TATCACCTG	GGTTGAAGG.TATCACCTG
GGTTGCTAT.TCGTGCCAC	GGTTGCTAT.TCGTGCCAC
GTAACAGTC.AACTTGTCG	GTAACAGTC.AACTTGTCG
GTAACAGTC.GCGCTTCTC	GTAACAGTC.GCGCTTCTC
GTAACTCAT.GACGCTTGC	GTAACTCAT.GACGCTTGC
GTAACTCAT.GCCATTAAG	GTAACTCAT.GCCATTAAG
GTAAGTGAG.CGAGCCGTT	GTAAGTGAG.CGAGCCGTT
GTAATATCG.ATAGTCAGT	GTAATATCG.ATAGTCAGT
GTAATCAGC.CCAACAACA	GTAATCAGC.CCAACAACA
GTACTCTAC.CAATTGTCT	GTACTCTAC.CAATTGTCT
GTAGACTCT.ATGAGTGTG	GTAGACTCT.ATGAGTGTG
GTAGCATAC.AGCAGACAA	GTAGCATAC.AGCAGACAA
GTAGGACGC.GCTTCACTC	GTAGGACGC.GCTTCACTC
GTAGTGGAG.CACATATCA	GTAGTGGAG.CACATATCA
GTATCCTGC.TGAGTGACT	GTATCCTGC.TGAGTGACT
GTATGCCTT.GTCTTCTCG	GTATGCCTT.GTCTTCTCG
GTCAATACA.CGTATTCCT	GTCAATACA.CGTATTCCT
GTCAGTTGT.GTATGCCTT	GTCAGTTGT.GTATGCCTT
GTCCACAAC.AATGAGTCG	GTCCACAAC.AATGAGTCG
GTCCACAAC.TATACGTGG	GTCCACAAC.TATACGTGG
GTCCACAAC.TTCCTGCTA	GTCCACAAC.TTCCTGCTA
GTCCTAGTT.CGATAGGTG	GTCCTAGTT.CGATAGGTG
GTCGAGTAC.TGATGGACA	GTCGAGTAC.TGATGGACA
GTCGAGTAC.TTCCAGATT	GTCGAGTAC.TTCCAGATT
GTCGTGTTA.ACTGGTCAG	GTCGTGTTA.ACTGGTCAG
GTCGTGTTA.TCATGCTCA	GTCGTGTTA.TCATGCTCA
GTCGTGTTA.TGGATTAGC	GTCGTGTTA.TGGATTAGC
GTCTCCAGG.CACTGGTCC	GTCTCCAGG.CACTGGTCC
GTCTCTTCA.TTCCAGATT	GTCTCTTCA.TTCCAGATT
GTCTGACGT.CACGTAGAC	GTCTGACGT.CACGTAGAC
GTCTTATGC.ACAACGAGC	GTCTTATGC.ACAACGAGC
GTCTTCATA.AGCTGCACT	GTCTTCATA.AGCTGCACT
GTCTTCTCG.TTCACCTTG	GTCTTCTCG.TTCACCTTG
GTGAACCAC.CACAACGCT	GTGAACCAC.CACAACGCT
GTGAACCAC.CCTCGAGAG	GTGAACCAC.CCTCGAGAG
GTGACTCTC.ATGCTGTCG	GTGACTCTC.ATGCTGTCG
GTGAGGACG.AAGTCATGA	GTGAGGACG.AAGTCATGA
GTGAGGACG.CTACGGTAT	GTGAGGACG.CTACGGTAT
GTGCTCGGA.CCTTATCCG	GTGCTCGGA.CCTTATCCG
GTGGAGGTC.TCTGCAACA	GTGGAGGTC.TCTGCAACA
GTGGATAAG.CAGAGCACC	GTGGATAAG.CAGAGCACC
GTGTACCGT.GCGGTAAGT	GTGTACCGT.GCGGTAAGT
GTGTACCGT.TTGCCGTAG	GTGTACCGT.TTGCCGTAG
GTGTATCTG.CCGGTGGTT	GTGTATCTG.CCGGTGGTT
GTGTCGAGC.TGCCTGGTT	GTGTCGAGC.TGCCTGGTT
GTGTTCCAG.AACTCCATG	GTGTTCCAG.AACTCCATG
GTGTTCCAG.ACTACCATC	GTGTTCCAG.ACTACCATC
GTGTTCCAG.CCGGTTCTA	GTGTTCCAG.CCGGTTCTA
GTTAATTCG.GGAGTTAGC	GTTAATTCG.GGAGTTAGC
GTTAATTCG.TAGCGCAGC	GTTAATTCG.TAGCGCAGC
GTTACTACT.CTACGTTGG	GTTACTACT.CTACGTTGG
GTTAGAGAC.CACCTACGC	GTTAGAGAC.CACCTACGC
GTTAGAGAC.CGCTTATGA	GTTAGAGAC.CGCTTATGA
GTTAGAGAC.GTTAGTCAA	GTTAGAGAC.GTTAGTCAA
GTTAGAGAC.TCATGCAGG	GTTAGAGAC.TCATGCAGG
GTTAGTCAA.ATTCACCTC	GTTAGTCAA.ATTCACCTC
GTTATCGAT.AGACGCCTG	GTTATCGAT.AGACGCCTG
GTTCACTCC.AGAAGCTGC	GTTCACTCC.AGAAGCTGC
GTTCACTCC.AGTTGCCTT	GTTCACTCC.AGTTGCCTT
GTTCAGAAG.CAACACCTA	GTTCAGAAG.CAACACCTA
GTTCAGAAG.GCGACAACC	GTTCAGAAG.GCGACAACC
GTTCAGAAG.TGCCGAACT	GTTCAGAAG.TGCCGAACT
GTTGACCAT.AGCGGAACA	GTTGACCAT.AGCGGAACA
GTTGACGTG.CGAATCCTG	GTTGACGTG.CGAATCCTG
GTTGCATGG.ATAGCTTGC	GTTGCATGG.ATAGCTTGC
GTTGCATGG.TCCGTATAC	GTTGCATGG.TCCGTATAC
TAACGTGTC.CCTGCAGAT	TAACGTGTC.CCTGCAGAT
TAAGCACTA.CAGAAGTGA	TAAGCACTA.CAGAAGTGA
TAAGCCATT.CCATGATGT	TAAGCCATT.CCATGATGT
TAAGGTCCG.AGACCAGCT	TAAGGTCCG.AGACCAGCT
TAAGGTCCG.GCTACAATG	TAAGGTCCG.GCTACAATG
TAAGTACAC.GTTAGAGAC	TAAGTACAC.GTTAGAGAC
TAAGTGTAG.AACCGTGAG	TAAGTGTAG.AACCGTGAG
TAAGTGTAG.GCTGACAGA	TAAGTGTAG.GCTGACAGA
TAAGTGTAG.TTGAGCTCT	TAAGTGTAG.TTGAGCTCT
TACAAGAGG.CAATGCATT	TACAAGAGG.CAATGCATT
TACAGTTAG.TCCTGTGGA	TACAGTTAG.TCCTGTGGA
TACAGTTAG.TTGGTAACT	TACAGTTAG.TTGGTAACT
TACATGCAC.GTGACTCTC	TACATGCAC.GTGACTCTC
TACATGCAC.TATGCCTTC	TACATGCAC.TATGCCTTC
TACCAGCCA.GTGACTCTC	TACCAGCCA.GTGACTCTC
TACCATGTA.ACACAGAAC	TACCATGTA.ACACAGAAC
TACCATGTA.CAACCGGTC	TACCATGTA.CAACCGGTC
TACCTATCC.CAGTCCTAA	TACCTATCC.CAGTCCTAA
TACGAGTGA.CAGGATCAA	TACGAGTGA.CAGGATCAA
TACTAGTAG.TCCGGAGCT	TACTAGTAG.TCCGGAGCT
TACTCGCTG.CTGGACTAA	TACTCGCTG.CTGGACTAA
TACTGATGA.ATACCGCTT	TACTGATGA.ATACCGCTT
TACTGATGA.TAACGTGTC	TACTGATGA.TAACGTGTC
TACTTCCAG.GGATTCGTC	TACTTCCAG.GGATTCGTC
TAGACCGCA.ACTCGTAGG	TAGACCGCA.ACTCGTAGG
TAGATAGCC.ACTTCGCAG	TAGATAGCC.ACTTCGCAG
TAGCACACG.CATTCCGAG	TAGCACACG.CATTCCGAG
TAGCACACG.GATCGCACT	TAGCACACG.GATCGCACT
TAGCACTAT.AGCACCGTG	TAGCACTAT.AGCACCGTG
TAGCGCAGC.GGTAGACAT	TAGCGCAGC.GGTAGACAT
TAGCGCAGC.TTCAGTGCC	TAGCGCAGC.TTCAGTGCC
TAGGTTAGT.CTAGTCGTC	TAGGTTAGT.CTAGTCGTC
TAGTAACGG.AGAGGTGAA	TAGTAACGG.AGAGGTGAA
TAGTAACGG.TTCATCCAA	TAGTAACGG.TTCATCCAA
TAGTTGACG.ACCGAGTAG	TAGTTGACG.ACCGAGTAG
TATAATCGC.TGGAGAACC	TATAATCGC.TGGAGAACC
TATACGGAT.TCTGCGCTG	TATACGGAT.TCTGCGCTG
TATACGTGG.TGCCGAACT	TATACGTGG.TGCCGAACT
TATAGTGCG.CATGCCAGT	TATAGTGCG.CATGCCAGT
TATCACCTG.CCTATTCAA	TATCACCTG.CCTATTCAA
TATCAGTGC.GACTAGCAT	TATCAGTGC.GACTAGCAT
TATCTGTCA.ACTTCTAAC	TATCTGTCA.ACTTCTAAC
TATCTGTCA.TGCCGCTAC	TATCTGTCA.TGCCGCTAC
TATGAAGAC.CTAGAGGTA	TATGAAGAC.CTAGAGGTA
TATGTATGC.ATCACCGCA	TATGTATGC.ATCACCGCA
TCAAGGTCG.TCCGATCTG	TCAAGGTCG.TCCGATCTG
TCACACTGC.CTTGCACAA	TCACACTGC.CTTGCACAA
TCACCGAGG.CACATGTGC	TCACCGAGG.CACATGTGC
TCACGCGAC.CCACATTAG	TCACGCGAC.CCACATTAG
TCAGCGACC.GGACTATTC	TCAGCGACC.GGACTATTC
TCAGTAAGC.AGCGGAACA	TCAGTAAGC.AGCGGAACA
TCAGTAAGC.TCTCAGGAT	TCAGTAAGC.TCTCAGGAT
TCATCAGAG.AGATGAAGA	TCATCAGAG.AGATGAAGA
TCATGCAGG.CTTAGAAGG	TCATGCAGG.CTTAGAAGG
TCATGCTCA.TAAGTGTAG	TCATGCTCA.TAAGTGTAG
TCCAACGTG.CAGTGAGGA	TCCAACGTG.CAGTGAGGA
TCCAAGTAA.CCGCAGAAT	TCCAAGTAA.CCGCAGAAT
TCCACCTCA.ACGTGAATC	TCCACCTCA.ACGTGAATC
TCCAGCTAT.CAGTCTAAC	TCCAGCTAT.CAGTCTAAC
TCCAGCTAT.GCCGAACCA	TCCAGCTAT.GCCGAACCA
TCCATCATT.AGTAATCAG	TCCATCATT.AGTAATCAG
TCCGATAAC.AGCAGACAA	TCCGATAAC.AGCAGACAA
TCCGATCTG.CGCCATTAC	TCCGATCTG.CGCCATTAC
TCCTGTGGA.CTCTTCAGC	TCCTGTGGA.CTCTTCAGC
TCCTTAGGT.CACCTACGC	TCCTTAGGT.CACCTACGC
TCCTTCAAC.GCACTGGAT	TCCTTCAAC.GCACTGGAT
TCGCAAGCA.CAAGTCACT	TCGCAAGCA.CAAGTCACT
TCGCGTCAT.CCAGGAGTT	TCGCGTCAT.CCAGGAGTT
TCGCTTAAC.AAGCAGCAT	TCGCTTAAC.AAGCAGCAT
TCGCTTAAC.ACCTCCTAG	TCGCTTAAC.ACCTCCTAG
TCGGATGTT.ACCTTGAAG	TCGGATGTT.ACCTTGAAG
TCGTAGGAA.CTTGCACAA	TCGTAGGAA.CTTGCACAA
TCGTAGGAA.TCTAGCTGG	TCGTAGGAA.TCTAGCTGG
TCGTGCCAC.GATCTGAAT	TCGTGCCAC.GATCTGAAT
TCGTGCCAC.TATGACCGA	TCGTGCCAC.TATGACCGA
TCTACAGTT.GTATGCCTT	TCTACAGTT.GTATGCCTT
TCTACGCAA.CGTTGATCC	TCTACGCAA.CGTTGATCC
TCTAGCTGG.CACAACCAG	TCTAGCTGG.CACAACCAG
TCTAGGATG.AGCACCGTG	TCTAGGATG.AGCACCGTG
TCTATGACA.ACCGGTTAC	TCTATGACA.ACCGGTTAC
TCTATGACA.CATGGTCGA	TCTATGACA.CATGGTCGA
TCTCAGGAT.TGCCAGACG	TCTCAGGAT.TGCCAGACG
TCTCCGCGT.GATTAGACA	TCTCCGCGT.GATTAGACA
TCTCGATGC.AGTAATGGT	TCTCGATGC.AGTAATGGT
TCTCGATGC.CAGTAATGT	TCTCGATGC.CAGTAATGT
TCTCGATGC.TCCTGTCCG	TCTCGATGC.TCCTGTCCG
TCTGCAACA.TAGATAGCC	TCTGCAACA.TAGATAGCC
TCTTAAGTG.GGTGGAGCT	TCTTAAGTG.GGTGGAGCT
TGAACGTCA.AGCAAGTCC	TGAACGTCA.AGCAAGTCC
TGAACGTCA.ATTCCTACG	TGAACGTCA.ATTCCTACG
TGAAGACCA.AATCTGACC	TGAAGACCA.AATCTGACC
TGACCTCCT.CCATACGAT	TGACCTCCT.CCATACGAT
TGACTGAGA.CTACTGTCA	TGACTGAGA.CTACTGTCA
TGAGAGGAC.TTATCCAAG	TGAGAGGAC.TTATCCAAG
TGAGCTAGA.AGCGTCGTC	TGAGCTAGA.AGCGTCGTC
TGAGCTAGA.ATGAGCAGG	TGAGCTAGA.ATGAGCAGG
TGAGCTAGA.TGAGATCAT	TGAGCTAGA.TGAGATCAT
TGATACCGT.TGCAGTCGG	TGATACCGT.TGCAGTCGG
TGATCGGAA.GCGAAGACA	TGATCGGAA.GCGAAGACA
TGATCTCGG.CCACATTAG	TGATCTCGG.CCACATTAG
TGATCTCGG.TTACAGTGT	TGATCTCGG.TTACAGTGT
TGATGACAG.CTCTAGTAA	TGATGACAG.CTCTAGTAA
TGATGACAG.GGACTATTC	TGATGACAG.GGACTATTC
TGATGACAG.GTACTCTAC	TGATGACAG.GTACTCTAC
TGATGTGTG.AGCACACCT	TGATGTGTG.AGCACACCT
TGATTATCG.TATGCCTTC	TGATTATCG.TATGCCTTC
TGCAGCCTT.AGAGAGTGG	TGCAGCCTT.AGAGAGTGG
TGCAGCCTT.CTAGTTCCA	TGCAGCCTT.CTAGTTCCA
TGCAGCCTT.TTAAGTGGT	TGCAGCCTT.TTAAGTGGT
TGCCAATGG.CTCTAGTAA	TGCCAATGG.CTCTAGTAA
TGCCACCGA.CAGCACGTG	TGCCACCGA.CAGCACGTG
TGCCAGACG.AGGATTACT	TGCCAGACG.AGGATTACT
TGCCATCTC.CACGCGTAA	TGCCATCTC.CACGCGTAA
TGCCGAACT.GGTTCTATC	TGCCGAACT.GGTTCTATC
TGCCGACTA.CCTGACCTC	TGCCGACTA.CCTGACCTC
TGCCGACTA.CTGATGCAC	TGCCGACTA.CTGATGCAC
TGCCGACTA.GTAACCATA	TGCCGACTA.GTAACCATA
TGCCTGGTT.ACTCCAACT	TGCCTGGTT.ACTCCAACT
TGCGTCTTA.CAAGAGAGT	TGCGTCTTA.CAAGAGAGT
TGCGTCTTA.CACAACGCT	TGCGTCTTA.CACAACGCT
TGCTCAGCG.AGCATATGG	TGCTCAGCG.AGCATATGG
TGCTCAGCG.CCTCTGCAT	TGCTCAGCG.CCTCTGCAT
TGCTCCTCC.ACGTCGCTC	TGCTCCTCC.ACGTCGCTC
TGCTGCGTC.TGCGTATCT	TGCTGCGTC.TGCGTATCT
TGGAAGATT.CACGTAGAC	TGGAAGATT.CACGTAGAC
TGGAAGATT.GCTGACAGA	TGGAAGATT.GCTGACAGA
TGGACGAGA.TCCTTCAAC	TGGACGAGA.TCCTTCAAC
TGGACTGCC.CGACCTGTA	TGGACTGCC.CGACCTGTA
TGGACTGCC.TAGACCATG	TGGACTGCC.TAGACCATG
TGGACTGCC.TGCCAATGG	TGGACTGCC.TGCCAATGG
TGGAGAACC.ATAGACCGA	TGGAGAACC.ATAGACCGA
TGGAGAGTG.CACTAGACT	TGGAGAGTG.CACTAGACT
TGGTAGCAG.CGCACTCTT	TGGTAGCAG.CGCACTCTT
TGGTAGCAG.TGTCATAGC	TGGTAGCAG.TGTCATAGC
TGGTCGCTA.ACCTGCAGA	TGGTCGCTA.ACCTGCAGA
TGGTGCCTG.ACTCTAGGA	TGGTGCCTG.ACTCTAGGA
TGGTGCCTG.CGTCATGGA	TGGTGCCTG.CGTCATGGA
TGGTGGATC.AGCGACACC	TGGTGGATC.AGCGACACC
TGGTTATAC.TAACTCCGA	TGGTTATAC.TAACTCCGA
TGTCCATAG.AGCATTCCA	TGTCCATAG.AGCATTCCA
TGTCGTGAG.ATATGTCCA	TGTCGTGAG.ATATGTCCA
TGTGAGTAT.AACAACCTA	TGTGAGTAT.AACAACCTA
TGTGCAGTA.CCGTTCCAA	TGTGCAGTA.CCGTTCCAA
TGTGCTAAC.GTCAGACCG	TGTGCTAAC.GTCAGACCG
TGTTACTGA.AGCTCTCCG	TGTTACTGA.AGCTCTCCG
TGTTACTGA.CAAGAACCG	TGTTACTGA.CAAGAACCG
TTACAGTGT.GTCGTGTTA	TTACAGTGT.GTCGTGTTA
TTACAGTGT.TCGCAAGCA	TTACAGTGT.TCGCAAGCA
TTAGATCGG.AGGAGGTGA	TTAGATCGG.AGGAGGTGA
TTAGTCGGA.CCACTACCA	TTAGTCGGA.CCACTACCA
TTCACTCCT.CATTGACAA	TTCACTCCT.CATTGACAA
TTCATTCGC.ACGAGCTTC	TTCATTCGC.ACGAGCTTC
TTCATTCGC.CATCGAAGC	TTCATTCGC.CATCGAAGC
TTCCGCCAG.TGCGCTGCA	TTCCGCCAG.TGCGCTGCA
TTCCTAAGG.AACAATGCA	TTCCTAAGG.AACAATGCA
TTCCTGCTA.GACTCTGGT	TTCCTGCTA.GACTCTGGT
TTCTGAATG.AACTAACTG	TTCTGAATG.AACTAACTG
TTCTGGTGC.ATCAAGAGA	TTCTGGTGC.ATCAAGAGA
TTGACCTGA.TGATTATCG	TTGACCTGA.TGATTATCG
TTGAGACGG.CCTGCTCCA	TTGAGACGG.CCTGCTCCA
TTGATCGTA.AGGTCCGTC	TTGATCGTA.AGGTCCGTC
TTGATCGTA.GATTCCTCT	TTGATCGTA.GATTCCTCT
TTGCAGTCA.CTCTAGTAA	TTGCAGTCA.CTCTAGTAA
TTGCCGTAG.TCTGCGCTG	TTGCCGTAG.TCTGCGCTG
TTGCGAACA.TGTCACATA	TTGCGAACA.TGTCACATA
TTGGACTTC.CAGTAATGT	TTGGACTTC.CAGTAATGT
TTGGACTTC.GGTCCTGGT	TTGGACTTC.GGTCCTGGT
TTGGTAACT.AATATCGCT	TTGGTAACT.AATATCGCT
TTGTAATGC.GCAGCAGTG	TTGTAATGC.GCAGCAGTG
TTGTAATGC.GCCACGAGT	TTGTAATGC.GCCACGAGT
TTGTATCAC.AGAATCAGA	TTGTATCAC.AGAATCAGA
TTGTTAGAG.CGACGTACG	TTGTTAGAG.CGACGTACG
