TCTTAAGTG.GTCTTATGC	TCTTAAGTG.GTCTTATGC
TCTTAAGTG.GTCTTCATA	TCTTAAGTG.GTCTTCATA
TCTTAAGTG.TGCAGATGC	TCTTAAGTG.TGCAGATGC
TCTTAAGTG.TTACTTACG	TCTTAAGTG.TTACTTACG
TCTTAGCGA.ATCGCCTCT	TCTTAGCGA.ATCGCCTCT
TCTTAGCGA.CCTGACCTC	TCTTAGCGA.CCTGACCTC
TCTTAGCGA.CTGACGATG	TCTTAGCGA.CTGACGATG
TCTTAGCGA.GTCACAGAG	TCTTAGCGA.GTCACAGAG
TCTTAGCGA.TAAGCCATT	TCTTAGCGA.TAAGCCATT
TCTTAGCGA.TGAGTTAAG	TCTTAGCGA.TGAGTTAAG
TCTTAGCGA.TGTCCATAG	TCTTAGCGA.TGTCCATAG
TCTTGGTAG.AATGCCTCA	TCTTGGTAG.AATGCCTCA
TCTTGGTAG.ACTCGAGTC	TCTTGGTAG.ACTCGAGTC
TCTTGGTAG.AGCCAGGAC	TCTTGGTAG.AGCCAGGAC
TCTTGGTAG.CGCAGTGTC	TCTTGGTAG.CGCAGTGTC
TCTTGGTAG.CTAGGTACT	TCTTGGTAG.CTAGGTACT
TCTTGGTAG.CTGAGGTTA	TCTTGGTAG.CTGAGGTTA
TCTTGGTAG.GAGCCGTTA	TCTTGGTAG.GAGCCGTTA
TCTTGGTAG.GCGTATAGG	TCTTGGTAG.GCGTATAGG
TCTTGGTAG.TCAACACTC	TCTTGGTAG.TCAACACTC
TCTTGGTAG.TTCTCCACA	TCTTGGTAG.TTCTCCACA
TGAACCAAT.CCAGTACTC	TGAACCAAT.CCAGTACTC
TGAACCAAT.CCGTCAGGT	TGAACCAAT.CCGTCAGGT
TGAACCAAT.GATTGGAAG	TGAACCAAT.GATTGGAAG
TGAACCAAT.TTGCGAACA	TGAACCAAT.TTGCGAACA
TGAACGGTT.ACAGCGTAT	TGAACGGTT.ACAGCGTAT
TGAACGGTT.ATCCGACCA	TGAACGGTT.ATCCGACCA
TGAACGGTT.ATTCCGTAC	TGAACGGTT.ATTCCGTAC
TGAACGGTT.CGTTAATGG	TGAACGGTT.CGTTAATGG
TGAACGGTT.CTCGAACTG	TGAACGGTT.CTCGAACTG
TGAACGGTT.GCCTTGTGA	TGAACGGTT.GCCTTGTGA
TGAACGGTT.GGTAAGGAT	TGAACGGTT.GGTAAGGAT
TGAACGGTT.GGTAGACAT	TGAACGGTT.GGTAGACAT
TGAACGGTT.GTCTTCATA	TGAACGGTT.GTCTTCATA
TGAACGGTT.TCGACGTTG	TGAACGGTT.TCGACGTTG
TGAACGTCA.AAGACGAAG	TGAACGTCA.AAGACGAAG
TGAACGTCA.ACTCGTAGG	TGAACGTCA.ACTCGTAGG
TGAACGTCA.ATCATGTTC	TGAACGTCA.ATCATGTTC
TGAACGTCA.CAACGTCTT	TGAACGTCA.CAACGTCTT
TGAACGTCA.GCAACCAAC	TGAACGTCA.GCAACCAAC
TGAACGTCA.GCTCCTAGC	TGAACGTCA.GCTCCTAGC
TGAACGTCA.TAGGATTAG	TGAACGTCA.TAGGATTAG
TGAACGTCA.TCTTGGTAG	TGAACGTCA.TCTTGGTAG
TGAACGTCA.TGCAGTTCA	TGAACGTCA.TGCAGTTCA
TGAACTTGC.AATGCTGAT	TGAACTTGC.AATGCTGAT
TGAACTTGC.CCACTGAAG	TGAACTTGC.CCACTGAAG
TGAACTTGC.CTCAGCTGG	TGAACTTGC.CTCAGCTGG
TGAAGACCA.AAGACGAAG	TGAAGACCA.AAGACGAAG
TGAAGACCA.CCATTACAG	TGAAGACCA.CCATTACAG
TGAAGACCA.GGTCTCATG	TGAAGACCA.GGTCTCATG
TGAAGACCA.GTCAATACA	TGAAGACCA.GTCAATACA
TGACAAGTT.ACTAAGTTC	TGACAAGTT.ACTAAGTTC
TGACAAGTT.CGAGTAGCA	TGACAAGTT.CGAGTAGCA
TGACAAGTT.CGCAGTGTC	TGACAAGTT.CGCAGTGTC
TGACAAGTT.TAACACGAG	TGACAAGTT.TAACACGAG
TGACAAGTT.TATGAGACC	TGACAAGTT.TATGAGACC
TGACAAGTT.TCGCTTAAC	TGACAAGTT.TCGCTTAAC
TGACAAGTT.TTCAGTGCC	TGACAAGTT.TTCAGTGCC
TGACCAAGT.AGTCGATCA	TGACCAAGT.AGTCGATCA
TGACCAAGT.ATCACTTCC	TGACCAAGT.ATCACTTCC
TGACCAAGT.ATCTCGAAC	TGACCAAGT.ATCTCGAAC
TGACCAAGT.ATGTGACGA	TGACCAAGT.ATGTGACGA
TGACCAAGT.CTCTGCAAG	TGACCAAGT.CTCTGCAAG
TGACCAAGT.GTTATCGAT	TGACCAAGT.GTTATCGAT
TGACCTATG.ATGTCGCCT	TGACCTATG.ATGTCGCCT
TGACCTATG.CTGGTACAT	TGACCTATG.CTGGTACAT
TGACCTATG.GTCTTATGC	TGACCTATG.GTCTTATGC
TGACCTATG.TGGAATCGT	TGACCTATG.TGGAATCGT
TGACCTCCT.ATCCGACCA	TGACCTCCT.ATCCGACCA
TGACCTCCT.CCAAGTCGA	TGACCTCCT.CCAAGTCGA
TGACCTCCT.CGGAATGCA	TGACCTCCT.CGGAATGCA
TGACCTCCT.GCCATTAAG	TGACCTCCT.GCCATTAAG
TGACGATGA.AACAATGCA	TGACGATGA.AACAATGCA
TGACGATGA.ACCACGCTA	TGACGATGA.ACCACGCTA
TGACGATGA.GATAGTTCT	TGACGATGA.GATAGTTCT
TGACGATGA.TTCACTGGA	TGACGATGA.TTCACTGGA
TGACGGTTG.ACGAGAGCA	TGACGGTTG.ACGAGAGCA
TGACGGTTG.ACGTGAATC	TGACGGTTG.ACGTGAATC
TGACGGTTG.ATCCTCCGA	TGACGGTTG.ATCCTCCGA
TGACGGTTG.CAATCATAC	TGACGGTTG.CAATCATAC
TGACGGTTG.CCTCATAAC	TGACGGTTG.CCTCATAAC
TGACGGTTG.TCTATGACA	TGACGGTTG.TCTATGACA
TGACGGTTG.TTGTCAACC	TGACGGTTG.TTGTCAACC
TGACTGAGA.CCAATGCCT	TGACTGAGA.CCAATGCCT
TGACTGAGA.CCGCTCATG	TGACTGAGA.CCGCTCATG
TGACTGAGA.CCTGACCTC	TGACTGAGA.CCTGACCTC
TGACTGAGA.GTGGTTACC	TGACTGAGA.GTGGTTACC
TGAGAATCC.GGAAGGTAT	TGAGAATCC.GGAAGGTAT
TGAGAATCC.TAACACGAG	TGAGAATCC.TAACACGAG
TGAGACAGC.AGTCGTCCG	TGAGACAGC.AGTCGTCCG
TGAGACAGC.ATTGGTTCC	TGAGACAGC.ATTGGTTCC
TGAGACAGC.CATCGCTGG	TGAGACAGC.CATCGCTGG
TGAGACAGC.CCGCAGAAT	TGAGACAGC.CCGCAGAAT
TGAGACAGC.CGAAGAGGT	TGAGACAGC.CGAAGAGGT
TGAGACAGC.CGGAACGAG	TGAGACAGC.CGGAACGAG
TGAGACAGC.CTGGAGCGA	TGAGACAGC.CTGGAGCGA
TGAGACAGC.GAATCAACC	TGAGACAGC.GAATCAACC
TGAGACAGC.GCAACACCT	TGAGACAGC.GCAACACCT
TGAGACAGC.TGGAAGATT	TGAGACAGC.TGGAAGATT
TGAGACAGC.TGTGAGTAT	TGAGACAGC.TGTGAGTAT
TGAGAGGAC.ACCTAGCAC	TGAGAGGAC.ACCTAGCAC
TGAGAGGAC.CGAGTAGCA	TGAGAGGAC.CGAGTAGCA
TGAGAGGAC.CTCGTCTTG	TGAGAGGAC.CTCGTCTTG
TGAGAGGAC.GACGTCAAT	TGAGAGGAC.GACGTCAAT
TGAGATCAT.CCGCAGCTA	TGAGATCAT.CCGCAGCTA
TGAGATCAT.TGCTCCTCC	TGAGATCAT.TGCTCCTCC
TGAGCAGAT.AGTGAGAGA	TGAGCAGAT.AGTGAGAGA
TGAGCAGAT.CCACAAGGT	TGAGCAGAT.CCACAAGGT
TGAGCAGAT.TCGCATTCG	TGAGCAGAT.TCGCATTCG
TGAGCTAGA.CAGCTCTTC	TGAGCTAGA.CAGCTCTTC
TGAGCTAGA.CTGGTCGGT	TGAGCTAGA.CTGGTCGGT
TGAGCTAGA.TAGCTAAGA	TGAGCTAGA.TAGCTAAGA
TGAGCTAGA.TGCAGTCGG	TGAGCTAGA.TGCAGTCGG
TGAGGTCTC.AAGCACAAC	TGAGGTCTC.AAGCACAAC
TGAGGTCTC.ACTCTGCTC	TGAGGTCTC.ACTCTGCTC
TGAGGTCTC.CTGGTACAT	TGAGGTCTC.CTGGTACAT
TGAGGTCTC.GCAACCAAC	TGAGGTCTC.GCAACCAAC
TGAGGTCTC.TGACTGAGA	TGAGGTCTC.TGACTGAGA
TGAGTGACT.ACTATTGTC	TGAGTGACT.ACTATTGTC
TGAGTGACT.AGCGGTAAG	TGAGTGACT.AGCGGTAAG
TGAGTGACT.GACGTCAAT	TGAGTGACT.GACGTCAAT
TGAGTGACT.GTAGTGGAG	TGAGTGACT.GTAGTGGAG
TGAGTGACT.GTTCCAACA	TGAGTGACT.GTTCCAACA
TGAGTGACT.TTGACCTGA	TGAGTGACT.TTGACCTGA
TGAGTTAAG.ACCTCCTAG	TGAGTTAAG.ACCTCCTAG
TGAGTTAAG.AGATCTTCA	TGAGTTAAG.AGATCTTCA
TGAGTTAAG.ATGTGACGA	TGAGTTAAG.ATGTGACGA
TGAGTTAAG.CACTGGTCC	TGAGTTAAG.CACTGGTCC
TGAGTTAAG.CGGAAGACG	TGAGTTAAG.CGGAAGACG
TGAGTTAAG.GCCGCTATC	TGAGTTAAG.GCCGCTATC
TGAGTTAAG.GTTGATGCA	TGAGTTAAG.GTTGATGCA
TGAGTTAAG.TACCGCGTT	TGAGTTAAG.TACCGCGTT
TGAGTTAAG.TACGTTACC	TGAGTTAAG.TACGTTACC
TGATACCGT.CATAGAGAT	TGATACCGT.CATAGAGAT
TGATACCGT.CGCATCTAC	TGATACCGT.CGCATCTAC
TGATACCGT.GCGTTCAGA	TGATACCGT.GCGTTCAGA
TGATACCGT.TCAGTGCAA	TGATACCGT.TCAGTGCAA
TGATAGAGG.AGCTTGGTG	TGATAGAGG.AGCTTGGTG
TGATAGAGG.ATATAGCGT	TGATAGAGG.ATATAGCGT
TGATAGAGG.CGTGACCAG	TGATAGAGG.CGTGACCAG
TGATAGAGG.CTGAGATAG	TGATAGAGG.CTGAGATAG
TGATAGAGG.GGATGCGAA	TGATAGAGG.GGATGCGAA
TGATAGAGG.GTACCACAA	TGATAGAGG.GTACCACAA
TGATAGAGG.TCGTGACGT	TGATAGAGG.TCGTGACGT
TGATAGAGG.TGCGTATCT	TGATAGAGG.TGCGTATCT
TGATAGAGG.TGTCTACAC	TGATAGAGG.TGTCTACAC
TGATCGGAA.ACTAACCGA	TGATCGGAA.ACTAACCGA
TGATCGGAA.CAGCTCTTC	TGATCGGAA.CAGCTCTTC
TGATCGGAA.GACGCTTGC	TGATCGGAA.GACGCTTGC
TGATCGGAA.TAACGGATA	TGATCGGAA.TAACGGATA
TGATCGGAA.TAGCTAAGA	TGATCGGAA.TAGCTAAGA
TGATCGGAA.TCTGAGATA	TGATCGGAA.TCTGAGATA
TGATCGGAA.TTAGGAAGG	TGATCGGAA.TTAGGAAGG
TGATCTCGG.AAGCAATCG	TGATCTCGG.AAGCAATCG
TGATCTCGG.ACGTACTGC	TGATCTCGG.ACGTACTGC
TGATCTCGG.ACTCGAGTC	TGATCTCGG.ACTCGAGTC
TGATCTCGG.GTGGTTACC	TGATCTCGG.GTGGTTACC
TGATGACAG.AGTGTTCTG	TGATGACAG.AGTGTTCTG
TGATGACAG.CAAGGTGTG	TGATGACAG.CAAGGTGTG
TGATGACAG.CCGACTTGG	TGATGACAG.CCGACTTGG
TGATGACAG.CTTAAGTTG	TGATGACAG.CTTAAGTTG
TGATGACAG.GTAATCAGC	TGATGACAG.GTAATCAGC
TGATGACAG.TAGCACACG	TGATGACAG.TAGCACACG
TGATGACAG.TGACCTATG	TGATGACAG.TGACCTATG
TGATGGACA.ATACAACCG	TGATGGACA.ATACAACCG
TGATGGACA.ATATAGCGT	TGATGGACA.ATATAGCGT
TGATGGACA.ATTAGCGGT	TGATGGACA.ATTAGCGGT
TGATGGACA.CGCTTATGA	TGATGGACA.CGCTTATGA
TGATGGACA.GCACAACTC	TGATGGACA.GCACAACTC
TGATGGACA.TTCCATACC	TGATGGACA.TTCCATACC
TGATGTGTG.AAGGATCGT	TGATGTGTG.AAGGATCGT
TGATGTGTG.ATGTGAGAC	TGATGTGTG.ATGTGAGAC
TGATGTGTG.CGCCATTAC	TGATGTGTG.CGCCATTAC
TGATGTGTG.GCATTGATC	TGATGTGTG.GCATTGATC
TGATGTGTG.TCGCGTCAT	TGATGTGTG.TCGCGTCAT
TGATTATCG.AAGTCATGA	TGATTATCG.AAGTCATGA
TGATTATCG.AATGCCTCA	TGATTATCG.AATGCCTCA
TGATTATCG.AGCTCTCCG	TGATTATCG.AGCTCTCCG
TGATTATCG.ATTCACCTC	TGATTATCG.ATTCACCTC
TGATTATCG.CCGACTTGG	TGATTATCG.CCGACTTGG
TGATTCACC.ATCGTAGTG	TGATTCACC.ATCGTAGTG
TGATTGCTG.AGTCGCGAC	TGATTGCTG.AGTCGCGAC
TGATTGCTG.CGTAATGAC	TGATTGCTG.CGTAATGAC
TGATTGCTG.GATTGGAAG	TGATTGCTG.GATTGGAAG
TGATTGCTG.GTCCACAAC	TGATTGCTG.GTCCACAAC
TGATTGCTG.GTGAACCAC	TGATTGCTG.GTGAACCAC
TGATTGTGC.AATGCAGCG	TGATTGTGC.AATGCAGCG
TGATTGTGC.AGTGTGCAC	TGATTGTGC.AGTGTGCAC
TGATTGTGC.ATCCGTCTC	TGATTGTGC.ATCCGTCTC
TGATTGTGC.ATGCCTTCA	TGATTGTGC.ATGCCTTCA
TGATTGTGC.ATGCTCACC	TGATTGTGC.ATGCTCACC
TGATTGTGC.CACCTAGCG	TGATTGTGC.CACCTAGCG
TGATTGTGC.CTAGAGTCG	TGATTGTGC.CTAGAGTCG
TGATTGTGC.TACTCGACC	TGATTGTGC.TACTCGACC
TGATTGTGC.TCAGTGCAA	TGATTGTGC.TCAGTGCAA
TGCAACTCT.AACCATGGT	TGCAACTCT.AACCATGGT
TGCAACTCT.CACAACCAG	TGCAACTCT.CACAACCAG
TGCAACTCT.CCGCATCCT	TGCAACTCT.CCGCATCCT
TGCAACTCT.GCGGAGATT	TGCAACTCT.GCGGAGATT
TGCAACTCT.TATACGTGG	TGCAACTCT.TATACGTGG
TGCAACTCT.TCACGACAA	TGCAACTCT.TCACGACAA
TGCAACTCT.TTATGAGGA	TGCAACTCT.TTATGAGGA
TGCAACTCT.TTCGTGATG	TGCAACTCT.TTCGTGATG
TGCACGATG.ACTCGTAGG	TGCACGATG.ACTCGTAGG
TGCACGATG.TACGGTCGT	TGCACGATG.TACGGTCGT
TGCACGATG.TCCTTCGTA	TGCACGATG.TCCTTCGTA
TGCAGATGC.CCTAGAGTA	TGCAGATGC.CCTAGAGTA
TGCAGATGC.GGACTATTC	TGCAGATGC.GGACTATTC
TGCAGATGC.GGTTCAGAC	TGCAGATGC.GGTTCAGAC
TGCAGATGC.GTCATTCTA	TGCAGATGC.GTCATTCTA
TGCAGATGC.GTGGTACGG	TGCAGATGC.GTGGTACGG
TGCAGCCTT.ACTGGTGCT	TGCAGCCTT.ACTGGTGCT
TGCAGCCTT.AGCTCTCCG	TGCAGCCTT.AGCTCTCCG
TGCAGCCTT.AGTACTCTC	TGCAGCCTT.AGTACTCTC
TGCAGCCTT.CACTACAGG	TGCAGCCTT.CACTACAGG
TGCAGCCTT.CGCAACCTC	TGCAGCCTT.CGCAACCTC
TGCAGCCTT.CTAATACGC	TGCAGCCTT.CTAATACGC
TGCAGCCTT.GAACTGCAA	TGCAGCCTT.GAACTGCAA
TGCAGCCTT.GACAATGTT	TGCAGCCTT.GACAATGTT
TGCAGCCTT.GATTATGCG	TGCAGCCTT.GATTATGCG
TGCAGCCTT.GGTACTTCC	TGCAGCCTT.GGTACTTCC
TGCAGCCTT.GTATCGTCG	TGCAGCCTT.GTATCGTCG
TGCAGCCTT.GTCTGAGCC	TGCAGCCTT.GTCTGAGCC
TGCAGCCTT.TAAGGTCCG	TGCAGCCTT.TAAGGTCCG
TGCAGCCTT.TCGTACCTT	TGCAGCCTT.TCGTACCTT
TGCAGCCTT.TGCAGATGC	TGCAGCCTT.TGCAGATGC
TGCAGCCTT.TTATGAGGA	TGCAGCCTT.TTATGAGGA
TGCAGTCGG.CAGCCGCAA	TGCAGTCGG.CAGCCGCAA
TGCAGTCGG.CTGCGTCAC	TGCAGTCGG.CTGCGTCAC
TGCAGTCGG.CTTGTAACG	TGCAGTCGG.CTTGTAACG
TGCAGTCGG.GTCTTATGC	TGCAGTCGG.GTCTTATGC
TGCAGTCGG.TACGAGTGA	TGCAGTCGG.TACGAGTGA
TGCAGTTCA.CAGCCGCAA	TGCAGTTCA.CAGCCGCAA
TGCAGTTCA.GTGTATCTG	TGCAGTTCA.GTGTATCTG
TGCAGTTCA.TCCATCATT	TGCAGTTCA.TCCATCATT
TGCATACAT.ACGACATCT	TGCATACAT.ACGACATCT
TGCATACAT.CAGGTTGTC	TGCATACAT.CAGGTTGTC
TGCATACAT.GTTAGATTG	TGCATACAT.GTTAGATTG
TGCATACAT.TCCTTAGGT	TGCATACAT.TCCTTAGGT
TGCATACAT.TGTCACATA	TGCATACAT.TGTCACATA
TGCATCGGA.AGGTATTCC	TGCATCGGA.AGGTATTCC
TGCATCGGA.CGGTAGCTT	TGCATCGGA.CGGTAGCTT
TGCATCGGA.CTAGTATAG	TGCATCGGA.CTAGTATAG
TGCATCGGA.CTGCATGTT	TGCATCGGA.CTGCATGTT
TGCATCGGA.TTCATCCAA	TGCATCGGA.TTCATCCAA
TGCCAATGG.AACTGATTC	TGCCAATGG.AACTGATTC
TGCCAATGG.AGAGCGCGA	TGCCAATGG.AGAGCGCGA
TGCCAATGG.CAACTCCAG	TGCCAATGG.CAACTCCAG
TGCCAATGG.CGTCTGCTG	TGCCAATGG.CGTCTGCTG
TGCCAATGG.GTCATTCTA	TGCCAATGG.GTCATTCTA
TGCCAATGG.GTTCACTCC	TGCCAATGG.GTTCACTCC
TGCCACCGA.ATTAGCCAC	TGCCACCGA.ATTAGCCAC
TGCCACCGA.CATAGAGAT	TGCCACCGA.CATAGAGAT
TGCCACCGA.CTCCTGACG	TGCCACCGA.CTCCTGACG
TGCCACCGA.TAGTGATCC	TGCCACCGA.TAGTGATCC
TGCCAGACG.CATGTGAAC	TGCCAGACG.CATGTGAAC
TGCCAGACG.GTTCCAACA	TGCCAGACG.GTTCCAACA
TGCCAGACG.TCGACGTTG	TGCCAGACG.TCGACGTTG
TGCCATCTC.ATAGCACGG	TGCCATCTC.ATAGCACGG
TGCCATCTC.CCTCATAAC	TGCCATCTC.CCTCATAAC
TGCCATCTC.TACCGCGTT	TGCCATCTC.TACCGCGTT
TGCCATCTC.TCTCGTATC	TGCCATCTC.TCTCGTATC
TGCCATCTC.TGCTCAGCG	TGCCATCTC.TGCTCAGCG
TGCCGAACT.ATCCAATGA	TGCCGAACT.ATCCAATGA
TGCCGAACT.CAAGCCTCG	TGCCGAACT.CAAGCCTCG
TGCCGAACT.GAACTATGG	TGCCGAACT.GAACTATGG
TGCCGAACT.GCTACCTTA	TGCCGAACT.GCTACCTTA
TGCCGAACT.GCTCAATGA	TGCCGAACT.GCTCAATGA
TGCCGACTA.ACTTCAGTA	TGCCGACTA.ACTTCAGTA
TGCCGACTA.ATTGACACG	TGCCGACTA.ATTGACACG
TGCCGACTA.CTTGCGACC	TGCCGACTA.CTTGCGACC
TGCCGACTA.GTGTACCGT	TGCCGACTA.GTGTACCGT
TGCCGACTA.TCACACTGC	TGCCGACTA.TCACACTGC
TGCCGACTA.TCATATCGC	TGCCGACTA.TCATATCGC
TGCCGACTA.TCGCTTAAC	TGCCGACTA.TCGCTTAAC
TGCCGACTA.TGCGACGTT	TGCCGACTA.TGCGACGTT
TGCCGACTA.TGGAGAGTG	TGCCGACTA.TGGAGAGTG
TGCCGCTAC.ATTAAGACC	TGCCGCTAC.ATTAAGACC
TGCCGCTAC.CAACCGGTC	TGCCGCTAC.CAACCGGTC
TGCCGCTAC.GGACTATTC	TGCCGCTAC.GGACTATTC
TGCCGCTAC.TGCACGATG	TGCCGCTAC.TGCACGATG
TGCCGCTAC.TGGATTAGC	TGCCGCTAC.TGGATTAGC
TGCCTGGTT.AGAGCGCGA	TGCCTGGTT.AGAGCGCGA
TGCCTGGTT.CGAGCCGTT	TGCCTGGTT.CGAGCCGTT
TGCCTGGTT.CGGATTCTC	TGCCTGGTT.CGGATTCTC
TGCCTGGTT.GCCGAGTCT	TGCCTGGTT.GCCGAGTCT
TGCCTGGTT.TTGCCAGAT	TGCCTGGTT.TTGCCAGAT
TGCCTTCAG.CAGGTATCG	TGCCTTCAG.CAGGTATCG
TGCCTTCAG.CCGAATATG	TGCCTTCAG.CCGAATATG
TGCCTTCAG.GTTGATGCA	TGCCTTCAG.GTTGATGCA
TGCCTTCAG.TGATGACAG	TGCCTTCAG.TGATGACAG
TGCGACGTT.AATGCCTCA	TGCGACGTT.AATGCCTCA
TGCGACGTT.GATACACTA	TGCGACGTT.GATACACTA
TGCGACGTT.TACAAGAGG	TGCGACGTT.TACAAGAGG
TGCGATACT.CACACCACA	TGCGATACT.CACACCACA
TGCGATACT.CAGCAGTAC	TGCGATACT.CAGCAGTAC
TGCGATACT.CATCTCGAT	TGCGATACT.CATCTCGAT
TGCGATACT.GATGTCTAG	TGCGATACT.GATGTCTAG
TGCGCACTG.AAGGAACAG	TGCGCACTG.AAGGAACAG
TGCGCACTG.AGTCCGTGT	TGCGCACTG.AGTCCGTGT
TGCGCACTG.ATCTCGTGA	TGCGCACTG.ATCTCGTGA
TGCGCACTG.CCAACAACA	TGCGCACTG.CCAACAACA
TGCGCACTG.CTCGACGAT	TGCGCACTG.CTCGACGAT
TGCGCACTG.CTGAGATAG	TGCGCACTG.CTGAGATAG
TGCGCACTG.GGAGACACA	TGCGCACTG.GGAGACACA
TGCGCTGCA.ACAATTCGG	TGCGCTGCA.ACAATTCGG
TGCGCTGCA.ATATAGCGT	TGCGCTGCA.ATATAGCGT
TGCGCTGCA.GGAACCTAG	TGCGCTGCA.GGAACCTAG
TGCGCTGCA.GTAGTGGAG	TGCGCTGCA.GTAGTGGAG
TGCGCTGCA.TCACATACT	TGCGCTGCA.TCACATACT
TGCGTAATC.AACTTAGCT	TGCGTAATC.AACTTAGCT
TGCGTAATC.CGTATTCCT	TGCGTAATC.CGTATTCCT
TGCGTAATC.CTCATGCCA	TGCGTAATC.CTCATGCCA
TGCGTAATC.TGTGTAGAG	TGCGTAATC.TGTGTAGAG
TGCGTATCT.AAGGTCTGA	TGCGTATCT.AAGGTCTGA
TGCGTATCT.CAACGTCTT	TGCGTATCT.CAACGTCTT
TGCGTATCT.CCAACAACA	TGCGTATCT.CCAACAACA
TGCGTATCT.CCTACTAGA	TGCGTATCT.CCTACTAGA
TGCGTATCT.GCGAAGACA	TGCGTATCT.GCGAAGACA
TGCGTATCT.GTCCTTCAT	TGCGTATCT.GTCCTTCAT
TGCGTATCT.TACCTCACT	TGCGTATCT.TACCTCACT
TGCGTATCT.TATAGTGCG	TGCGTATCT.TATAGTGCG
TGCGTCTTA.AATCGCCAT	TGCGTCTTA.AATCGCCAT
TGCGTCTTA.ACCGTCACG	TGCGTCTTA.ACCGTCACG
TGCGTCTTA.AGCATATGG	TGCGTCTTA.AGCATATGG
TGCGTCTTA.CACTGCTTA	TGCGTCTTA.CACTGCTTA
TGCGTCTTA.CAGTCCTAA	TGCGTCTTA.CAGTCCTAA
TGCGTCTTA.GCGTCGTCT	TGCGTCTTA.GCGTCGTCT
TGCGTCTTA.GTGAATGCC	TGCGTCTTA.GTGAATGCC
TGCGTCTTA.TCAGTAAGC	TGCGTCTTA.TCAGTAAGC
TGCGTGCCA.ACGACATCT	TGCGTGCCA.ACGACATCT
TGCGTGCCA.CATCCGACA	TGCGTGCCA.CATCCGACA
TGCGTGCCA.CCATATGCC	TGCGTGCCA.CCATATGCC
TGCGTGCCA.CGTGCTTGA	TGCGTGCCA.CGTGCTTGA
TGCGTGCCA.GACAATGTT	TGCGTGCCA.GACAATGTT
TGCGTGCCA.GTTGACCAT	TGCGTGCCA.GTTGACCAT
TGCGTGCCA.TGAGACAGC	TGCGTGCCA.TGAGACAGC
TGCTATGAA.AGAAGCTGC	TGCTATGAA.AGAAGCTGC
TGCTATGAA.GACGCCGTA	TGCTATGAA.GACGCCGTA
TGCTATGAA.GATAGTTCT	TGCTATGAA.GATAGTTCT
TGCTATGAA.GTCCGCTCA	TGCTATGAA.GTCCGCTCA
TGCTATGAA.TACTACTGT	TGCTATGAA.TACTACTGT
TGCTATGAA.TCGTGACGT	TGCTATGAA.TCGTGACGT
TGCTATGAA.TGCTCCTCC	TGCTATGAA.TGCTCCTCC
TGCTCACAC.AAGACTGGT	TGCTCACAC.AAGACTGGT
TGCTCACAC.AAGAGAGAG	TGCTCACAC.AAGAGAGAG
TGCTCACAC.AAGCCACAC	TGCTCACAC.AAGCCACAC
TGCTCACAC.ACCGGAAGG	TGCTCACAC.ACCGGAAGG
TGCTCACAC.AGTCGATCA	TGCTCACAC.AGTCGATCA
TGCTCACAC.ATATGCAGC	TGCTCACAC.ATATGCAGC
TGCTCACAC.GAACCAGTT	TGCTCACAC.GAACCAGTT
TGCTCACAC.TGGTAGCAG	TGCTCACAC.TGGTAGCAG
TGCTCACAC.TTCCTCGGT	TGCTCACAC.TTCCTCGGT
TGCTCAGCG.CCTAGCAAT	TGCTCAGCG.CCTAGCAAT
TGCTCAGCG.TAGTAGTCT	TGCTCAGCG.TAGTAGTCT
TGCTCAGCG.TGATCTCGG	TGCTCAGCG.TGATCTCGG
TGCTCAGCG.TTGTAATGC	TGCTCAGCG.TTGTAATGC
TGCTCCTCC.AGTGACGAT	TGCTCCTCC.AGTGACGAT
TGCTCCTCC.ATCACCGCA	TGCTCCTCC.ATCACCGCA
TGCTCCTCC.GAACTATGG	TGCTCCTCC.GAACTATGG
TGCTCCTCC.GCAACCAAC	TGCTCCTCC.GCAACCAAC
TGCTGCGTC.AACTGATTC	TGCTGCGTC.AACTGATTC
TGCTGCGTC.ATACCGCTT	TGCTGCGTC.ATACCGCTT
TGCTGCGTC.ATCACCGCA	TGCTGCGTC.ATCACCGCA
TGCTGCGTC.CGGAATGCA	TGCTGCGTC.CGGAATGCA
TGCTGCGTC.GCACGCATT	TGCTGCGTC.GCACGCATT
TGCTGCGTC.GTCTGACGT	TGCTGCGTC.GTCTGACGT
TGCTGCGTC.TCCACCTCA	TGCTGCGTC.TCCACCTCA
TGCTGCGTC.TGATTCACC	TGCTGCGTC.TGATTCACC
TGCTGCGTC.TGTTGTCGA	TGCTGCGTC.TGTTGTCGA
TGCTTACGG.CTGGTAATC	TGCTTACGG.CTGGTAATC
TGCTTACGG.TAGTCAGAC	TGCTTACGG.TAGTCAGAC
TGCTTACGG.TATGATGTG	TGCTTACGG.TATGATGTG
TGCTTACGG.TGCTTACGG	TGCTTACGG.TGCTTACGG
TGGAACTAA.AGATGTTGG	TGGAACTAA.AGATGTTGG
TGGAAGATT.CCGGTTGAG	TGGAAGATT.CCGGTTGAG
TGGAAGATT.TGGTGGTAA	TGGAAGATT.TGGTGGTAA
TGGAATCGT.GCCTTCCAT	TGGAATCGT.GCCTTCCAT
TGGACGAGA.ACGTTCAAT	TGGACGAGA.ACGTTCAAT
TGGACGAGA.ATAGTGGTT	TGGACGAGA.ATAGTGGTT
TGGACGAGA.ATTAGCGGT	TGGACGAGA.ATTAGCGGT
TGGACGAGA.ATTCACCTC	TGGACGAGA.ATTCACCTC
TGGACGAGA.CCTTCCTCA	TGGACGAGA.CCTTCCTCA
TGGACGAGA.CGTGCTTGA	TGGACGAGA.CGTGCTTGA
TGGACGAGA.CTTAACAGC	TGGACGAGA.CTTAACAGC
TGGACGAGA.GACCGGTAG	TGGACGAGA.GACCGGTAG
TGGACGAGA.GTACGTCTA	TGGACGAGA.GTACGTCTA
TGGACGAGA.TAGTCGCAT	TGGACGAGA.TAGTCGCAT
TGGACGAGA.TCCAAGTAA	TGGACGAGA.TCCAAGTAA
TGGACGAGA.TTACGCTCG	TGGACGAGA.TTACGCTCG
TGGACTGCC.AATCAGGAG	TGGACTGCC.AATCAGGAG
TGGACTGCC.TAACCGTGA	TGGACTGCC.TAACCGTGA
TGGAGAACC.ACCTAGCAC	TGGAGAACC.ACCTAGCAC
TGGAGAACC.ACGGTGCCT	TGGAGAACC.ACGGTGCCT
TGGAGAACC.AGTTCGATA	TGGAGAACC.AGTTCGATA
TGGAGAACC.CATATGTCG	TGGAGAACC.CATATGTCG
TGGAGAACC.GAGACGATC	TGGAGAACC.GAGACGATC
TGGAGAACC.GGAGCATCT	TGGAGAACC.GGAGCATCT
TGGAGAACC.GTTGCTCAG	TGGAGAACC.GTTGCTCAG
TGGAGAACC.TATCTGTCA	TGGAGAACC.TATCTGTCA
TGGAGAGTG.CAGTCCTAA	TGGAGAGTG.CAGTCCTAA
TGGAGAGTG.CTTCCTGAT	TGGAGAGTG.CTTCCTGAT
TGGAGAGTG.GGAAGGTAT	TGGAGAGTG.GGAAGGTAT
TGGAGAGTG.TGCCGACTA	TGGAGAGTG.TGCCGACTA
TGGAGAGTG.TGTAGCAAG	TGGAGAGTG.TGTAGCAAG
TGGAGTGGA.AATGTGCGT	TGGAGTGGA.AATGTGCGT
TGGAGTGGA.CAATGTGCT	TGGAGTGGA.CAATGTGCT
TGGAGTGGA.CATCCGACA	TGGAGTGGA.CATCCGACA
TGGAGTGGA.GCTATGTAA	TGGAGTGGA.GCTATGTAA
TGGAGTGGA.TAACGTGTC	TGGAGTGGA.TAACGTGTC
TGGAGTGGA.TTGGAGAAC	TGGAGTGGA.TTGGAGAAC
TGGATAGGT.AACAACTGG	TGGATAGGT.AACAACTGG
TGGATAGGT.AACTTAGCT	TGGATAGGT.AACTTAGCT
TGGATAGGT.AGCGCATGA	TGGATAGGT.AGCGCATGA
TGGATAGGT.AGTCTAAGC	TGGATAGGT.AGTCTAAGC
TGGATAGGT.ATGGATATC	TGGATAGGT.ATGGATATC
TGGATAGGT.CAATGTGCT	TGGATAGGT.CAATGTGCT
TGGATAGGT.CACTGCTTA	TGGATAGGT.CACTGCTTA
TGGATAGGT.CCGACTGTT	TGGATAGGT.CCGACTGTT
TGGATAGGT.GATCTGAAT	TGGATAGGT.GATCTGAAT
TGGATAGGT.GCTTACGTT	TGGATAGGT.GCTTACGTT
TGGATAGGT.GTTAATTCG	TGGATAGGT.GTTAATTCG
TGGATAGGT.TACGACTTG	TGGATAGGT.TACGACTTG
TGGATAGGT.TAGCGCAGC	TGGATAGGT.TAGCGCAGC
TGGATAGGT.TCTCATCGG	TGGATAGGT.TCTCATCGG
TGGATTAGC.ACCTAGTTA	TGGATTAGC.ACCTAGTTA
TGGATTAGC.ATGCGCTAC	TGGATTAGC.ATGCGCTAC
TGGATTAGC.CCGTCAGGT	TGGATTAGC.CCGTCAGGT
TGGATTAGC.CGTTCCATT	TGGATTAGC.CGTTCCATT
TGGATTAGC.CTGCGTCAC	TGGATTAGC.CTGCGTCAC
TGGATTAGC.GCTACCTTA	TGGATTAGC.GCTACCTTA
TGGATTAGC.GGTAACTAC	TGGATTAGC.GGTAACTAC
TGGATTAGC.TCGTGACGT	TGGATTAGC.TCGTGACGT
TGGTAACCA.ACGCTATGT	TGGTAACCA.ACGCTATGT
TGGTAACCA.AGCGGAACA	TGGTAACCA.AGCGGAACA
TGGTAACCA.ATGTGACGA	TGGTAACCA.ATGTGACGA
TGGTAACCA.CATAAGATC	TGGTAACCA.CATAAGATC
TGGTAACCA.CTTGCACAA	TGGTAACCA.CTTGCACAA
TGGTAACCA.GTCTTATGC	TGGTAACCA.GTCTTATGC
TGGTAACCA.TCTAGCTGG	TGGTAACCA.TCTAGCTGG
TGGTAGCAG.AACGCCTAC	TGGTAGCAG.AACGCCTAC
TGGTAGCAG.AGGATTACT	TGGTAGCAG.AGGATTACT
TGGTAGCAG.CCAACGGAA	TGGTAGCAG.CCAACGGAA
TGGTAGCAG.CGATTCGAG	TGGTAGCAG.CGATTCGAG
TGGTAGCAG.GATTAGTGT	TGGTAGCAG.GATTAGTGT
TGGTAGCAG.GCTGGTTCG	TGGTAGCAG.GCTGGTTCG
TGGTAGCAG.GTCTCTTCA	TGGTAGCAG.GTCTCTTCA
TGGTAGCAG.TCCGATCTG	TGGTAGCAG.TCCGATCTG
TGGTCCTAG.AGTTGTGTA	TGGTCCTAG.AGTTGTGTA
TGGTCCTAG.ATACCGCTT	TGGTCCTAG.ATACCGCTT
TGGTCCTAG.CCTCTTGTA	TGGTCCTAG.CCTCTTGTA
TGGTCCTAG.CTGTCACTT	TGGTCCTAG.CTGTCACTT
TGGTCCTAG.TGCGTCTTA	TGGTCCTAG.TGCGTCTTA
TGGTCCTAG.TGGTCGCTA	TGGTCCTAG.TGGTCGCTA
TGGTCCTAG.TTACGGACC	TGGTCCTAG.TTACGGACC
TGGTCGCTA.CAGCAGTAC	TGGTCGCTA.CAGCAGTAC
TGGTCGCTA.CCTAGTCTC	TGGTCGCTA.CCTAGTCTC
TGGTCGCTA.CGAATGAGT	TGGTCGCTA.CGAATGAGT
TGGTCGCTA.CTGATCCGA	TGGTCGCTA.CTGATCCGA
TGGTCTACG.AACGTCGAG	TGGTCTACG.AACGTCGAG
TGGTCTACG.ACCTCCTAG	TGGTCTACG.ACCTCCTAG
TGGTCTACG.ACGAATCGC	TGGTCTACG.ACGAATCGC
TGGTCTACG.AGAGAGTGG	TGGTCTACG.AGAGAGTGG
TGGTCTACG.CATTCAGTT	TGGTCTACG.CATTCAGTT
TGGTGCCTG.CACAACGCT	TGGTGCCTG.CACAACGCT
TGGTGCCTG.CTGCTTAGG	TGGTGCCTG.CTGCTTAGG
TGGTGGATC.CACATTCTG	TGGTGGATC.CACATTCTG
TGGTGGATC.CATGGTTAC	TGGTGGATC.CATGGTTAC
TGGTGGATC.TGAGGTCTC	TGGTGGATC.TGAGGTCTC
TGGTGGTAA.ACACACCGT	TGGTGGTAA.ACACACCGT
TGGTGGTAA.ACTCTGCTC	TGGTGGTAA.ACTCTGCTC
TGGTTATAC.AAGACGAAG	TGGTTATAC.AAGACGAAG
TGGTTATAC.AATCCTCGT	TGGTTATAC.AATCCTCGT
TGGTTATAC.GACACGCAA	TGGTTATAC.GACACGCAA
TGGTTATAC.GATTGGAAG	TGGTTATAC.GATTGGAAG
TGGTTATAC.GCACGTAGA	TGGTTATAC.GCACGTAGA
TGGTTATAC.TACACGGTC	TGGTTATAC.TACACGGTC
TGGTTATAC.TGACGATGA	TGGTTATAC.TGACGATGA
TGGTTATAC.TGTGCTAAC	TGGTTATAC.TGTGCTAAC
TGGTTATAC.TTAGTCGGA	TGGTTATAC.TTAGTCGGA
TGTAACAGT.ATGAGTGTG	TGTAACAGT.ATGAGTGTG
TGTAACAGT.CACAGCGAA	TGTAACAGT.CACAGCGAA
TGTAACAGT.CCAAGCGAG	TGTAACAGT.CCAAGCGAG
TGTAACAGT.CGGATTCTC	TGTAACAGT.CGGATTCTC
TGTAACAGT.GTCCTTCAT	TGTAACAGT.GTCCTTCAT
TGTAACAGT.TAGCACACG	TGTAACAGT.TAGCACACG
TGTAACAGT.TGCTATGAA	TGTAACAGT.TGCTATGAA
TGTACACGA.CAGTCTAAC	TGTACACGA.CAGTCTAAC
TGTACACGA.CCGCAGAAT	TGTACACGA.CCGCAGAAT
TGTACACGA.GCTGATGTC	TGTACACGA.GCTGATGTC
TGTACACGA.TACGTTACC	TGTACACGA.TACGTTACC
TGTAGATCG.AGAAGTAAC	TGTAGATCG.AGAAGTAAC
TGTAGATCG.AGTTGAGCG	TGTAGATCG.AGTTGAGCG
TGTAGATCG.ATCTCGTGA	TGTAGATCG.ATCTCGTGA
TGTAGATCG.CACTACAGG	TGTAGATCG.CACTACAGG
TGTAGATCG.GCTGACAGA	TGTAGATCG.GCTGACAGA
TGTAGATCG.GGATTACGC	TGTAGATCG.GGATTACGC
TGTAGCAAG.ACGTATGTC	TGTAGCAAG.ACGTATGTC
TGTAGCAAG.CCAACGGAA	TGTAGCAAG.CCAACGGAA
TGTAGGTTA.CGGACAAGT	TGTAGGTTA.CGGACAAGT
