ATGCGGATT.ACTCTGCTC	ATGCGGATT.ACTCTGCTC
ATGCGGATT.GAATAAGAG	ATGCGGATT.GAATAAGAG
ATGCGGATT.GACGTTCAG	ATGCGGATT.GACGTTCAG
ATGCGGATT.GACTCTCAC	ATGCGGATT.GACTCTCAC
ATGCGGATT.GAGACTCGA	ATGCGGATT.GAGACTCGA
ATGCGGATT.GGACTCCTT	ATGCGGATT.GGACTCCTT
ATGCGGATT.GTGATGTGC	ATGCGGATT.GTGATGTGC
ATGCGGATT.TAGGATTAG	ATGCGGATT.TAGGATTAG
ATGCGGATT.TCAGAGCGT	ATGCGGATT.TCAGAGCGT
ATGCGGATT.TCCAACGTG	ATGCGGATT.TCCAACGTG
ATGCTCACC.ACTCCAACT	ATGCTCACC.ACTCCAACT
ATGCTCACC.CCGCTCATG	ATGCTCACC.CCGCTCATG
ATGCTCACC.CGTATAGCG	ATGCTCACC.CGTATAGCG
ATGCTCACC.GTAACCATA	ATGCTCACC.GTAACCATA
ATGCTGTCG.AGACTTCGT	ATGCTGTCG.AGACTTCGT
ATGCTGTCG.CATAATTGG	ATGCTGTCG.CATAATTGG
ATGCTGTCG.GAGGTCACG	ATGCTGTCG.GAGGTCACG
ATGCTGTCG.GCGCTACCT	ATGCTGTCG.GCGCTACCT
ATGCTGTCG.TAGAGCGTC	ATGCTGTCG.TAGAGCGTC
ATGCTGTCG.TGAGAGGAC	ATGCTGTCG.TGAGAGGAC
ATGCTTCAG.AGCATATGG	ATGCTTCAG.AGCATATGG
ATGCTTCAG.AGTCGATCA	ATGCTTCAG.AGTCGATCA
ATGCTTCAG.ATGACACAA	ATGCTTCAG.ATGACACAA
ATGCTTCAG.ATGAGGTAT	ATGCTTCAG.ATGAGGTAT
ATGCTTCAG.CAATGTGCT	ATGCTTCAG.CAATGTGCT
ATGCTTCAG.CGAAGAGGT	ATGCTTCAG.CGAAGAGGT
ATGCTTCAG.CTATGGATG	ATGCTTCAG.CTATGGATG
ATGCTTCAG.GATGCTCCT	ATGCTTCAG.GATGCTCCT
ATGCTTCAG.TCTGATGAA	ATGCTTCAG.TCTGATGAA
ATGGACGTT.CAAGGTGTG	ATGGACGTT.CAAGGTGTG
ATGGACGTT.GTGCACGAG	ATGGACGTT.GTGCACGAG
ATGGACGTT.TGTAGATCG	ATGGACGTT.TGTAGATCG
ATGGAGAGT.ACCGTCCTA	ATGGAGAGT.ACCGTCCTA
ATGGAGAGT.CGGAATGCA	ATGGAGAGT.CGGAATGCA
ATGGAGAGT.CTCCGCATT	ATGGAGAGT.CTCCGCATT
ATGGAGAGT.GTGCATCAA	ATGGAGAGT.GTGCATCAA
ATGGAGGAA.AACTGCGAC	ATGGAGGAA.AACTGCGAC
ATGGAGGAA.AGTGACGAT	ATGGAGGAA.AGTGACGAT
ATGGAGGAA.GGTCTCATG	ATGGAGGAA.GGTCTCATG
ATGGAGGAA.TACGACTTG	ATGGAGGAA.TACGACTTG
ATGGAGGAA.TCCACGTGC	ATGGAGGAA.TCCACGTGC
ATGGAGGAA.TGTAGATCG	ATGGAGGAA.TGTAGATCG
ATGGAGGAA.TGTAGGTTA	ATGGAGGAA.TGTAGGTTA
ATGGATATC.CATTGCAGA	ATGGATATC.CATTGCAGA
ATGGATATC.CCATACGAT	ATGGATATC.CCATACGAT
ATGGATATC.CTGCTGCTT	ATGGATATC.CTGCTGCTT
ATGGATATC.TACACGGTC	ATGGATATC.TACACGGTC
ATGGATATC.TCAGGTGCA	ATGGATATC.TCAGGTGCA
ATGGATATC.TCTCCGCGT	ATGGATATC.TCTCCGCGT
ATGGATATC.TGATCGGAA	ATGGATATC.TGATCGGAA
ATGGATATC.TGTAGATCG	ATGGATATC.TGTAGATCG
ATGGTTCGA.GATCTGAAT	ATGGTTCGA.GATCTGAAT
ATGGTTCGA.GTAACGCGA	ATGGTTCGA.GTAACGCGA
ATGGTTCGA.GTCCACAAC	ATGGTTCGA.GTCCACAAC
ATGTCCTCC.AGATCTGAC	ATGTCCTCC.AGATCTGAC
ATGTCCTCC.CCAGATCAC	ATGTCCTCC.CCAGATCAC
ATGTCCTCC.CGCACTGAA	ATGTCCTCC.CGCACTGAA
ATGTCCTCC.CGGTGTTAC	ATGTCCTCC.CGGTGTTAC
ATGTCCTCC.GAATCGAGA	ATGTCCTCC.GAATCGAGA
ATGTCCTCC.GCAGCTTGA	ATGTCCTCC.GCAGCTTGA
ATGTCCTCC.TCAAGCGTA	ATGTCCTCC.TCAAGCGTA
ATGTCGCCT.TGTGCTAAC	ATGTCGCCT.TGTGCTAAC
ATGTGACGA.AGAGAGTGG	ATGTGACGA.AGAGAGTGG
ATGTGACGA.ATTAGCACA	ATGTGACGA.ATTAGCACA
ATGTGACGA.ATTGGTTCC	ATGTGACGA.ATTGGTTCC
ATGTGACGA.CACCAGAAG	ATGTGACGA.CACCAGAAG
ATGTGACGA.CTAACTAAG	ATGTGACGA.CTAACTAAG
ATGTGACGA.TGGATTAGC	ATGTGACGA.TGGATTAGC
ATGTGACGA.TTATGAGGA	ATGTGACGA.TTATGAGGA
ATGTGAGAC.AGATCTGAC	ATGTGAGAC.AGATCTGAC
ATGTGAGAC.CTTAACAGC	ATGTGAGAC.CTTAACAGC
ATGTGAGAC.GACAATGTT	ATGTGAGAC.GACAATGTT
ATGTGAGAC.GACGCTTGC	ATGTGAGAC.GACGCTTGC
ATGTGAGAC.GGACGAGCA	ATGTGAGAC.GGACGAGCA
ATGTGAGAC.TTACTTACG	ATGTGAGAC.TTACTTACG
ATTAAGACC.ACAGAGATG	ATTAAGACC.ACAGAGATG
ATTAAGACC.CATGTCCTG	ATTAAGACC.CATGTCCTG
ATTAAGACC.GACACCGAT	ATTAAGACC.GACACCGAT
ATTAAGACC.GCTACCGAG	ATTAAGACC.GCTACCGAG
ATTAGCACA.AAGTAGGAC	ATTAGCACA.AAGTAGGAC
ATTAGCACA.ACATGACTA	ATTAGCACA.ACATGACTA
ATTAGCACA.AGATGTTGG	ATTAGCACA.AGATGTTGG
ATTAGCACA.ATCCAATGA	ATTAGCACA.ATCCAATGA
ATTAGCACA.CGTACATCT	ATTAGCACA.CGTACATCT
ATTAGCACA.CTCGCAAGA	ATTAGCACA.CTCGCAAGA
ATTAGCACA.CTGTAGAAG	ATTAGCACA.CTGTAGAAG
ATTAGCACA.GTAACGCGA	ATTAGCACA.GTAACGCGA
ATTAGCACA.GTACCTAAC	ATTAGCACA.GTACCTAAC
ATTAGCACA.TGTTGTCGA	ATTAGCACA.TGTTGTCGA
ATTAGCACA.TTGATGAGT	ATTAGCACA.TTGATGAGT
ATTAGCCAC.AAGACTGGT	ATTAGCCAC.AAGACTGGT
ATTAGCCAC.ACGCAAGAT	ATTAGCCAC.ACGCAAGAT
ATTAGCCAC.ACGTTCAAT	ATTAGCCAC.ACGTTCAAT
ATTAGCCAC.AGCGTAGAA	ATTAGCCAC.AGCGTAGAA
ATTAGCCAC.AGGTCAGCA	ATTAGCCAC.AGGTCAGCA
ATTAGCCAC.ATGCTGTCG	ATTAGCCAC.ATGCTGTCG
ATTAGCCAC.CACACCTGT	ATTAGCCAC.CACACCTGT
ATTAGCCAC.GATTAGTGT	ATTAGCCAC.GATTAGTGT
ATTAGCCAC.GCTGGTAAC	ATTAGCCAC.GCTGGTAAC
ATTAGCCAC.GGACAGATT	ATTAGCCAC.GGACAGATT
ATTAGCGGT.AGATGTTGG	ATTAGCGGT.AGATGTTGG
ATTAGCGGT.AGTAATGGT	ATTAGCGGT.AGTAATGGT
ATTAGCGGT.TCGATTCAG	ATTAGCGGT.TCGATTCAG
ATTATGCAG.AGTAACGTA	ATTATGCAG.AGTAACGTA
ATTATGCAG.ATATTCGCA	ATTATGCAG.ATATTCGCA
ATTATGCAG.GCAGCAGTG	ATTATGCAG.GCAGCAGTG
ATTATGCAG.GCCAACAAT	ATTATGCAG.GCCAACAAT
ATTATGCAG.GCCGAACCA	ATTATGCAG.GCCGAACCA
ATTATGCAG.TATGTACCT	ATTATGCAG.TATGTACCT
ATTATGCAG.TCAATCTAG	ATTATGCAG.TCAATCTAG
ATTATGCAG.TGATTCACC	ATTATGCAG.TGATTCACC
ATTCACCTC.CGGAATGCA	ATTCACCTC.CGGAATGCA
ATTCACCTC.TAGGTCAAC	ATTCACCTC.TAGGTCAAC
ATTCACCTC.TCTAGCTGG	ATTCACCTC.TCTAGCTGG
ATTCATGTG.CGCTTATGA	ATTCATGTG.CGCTTATGA
ATTCATGTG.CTTGATCTA	ATTCATGTG.CTTGATCTA
ATTCATGTG.GAGATACAC	ATTCATGTG.GAGATACAC
ATTCATGTG.TCCTGAGAC	ATTCATGTG.TCCTGAGAC
ATTCCGTAC.ACCATACTT	ATTCCGTAC.ACCATACTT
ATTCCGTAC.AGCGTAGAA	ATTCCGTAC.AGCGTAGAA
ATTCCGTAC.CAGCAGTAC	ATTCCGTAC.CAGCAGTAC
ATTCCGTAC.GCAGCTTGA	ATTCCGTAC.GCAGCTTGA
ATTCCGTAC.TAGTCGCAT	ATTCCGTAC.TAGTCGCAT
ATTCCGTAC.TGAACGTCA	ATTCCGTAC.TGAACGTCA
ATTCCTACG.CGATACTCT	ATTCCTACG.CGATACTCT
ATTCGAAGA.ACAGCATCA	ATTCGAAGA.ACAGCATCA
ATTCGAAGA.ATTCGAAGA	ATTCGAAGA.ATTCGAAGA
ATTCGAAGA.GATACTGTG	ATTCGAAGA.GATACTGTG
ATTCGAAGA.TCATGCAGG	ATTCGAAGA.TCATGCAGG
ATTCGCTTA.AACTGATTC	ATTCGCTTA.AACTGATTC
ATTCGCTTA.ACTAAGTTC	ATTCGCTTA.ACTAAGTTC
ATTCGCTTA.CATCCTCTC	ATTCGCTTA.CATCCTCTC
ATTCGCTTA.CATTGACAA	ATTCGCTTA.CATTGACAA
ATTCGCTTA.CCTGCTCCA	ATTCGCTTA.CCTGCTCCA
ATTCGCTTA.GATATATCC	ATTCGCTTA.GATATATCC
ATTCGCTTA.GGTTAGATG	ATTCGCTTA.GGTTAGATG
ATTCGCTTA.GTCGCAGGT	ATTCGCTTA.GTCGCAGGT
ATTCGCTTA.TGAGGTCTC	ATTCGCTTA.TGAGGTCTC
ATTCGCTTA.TTCTGGTGC	ATTCGCTTA.TTCTGGTGC
ATTCTCTGG.ACTCTGCTC	ATTCTCTGG.ACTCTGCTC
ATTCTCTGG.AGTAAGCCA	ATTCTCTGG.AGTAAGCCA
ATTCTCTGG.ATCTCGAAC	ATTCTCTGG.ATCTCGAAC
ATTCTCTGG.CCGAATATG	ATTCTCTGG.CCGAATATG
ATTCTCTGG.CCTAGAGTA	ATTCTCTGG.CCTAGAGTA
ATTCTCTGG.GTTGCTCAG	ATTCTCTGG.GTTGCTCAG
ATTCTCTGG.TCTGATGAA	ATTCTCTGG.TCTGATGAA
ATTGACACG.ACACCGCCA	ATTGACACG.ACACCGCCA
ATTGACACG.ATGAGATCC	ATTGACACG.ATGAGATCC
ATTGACACG.CATCCGACA	ATTGACACG.CATCCGACA
ATTGACACG.CTGACGATG	ATTGACACG.CTGACGATG
ATTGACACG.GGAACCTAG	ATTGACACG.GGAACCTAG
ATTGACACG.TAGCTAAGA	ATTGACACG.TAGCTAAGA
ATTGACACG.TCGGATGTT	ATTGACACG.TCGGATGTT
ATTGATCAC.AGAGCCGCA	ATTGATCAC.AGAGCCGCA
ATTGATCAC.ATGCGCTAC	ATTGATCAC.ATGCGCTAC
ATTGATCAC.TTCAGTGCC	ATTGATCAC.TTCAGTGCC
ATTGATTGG.ATCTACATC	ATTGATTGG.ATCTACATC
ATTGATTGG.CGGATTCTC	ATTGATTGG.CGGATTCTC
ATTGATTGG.GCCTAACGG	ATTGATTGG.GCCTAACGG
ATTGATTGG.GCTGAGCAG	ATTGATTGG.GCTGAGCAG
ATTGATTGG.GTCCGCTCA	ATTGATTGG.GTCCGCTCA
ATTGATTGG.GTCGTTGCG	ATTGATTGG.GTCGTTGCG
ATTGATTGG.TACTCGACC	ATTGATTGG.TACTCGACC
ATTGATTGG.TCGCCAAGC	ATTGATTGG.TCGCCAAGC
ATTGATTGG.TGGTGCCTG	ATTGATTGG.TGGTGCCTG
ATTGATTGG.TTAGGAAGG	ATTGATTGG.TTAGGAAGG
ATTGCCGAC.ACGACTGCG	ATTGCCGAC.ACGACTGCG
ATTGCCGAC.AGCGACACC	ATTGCCGAC.AGCGACACC
ATTGCCGAC.CCTCGAGAG	ATTGCCGAC.CCTCGAGAG
ATTGCCGAC.CCTGCTCCA	ATTGCCGAC.CCTGCTCCA
ATTGCCGAC.CTCGCTACG	ATTGCCGAC.CTCGCTACG
ATTGCCGAC.GGTCGGTCT	ATTGCCGAC.GGTCGGTCT
ATTGCCGAC.GTGCGAGTA	ATTGCCGAC.GTGCGAGTA
ATTGCCGAC.TAAGTACAC	ATTGCCGAC.TAAGTACAC
ATTGCGCTA.CTTCCGGTA	ATTGCGCTA.CTTCCGGTA
ATTGCGCTA.GCCACATGG	ATTGCGCTA.GCCACATGG
ATTGCGCTA.GCGCATTAC	ATTGCGCTA.GCGCATTAC
ATTGCGCTA.TAGCTAAGA	ATTGCGCTA.TAGCTAAGA
ATTGCGCTA.TCTAGCTGG	ATTGCGCTA.TCTAGCTGG
ATTGCGCTA.TGCTATGAA	ATTGCGCTA.TGCTATGAA
ATTGGTTCC.AACAGATCG	ATTGGTTCC.AACAGATCG
ATTGGTTCC.CGCATAACT	ATTGGTTCC.CGCATAACT
ATTGGTTCC.GACGTCAAT	ATTGGTTCC.GACGTCAAT
ATTGGTTCC.GATCGTTGA	ATTGGTTCC.GATCGTTGA
ATTGGTTCC.GCGCTCTAT	ATTGGTTCC.GCGCTCTAT
CAACACCTA.AGATGAAGA	CAACACCTA.AGATGAAGA
CAACACCTA.AGATGTTGG	CAACACCTA.AGATGTTGG
CAACACCTA.ATGCCTTCA	CAACACCTA.ATGCCTTCA
CAACACCTA.CATCCACCG	CAACACCTA.CATCCACCG
CAACACCTA.GAGACTCGA	CAACACCTA.GAGACTCGA
CAACACCTA.GCAACCAAC	CAACACCTA.GCAACCAAC
CAACACCTA.GCGAGCAAG	CAACACCTA.GCGAGCAAG
CAACACCTA.GTACGAACG	CAACACCTA.GTACGAACG
CAACACCTA.TCGTGACGT	CAACACCTA.TCGTGACGT
CAACACTCC.AATGCACTT	CAACACTCC.AATGCACTT
CAACACTCC.ATTCATGTG	CAACACTCC.ATTCATGTG
CAACACTCC.GAATTGTTG	CAACACTCC.GAATTGTTG
CAACACTCC.GCACAACTC	CAACACTCC.GCACAACTC
CAACACTCC.GCAGCTTGA	CAACACTCC.GCAGCTTGA
CAACACTCC.TGAGCTAGA	CAACACTCC.TGAGCTAGA
CAACACTCC.TTGGTAACT	CAACACTCC.TTGGTAACT
CAACCGGTC.ACTCATTCA	CAACCGGTC.ACTCATTCA
CAACCGGTC.ATGGACGTT	CAACCGGTC.ATGGACGTT
CAACCGGTC.CAGGAGCCT	CAACCGGTC.CAGGAGCCT
CAACCGGTC.CGTCTGCTG	CAACCGGTC.CGTCTGCTG
CAACCGGTC.CTTGGATCA	CAACCGGTC.CTTGGATCA
CAACCTGGT.ACCGAGTAG	CAACCTGGT.ACCGAGTAG
CAACCTGGT.ATATAGCGT	CAACCTGGT.ATATAGCGT
CAACCTGGT.ATATGTCCA	CAACCTGGT.ATATGTCCA
CAACCTGGT.ATGTGACGA	CAACCTGGT.ATGTGACGA
CAACCTGGT.CATTCCGAG	CAACCTGGT.CATTCCGAG
CAACCTGGT.GAGTTATAG	CAACCTGGT.GAGTTATAG
CAACCTGGT.TGAGGTCTC	CAACCTGGT.TGAGGTCTC
CAACCTGGT.TGCGTCTTA	CAACCTGGT.TGCGTCTTA
CAACCTGGT.TGCTTACGG	CAACCTGGT.TGCTTACGG
CAACCTGGT.TGTCATAGC	CAACCTGGT.TGTCATAGC
CAACGATCG.ACGAGAGCA	CAACGATCG.ACGAGAGCA
CAACGATCG.CCACTGAAG	CAACGATCG.CCACTGAAG
CAACGATCG.CCGACGTCA	CAACGATCG.CCGACGTCA
CAACGATCG.GCACCATCG	CAACGATCG.GCACCATCG
CAACGATCG.GTACCACAA	CAACGATCG.GTACCACAA
CAACGATCG.TACCTATCC	CAACGATCG.TACCTATCC
CAACGATCG.TAGTGATCC	CAACGATCG.TAGTGATCC
CAACGCACA.TAACGGATA	CAACGCACA.TAACGGATA
CAACGCACA.TGAGAGGAC	CAACGCACA.TGAGAGGAC
CAACGTCTT.AATCCGCTG	CAACGTCTT.AATCCGCTG
CAACGTCTT.AGTCATACT	CAACGTCTT.AGTCATACT
CAACGTCTT.CCAAGCGAG	CAACGTCTT.CCAAGCGAG
CAACGTCTT.CCGCAATGG	CAACGTCTT.CCGCAATGG
CAACGTCTT.CCTCTTGTA	CAACGTCTT.CCTCTTGTA
CAACGTCTT.GCGATATGA	CAACGTCTT.GCGATATGA
CAACGTCTT.GTACGTCTA	CAACGTCTT.GTACGTCTA
CAACGTCTT.TCCAGCTAT	CAACGTCTT.TCCAGCTAT
CAACTCCAG.AAGCAACTA	CAACTCCAG.AAGCAACTA
CAACTCCAG.AGTCGCGAC	CAACTCCAG.AGTCGCGAC
CAACTCCAG.CAGTCCTAA	CAACTCCAG.CAGTCCTAA
CAACTCCAG.GATGTTACA	CAACTCCAG.GATGTTACA
CAACTCCAG.TAGGTCAAC	CAACTCCAG.TAGGTCAAC
CAACTCCAG.TCCAGCAGC	CAACTCCAG.TCCAGCAGC
CAACTCCAG.TGGTAGCAG	CAACTCCAG.TGGTAGCAG
CAAGAACCG.ACTCTGCTC	CAAGAACCG.ACTCTGCTC
CAAGAACCG.AGAGCGGAG	CAAGAACCG.AGAGCGGAG
CAAGAACCG.ATAGTCAGT	CAAGAACCG.ATAGTCAGT
CAAGAACCG.CTTACATGC	CAAGAACCG.CTTACATGC
CAAGAACCG.GTGCACGAG	CAAGAACCG.GTGCACGAG
CAAGAACCG.GTTGATGCA	CAAGAACCG.GTTGATGCA
CAAGAGAGT.AGCGGTCTA	CAAGAGAGT.AGCGGTCTA
CAAGAGAGT.AGGTGTACA	CAAGAGAGT.AGGTGTACA
CAAGAGAGT.ATACCGCTT	CAAGAGAGT.ATACCGCTT
CAAGAGAGT.CAAGTCACT	CAAGAGAGT.CAAGTCACT
CAAGAGAGT.GATCCGCAC	CAAGAGAGT.GATCCGCAC
CAAGAGAGT.GGAAGTATG	CAAGAGAGT.GGAAGTATG
CAAGAGAGT.GTCTGACGT	CAAGAGAGT.GTCTGACGT
CAAGAGAGT.GTGATGTGC	CAAGAGAGT.GTGATGTGC
CAAGAGAGT.GTTCAGAAG	CAAGAGAGT.GTTCAGAAG
CAAGAGGAG.ACAATTCGG	CAAGAGGAG.ACAATTCGG
CAAGAGGAG.ACGGTGCCT	CAAGAGGAG.ACGGTGCCT
CAAGAGGAG.CAATCTCCG	CAAGAGGAG.CAATCTCCG
CAAGAGGAG.CGGAGACTT	CAAGAGGAG.CGGAGACTT
CAAGAGGAG.CGGTGAGTC	CAAGAGGAG.CGGTGAGTC
CAAGAGGAG.GTAACAGTC	CAAGAGGAG.GTAACAGTC
CAAGAGGAG.GTCACTATG	CAAGAGGAG.GTCACTATG
CAAGAGGAG.TCACAGGTA	CAAGAGGAG.TCACAGGTA
CAAGAGGAG.TCTTAGCGA	CAAGAGGAG.TCTTAGCGA
CAAGAGGAG.TGTAGCAAG	CAAGAGGAG.TGTAGCAAG
CAAGCCTCG.ACCGCTGTG	CAAGCCTCG.ACCGCTGTG
CAAGCCTCG.AGACCAGCT	CAAGCCTCG.AGACCAGCT
CAAGCCTCG.AGACTAGTA	CAAGCCTCG.AGACTAGTA
CAAGCCTCG.CACTAGACT	CAAGCCTCG.CACTAGACT
CAAGCCTCG.CATAATTGG	CAAGCCTCG.CATAATTGG
CAAGCCTCG.TCAGTGCAA	CAAGCCTCG.TCAGTGCAA
CAAGCCTCG.TCGCGTCAT	CAAGCCTCG.TCGCGTCAT
CAAGCCTCG.TCGGATGTT	CAAGCCTCG.TCGGATGTT
CAAGCGCAT.ACGAATCGC	CAAGCGCAT.ACGAATCGC
CAAGCGCAT.CAAGCTGCA	CAAGCGCAT.CAAGCTGCA
CAAGCGCAT.CAGGATCAA	CAAGCGCAT.CAGGATCAA
CAAGCGCAT.CTACGGTAT	CAAGCGCAT.CTACGGTAT
CAAGCGCAT.TACGAGTGA	CAAGCGCAT.TACGAGTGA
CAAGCTGCA.ATGCCTGTC	CAAGCTGCA.ATGCCTGTC
CAAGCTGCA.CCTGCTCCA	CAAGCTGCA.CCTGCTCCA
CAAGCTGCA.TAGCCAGTG	CAAGCTGCA.TAGCCAGTG
CAAGCTGCA.TATAATCGC	CAAGCTGCA.TATAATCGC
CAAGGTGTG.GAAGAGCAC	CAAGGTGTG.GAAGAGCAC
CAAGTACGA.AGAATCAGA	CAAGTACGA.AGAATCAGA
CAAGTACGA.CATGGTCGA	CAAGTACGA.CATGGTCGA
CAAGTACGA.CCGATCAGC	CAAGTACGA.CCGATCAGC
CAAGTACGA.CGTGCTTGA	CAAGTACGA.CGTGCTTGA
CAAGTACGA.GTCGAGTAC	CAAGTACGA.GTCGAGTAC
CAAGTACGA.GTGAATGCC	CAAGTACGA.GTGAATGCC
CAAGTCACT.GTAGCATAC	CAAGTCACT.GTAGCATAC
CAAGTCACT.GTAGGACGC	CAAGTCACT.GTAGGACGC
CAAGTCACT.TAGCAGAGT	CAAGTCACT.TAGCAGAGT
CAAGTCGAA.AACGATGAC	CAAGTCGAA.AACGATGAC
CAAGTCGAA.TACTACTGT	CAAGTCGAA.TACTACTGT
CAATACCAC.AGACGCCTG	CAATACCAC.AGACGCCTG
CAATACCAC.ATGGTTCGA	CAATACCAC.ATGGTTCGA
CAATACCAC.CATTGACAA	CAATACCAC.CATTGACAA
CAATACCAC.CTCTGCGGT	CAATACCAC.CTCTGCGGT
CAATACCAC.TGCGCACTG	CAATACCAC.TGCGCACTG
CAATACCAC.TTCACTGGA	CAATACCAC.TTCACTGGA
CAATCAAGT.AGATCGAGT	CAATCAAGT.AGATCGAGT
CAATCAAGT.CCACGAAGG	CAATCAAGT.CCACGAAGG
CAATCAAGT.CCTCAGGTG	CAATCAAGT.CCTCAGGTG
CAATCAAGT.CTCTAAGAG	CAATCAAGT.CTCTAAGAG
CAATCAAGT.CTCTACGCA	CAATCAAGT.CTCTACGCA
CAATCAAGT.GCACCATCG	CAATCAAGT.GCACCATCG
CAATCAAGT.GCCTTAGAG	CAATCAAGT.GCCTTAGAG
CAATCAAGT.TATGATGTG	CAATCAAGT.TATGATGTG
CAATCAAGT.TGATTCACC	CAATCAAGT.TGATTCACC
CAATCATAC.AGACTAGTA	CAATCATAC.AGACTAGTA
CAATCATAC.ATAGACCGA	CAATCATAC.ATAGACCGA
CAATCTCCG.ACGCGACAG	CAATCTCCG.ACGCGACAG
CAATCTCCG.CCAAGTCGA	CAATCTCCG.CCAAGTCGA
CAATCTCCG.GGTTAGATG	CAATCTCCG.GGTTAGATG
CAATCTCCG.GTAAGGTCC	CAATCTCCG.GTAAGGTCC
CAATCTCCG.TGACTGAGA	CAATCTCCG.TGACTGAGA
CAATGCATT.AAGACTACC	CAATGCATT.AAGACTACC
CAATGCATT.AATAACTCC	CAATGCATT.AATAACTCC
CAATGCATT.AGTATGACG	CAATGCATT.AGTATGACG
CAATGCATT.ATGACACAA	CAATGCATT.ATGACACAA
CAATGCATT.ATGTGACGA	CAATGCATT.ATGTGACGA
CAATGCATT.CGAAGAGGT	CAATGCATT.CGAAGAGGT
CAATGCATT.CGTGAGACT	CAATGCATT.CGTGAGACT
CAATGCATT.CTCGTGTCC	CAATGCATT.CTCGTGTCC
CAATGCATT.GCGCTAGAA	CAATGCATT.GCGCTAGAA
CAATGCATT.GTACGCGAT	CAATGCATT.GTACGCGAT
CAATGCATT.TCTGTGAAG	CAATGCATT.TCTGTGAAG
CAATGCATT.TGGAGTGGA	CAATGCATT.TGGAGTGGA
CAATGTGCT.CACAGCGAA	CAATGTGCT.CACAGCGAA
CAATGTGCT.CATAATTGG	CAATGTGCT.CATAATTGG
CAATGTGCT.CATTCGAAT	CAATGTGCT.CATTCGAAT
CAATGTGCT.CTAGAGTCG	CAATGTGCT.CTAGAGTCG
CAATGTGCT.GACCAACAG	CAATGTGCT.GACCAACAG
CAATGTGCT.TAGCCAGTG	CAATGTGCT.TAGCCAGTG
CAATGTGCT.TCAGGTGCA	CAATGTGCT.TCAGGTGCA
CAATGTGCT.TCTACATCC	CAATGTGCT.TCTACATCC
CAATTGTCT.AATCGTGTT	CAATTGTCT.AATCGTGTT
CAATTGTCT.AGAAGAGTC	CAATTGTCT.AGAAGAGTC
CAATTGTCT.AGTAAGCCA	CAATTGTCT.AGTAAGCCA
CAATTGTCT.CAACTAATC	CAATTGTCT.CAACTAATC
CAATTGTCT.GTAATATCG	CAATTGTCT.GTAATATCG
CAATTGTCT.TCGTAGGAA	CAATTGTCT.TCGTAGGAA
CACAACCAG.AACGCTCAA	CACAACCAG.AACGCTCAA
CACAACCAG.GGTTCGCAA	CACAACCAG.GGTTCGCAA
CACAACGCT.AACAATGCA	CACAACGCT.AACAATGCA
CACAACGCT.CAAGCGCAT	CACAACGCT.CAAGCGCAT
CACAACGCT.CGATTGAAC	CACAACGCT.CGATTGAAC
CACAACGCT.GAAGTGTGA	CACAACGCT.GAAGTGTGA
CACAACGCT.GTGTCGAGC	CACAACGCT.GTGTCGAGC
CACAACGCT.TTCCGCCAG	CACAACGCT.TTCCGCCAG
CACAATAAC.ACCGACGGT	CACAATAAC.ACCGACGGT
CACAATAAC.AGCCACTTC	CACAATAAC.AGCCACTTC
CACAATAAC.GCAGATCCG	CACAATAAC.GCAGATCCG
CACAATAAC.GCCGCCTAA	CACAATAAC.GCCGCCTAA
CACAATAAC.GCGAACTCG	CACAATAAC.GCGAACTCG
CACAATAAC.TCAGTGCAA	CACAATAAC.TCAGTGCAA
CACAATAAC.TCGCAAGCA	CACAATAAC.TCGCAAGCA
CACAATAAC.TGGAGAGTG	CACAATAAC.TGGAGAGTG
CACAATAAC.TGTGAGTAT	CACAATAAC.TGTGAGTAT
CACACCACA.AATCAGGAG	CACACCACA.AATCAGGAG
CACACCACA.AATGCTGAT	CACACCACA.AATGCTGAT
CACACCACA.AGGATCTCA	CACACCACA.AGGATCTCA
CACACCACA.ATCTGCGTA	CACACCACA.ATCTGCGTA
CACACCACA.CCAATATAC	CACACCACA.CCAATATAC
CACACCACA.CTAACTAAG	CACACCACA.CTAACTAAG
CACACCACA.CTGTTACCA	CACACCACA.CTGTTACCA
CACACCTGT.AACTAACTG	CACACCTGT.AACTAACTG
CACACCTGT.GATCTGTTC	CACACCTGT.GATCTGTTC
CACACTGCC.ATACCGCTT	CACACTGCC.ATACCGCTT
CACACTGCC.ATCAAGCAT	CACACTGCC.ATCAAGCAT
CACACTGCC.CTCATGCCA	CACACTGCC.CTCATGCCA
CACACTGCC.GAGCAGGAA	CACACTGCC.GAGCAGGAA
CACACTGCC.GCACCATCG	CACACTGCC.GCACCATCG
CACACTGCC.GCGGACGAA	CACACTGCC.GCGGACGAA
CACACTGCC.GCGTGATAC	CACACTGCC.GCGTGATAC
CACACTGCC.TATCCTCAG	CACACTGCC.TATCCTCAG
CACAGCGAA.GAGTATCGC	CACAGCGAA.GAGTATCGC
CACAGCGAA.GTAAGTGAG	CACAGCGAA.GTAAGTGAG
CACAGCGAA.GTGAACCAC	CACAGCGAA.GTGAACCAC
CACAGCGAA.TTCTCCACA	CACAGCGAA.TTCTCCACA
CACATATCA.ATGAGCAGG	CACATATCA.ATGAGCAGG
CACATATCA.GACCTTGTG	CACATATCA.GACCTTGTG
CACATATCA.GCCTTAGAG	CACATATCA.GCCTTAGAG
CACATATCA.TGTAGATCG	CACATATCA.TGTAGATCG
CACATATCA.TGTCAACCT	CACATATCA.TGTCAACCT
CACATGTGC.CCGTAGTTG	CACATGTGC.CCGTAGTTG
CACATGTGC.GAGAATCAG	CACATGTGC.GAGAATCAG
CACATGTGC.TAGGAGGAT	CACATGTGC.TAGGAGGAT
CACATGTGC.TAGGATTAG	CACATGTGC.TAGGATTAG
CACATTCTG.AGTCGATCA	CACATTCTG.AGTCGATCA
CACATTCTG.CAATTGTCT	CACATTCTG.CAATTGTCT
CACATTCTG.CTCTCAGTC	CACATTCTG.CTCTCAGTC
CACATTCTG.GTACGAACG	CACATTCTG.GTACGAACG
CACATTCTG.TAGAGACTA	CACATTCTG.TAGAGACTA
CACCAAGAT.AGATCTTCA	CACCAAGAT.AGATCTTCA
CACCAAGAT.AGCGGTCTA	CACCAAGAT.AGCGGTCTA
CACCAAGAT.TGATACCGT	CACCAAGAT.TGATACCGT
CACCAAGAT.TTCACCTTG	CACCAAGAT.TTCACCTTG
CACCAGAAG.ACCACGCTA	CACCAGAAG.ACCACGCTA
CACCAGAAG.ACTTAGCTT	CACCAGAAG.ACTTAGCTT
CACCAGAAG.ATCCGGTCC	CACCAGAAG.ATCCGGTCC
CACCAGAAG.CCGGTTGAG	CACCAGAAG.CCGGTTGAG
CACCAGAAG.CCTCTGCAT	CACCAGAAG.CCTCTGCAT
CACCAGAAG.GCTACCTTA	CACCAGAAG.GCTACCTTA
CACCAGAAG.GTCGCAGGT	CACCAGAAG.GTCGCAGGT
CACCAGAAG.TAGTCGCAT	CACCAGAAG.TAGTCGCAT
CACCAGAAG.TTCGTGATG	CACCAGAAG.TTCGTGATG
CACCTACGC.AAGGAACAG	CACCTACGC.AAGGAACAG
CACCTACGC.AGTCCAGTG	CACCTACGC.AGTCCAGTG
CACCTACGC.GCAGCTCTT	CACCTACGC.GCAGCTCTT
CACCTACGC.GGAATTGGA	CACCTACGC.GGAATTGGA
CACCTAGCG.AAGCCAAGT	CACCTAGCG.AAGCCAAGT
CACCTAGCG.AATGCACTT	CACCTAGCG.AATGCACTT
CACCTAGCG.ACGTGCTCG	CACCTAGCG.ACGTGCTCG
CACCTAGCG.ATGTGAGAC	CACCTAGCG.ATGTGAGAC
CACCTAGCG.ATTCGCTTA	CACCTAGCG.ATTCGCTTA
CACCTAGCG.CGCCATTAC	CACCTAGCG.CGCCATTAC
CACCTAGCG.CTCGTTCAC	CACCTAGCG.CTCGTTCAC
CACCTAGCG.GAGTTAACT	CACCTAGCG.GAGTTAACT
CACCTCAAC.CAGGAGCCT	CACCTCAAC.CAGGAGCCT
CACCTCAAC.CATAAGATC	CACCTCAAC.CATAAGATC
CACCTCAAC.CTCATTAGT	CACCTCAAC.CTCATTAGT
CACCTCAAC.CTGGTAATC	CACCTCAAC.CTGGTAATC
CACCTCAAC.TATGGTTGG	CACCTCAAC.TATGGTTGG
CACCTCAAC.TTCGTGATG	CACCTCAAC.TTCGTGATG
CACCTCGGA.ACACACCGT	CACCTCGGA.ACACACCGT
CACCTCGGA.ATGTCGCCT	CACCTCGGA.ATGTCGCCT
CACCTCGGA.TACTTCCAG	CACCTCGGA.TACTTCCAG
CACCTCGGA.TCGCTGATT	CACCTCGGA.TCGCTGATT
CACCTCGGA.TCGTAATAG	CACCTCGGA.TCGTAATAG
CACCTCGGA.TGTGTCTAC	CACCTCGGA.TGTGTCTAC
CACCTTCCT.ATGCCTTCA	CACCTTCCT.ATGCCTTCA
CACCTTCCT.CATCTCGAT	CACCTTCCT.CATCTCGAT
CACCTTCCT.CCTCGACCT	CACCTTCCT.CCTCGACCT
CACCTTCCT.CCTCGAGAG	CACCTTCCT.CCTCGAGAG
CACCTTCCT.CTTCGTGCA	CACCTTCCT.CTTCGTGCA
CACCTTCCT.GCGGTAGTC	CACCTTCCT.GCGGTAGTC
CACCTTCCT.GGACTATTC	CACCTTCCT.GGACTATTC
CACCTTCCT.TGTATGTAG	CACCTTCCT.TGTATGTAG
CACGACTCA.AAGTAGGAC	CACGACTCA.AAGTAGGAC
CACGACTCA.ACATGACTA	CACGACTCA.ACATGACTA
CACGACTCA.ATGTCGCCT	CACGACTCA.ATGTCGCCT
CACGACTCA.CCTAGTTAG	CACGACTCA.CCTAGTTAG
CACGACTCA.CCTGCGTTA	CACGACTCA.CCTGCGTTA
CACGACTCA.GTTATCGAT	CACGACTCA.GTTATCGAT
CACGACTCA.TAGACCGCA	CACGACTCA.TAGACCGCA
CACGATAGA.ACAATAGGT	CACGATAGA.ACAATAGGT
CACGATAGA.AGATCTGAC	CACGATAGA.AGATCTGAC
CACGATAGA.AGCGTAGAA	CACGATAGA.AGCGTAGAA
CACGATAGA.ATAGACCGA	CACGATAGA.ATAGACCGA
CACGATAGA.CAGTGAGGA	CACGATAGA.CAGTGAGGA
CACGATAGA.CGCCTGCAA	CACGATAGA.CGCCTGCAA
CACGATAGA.TCTGCGCTG	CACGATAGA.TCTGCGCTG
CACGATAGA.TGAAGACCA	CACGATAGA.TGAAGACCA
CACGCGTAA.AGTTCGATA	CACGCGTAA.AGTTCGATA
CACGCGTAA.CATGGTTAC	CACGCGTAA.CATGGTTAC
CACGCGTAA.CCGATCTCT	CACGCGTAA.CCGATCTCT
CACGCGTAA.TCTCATCGG	CACGCGTAA.TCTCATCGG
CACGGAAGT.ATATTCGCA	CACGGAAGT.ATATTCGCA
CACGGAAGT.CCACTACCA	CACGGAAGT.CCACTACCA
CACGGAAGT.GAGAACAGG	CACGGAAGT.GAGAACAGG
CACGGAAGT.GTGAACCAC	CACGGAAGT.GTGAACCAC
CACGGATAG.AACTCCATG	CACGGATAG.AACTCCATG
CACGGATAG.ATATAGCGT	CACGGATAG.ATATAGCGT
CACGGATAG.ATGCGCCGT	CACGGATAG.ATGCGCCGT
CACGGATAG.GAGATACAC	CACGGATAG.GAGATACAC
CACGGATAG.GAGCATACA	CACGGATAG.GAGCATACA
CACGGATAG.TCGTAGGAA	CACGGATAG.TCGTAGGAA
CACGGATAG.TCGTTCTCC	CACGGATAG.TCGTTCTCC
CACGTAGAC.AACTCCATG	CACGTAGAC.AACTCCATG
CACGTAGAC.ATAGAGCAG	CACGTAGAC.ATAGAGCAG
CACGTAGAC.CATAATTGG	CACGTAGAC.CATAATTGG
CACGTAGAC.CTCGTTCAC	CACGTAGAC.CTCGTTCAC
CACGTAGAC.CTGAGTCCA	CACGTAGAC.CTGAGTCCA
CACGTAGAC.TATAATCGC	CACGTAGAC.TATAATCGC
CACGTCATA.CTATAGCTC	CACGTCATA.CTATAGCTC
CACTACAGG.CAATCTCCG	CACTACAGG.CAATCTCCG
CACTACAGG.CAGTAATGT	CACTACAGG.CAGTAATGT
CACTACAGG.CCATAATCG	CACTACAGG.CCATAATCG
CACTACAGG.TACAACACC	CACTACAGG.TACAACACC
CACTACAGG.TCCACCGGT	CACTACAGG.TCCACCGGT
CACTACAGG.TGACCAAGT	CACTACAGG.TGACCAAGT
CACTAGACT.ATAATGTGG	CACTAGACT.ATAATGTGG
CACTAGACT.ATAGTCAGT	CACTAGACT.ATAGTCAGT
CACTAGACT.CTCGCTACG	CACTAGACT.CTCGCTACG
CACTAGACT.GCAACACCT	CACTAGACT.GCAACACCT
CACTCACTA.AACGCTCAA	CACTCACTA.AACGCTCAA
CACTCACTA.AACGTTCTT	CACTCACTA.AACGTTCTT
CACTCACTA.ACTGACTAC	CACTCACTA.ACTGACTAC
CACTCACTA.AGATCTTCA	CACTCACTA.AGATCTTCA
CACTCACTA.ATGCTGTCG	CACTCACTA.ATGCTGTCG
CACTCACTA.TAACATTGG	CACTCACTA.TAACATTGG
CACTCACTA.TACGAGTGA	CACTCACTA.TACGAGTGA
CACTCACTA.TATGACCGA	CACTCACTA.TATGACCGA
CACTCACTA.TGATTGCTG	CACTCACTA.TGATTGCTG
CACTGCTTA.ATGGAGAGT	CACTGCTTA.ATGGAGAGT
CACTGCTTA.ATTGATCAC	CACTGCTTA.ATTGATCAC
CACTGCTTA.GTACAATGC	CACTGCTTA.GTACAATGC
CACTGCTTA.TGCCAGACG	CACTGCTTA.TGCCAGACG
CACTGGTCC.AGTAATGGT	CACTGGTCC.AGTAATGGT
