TCAATCTAG.CACCTCGGA	TCAATCTAG.CACCTCGGA
TCAATCTAG.GACGCCGTA	TCAATCTAG.GACGCCGTA
TCAATCTAG.GTAGCTACA	TCAATCTAG.GTAGCTACA
TCAATGGAC.GACGGTGCT	TCAATGGAC.GACGGTGCT
TCAATGGAC.GAGATACAC	TCAATGGAC.GAGATACAC
TCAATGGAC.TACAAGAGG	TCAATGGAC.TACAAGAGG
TCACACTGC.CGATACTCT	TCACACTGC.CGATACTCT
TCACACTGC.CGGAATGCA	TCACACTGC.CGGAATGCA
TCACACTGC.GAATCACAT	TCACACTGC.GAATCACAT
TCACACTGC.GACCAACAG	TCACACTGC.GACCAACAG
TCACACTGC.GTGCTGACT	TCACACTGC.GTGCTGACT
TCACACTGC.TCCTTCGTA	TCACACTGC.TCCTTCGTA
TCACACTGC.TGCCAGACG	TCACACTGC.TGCCAGACG
TCACAGGTA.AATATCGCT	TCACAGGTA.AATATCGCT
TCACAGGTA.CATGTCCTG	TCACAGGTA.CATGTCCTG
TCACAGGTA.CGAACAATC	TCACAGGTA.CGAACAATC
TCACAGGTA.CGCGCACAT	TCACAGGTA.CGCGCACAT
TCACAGGTA.GATCTTCGC	TCACAGGTA.GATCTTCGC
TCACAGGTA.TAATTCGTG	TCACAGGTA.TAATTCGTG
TCACATACT.CAACGATCG	TCACATACT.CAACGATCG
TCACCGAGG.ACAGCGGTC	TCACCGAGG.ACAGCGGTC
TCACCGAGG.CACTCACTA	TCACCGAGG.CACTCACTA
TCACCGAGG.CAGGATCAA	TCACCGAGG.CAGGATCAA
TCACCGAGG.GAACTATGG	TCACCGAGG.GAACTATGG
TCACCGAGG.TTATCGCAC	TCACCGAGG.TTATCGCAC
TCACGACAA.GCCAACAAT	TCACGACAA.GCCAACAAT
TCACGCGAC.AAGTTCTCT	TCACGCGAC.AAGTTCTCT
TCACGCGAC.ATATCAGCC	TCACGCGAC.ATATCAGCC
TCACGCGAC.ATGCGCCGT	TCACGCGAC.ATGCGCCGT
TCACGCGAC.CACTGTATC	TCACGCGAC.CACTGTATC
TCACGCGAC.CCTCCAATC	TCACGCGAC.CCTCCAATC
TCACGCGAC.CTAGACATG	TCACGCGAC.CTAGACATG
TCACGCGAC.CTTGCACAA	TCACGCGAC.CTTGCACAA
TCACGCGAC.TGAACCAAT	TCACGCGAC.TGAACCAAT
TCACTACGT.AACTAACTG	TCACTACGT.AACTAACTG
TCACTACGT.CTTCACTGT	TCACTACGT.CTTCACTGT
TCACTACGT.GAGAACAGG	TCACTACGT.GAGAACAGG
TCACTCGCT.ACCATGTCT	TCACTCGCT.ACCATGTCT
TCACTCGCT.CCGTACGGA	TCACTCGCT.CCGTACGGA
TCACTCGCT.TGTAGGTTA	TCACTCGCT.TGTAGGTTA
TCAGACAAG.AGATGAAGA	TCAGACAAG.AGATGAAGA
TCAGACAAG.CTAACACTG	TCAGACAAG.CTAACACTG
TCAGACAAG.GCAACCAAC	TCAGACAAG.GCAACCAAC
TCAGACAAG.GCCTTATCT	TCAGACAAG.GCCTTATCT
TCAGACAAG.TGTATGTAG	TCAGACAAG.TGTATGTAG
TCAGAGCGT.AATACCTTG	TCAGAGCGT.AATACCTTG
TCAGAGCGT.ACTCCAACT	TCAGAGCGT.ACTCCAACT
TCAGAGCGT.CGTTACACC	TCAGAGCGT.CGTTACACC
TCAGAGCGT.GAACTGCAA	TCAGAGCGT.GAACTGCAA
TCAGAGCGT.GCTAGTGGA	TCAGAGCGT.GCTAGTGGA
TCAGAGCGT.GGTCGGTCT	TCAGAGCGT.GGTCGGTCT
TCAGAGCGT.TAACCGTGA	TCAGAGCGT.TAACCGTGA
TCAGAGCGT.TATCGAGCC	TCAGAGCGT.TATCGAGCC
TCAGAGCGT.TGACAAGTT	TCAGAGCGT.TGACAAGTT
TCAGAGTCA.AAGGAACAG	TCAGAGTCA.AAGGAACAG
TCAGAGTCA.ATATCCGAT	TCAGAGTCA.ATATCCGAT
TCAGAGTCA.ATGCTGTCG	TCAGAGTCA.ATGCTGTCG
TCAGAGTCA.GAGGTCACG	TCAGAGTCA.GAGGTCACG
TCAGAGTCA.GATATATCC	TCAGAGTCA.GATATATCC
TCAGAGTCA.TAGAGCGTC	TCAGAGTCA.TAGAGCGTC
TCAGAGTCA.TTCTGCCGA	TCAGAGTCA.TTCTGCCGA
TCAGCGACC.ACCGAGTAG	TCAGCGACC.ACCGAGTAG
TCAGCGACC.ATATAGCGT	TCAGCGACC.ATATAGCGT
TCAGCGACC.CACTGCTTA	TCAGCGACC.CACTGCTTA
TCAGCGACC.CGATTCGAG	TCAGCGACC.CGATTCGAG
TCAGCGACC.GGTGGAGCT	TCAGCGACC.GGTGGAGCT
TCAGCGACC.TCTACGCAA	TCAGCGACC.TCTACGCAA
TCAGCGACC.TGCGTCTTA	TCAGCGACC.TGCGTCTTA
TCAGCTCAG.AACAGATCG	TCAGCTCAG.AACAGATCG
TCAGCTCAG.ATATGTCCA	TCAGCTCAG.ATATGTCCA
TCAGCTCAG.CACGTAGAC	TCAGCTCAG.CACGTAGAC
TCAGCTCAG.CTATGGATG	TCAGCTCAG.CTATGGATG
TCAGCTCAG.TAATCTGGA	TCAGCTCAG.TAATCTGGA
TCAGCTCAG.TATTCAACG	TCAGCTCAG.TATTCAACG
TCAGCTCAG.TGGACGAGA	TCAGCTCAG.TGGACGAGA
TCAGGACTG.GTCTGACGT	TCAGGACTG.GTCTGACGT
TCAGGACTG.TTCCAATTC	TCAGGACTG.TTCCAATTC
TCAGGTGCA.CATTGACAA	TCAGGTGCA.CATTGACAA
TCAGGTGCA.CGTATAGCG	TCAGGTGCA.CGTATAGCG
TCAGGTGCA.GCGCTACCT	TCAGGTGCA.GCGCTACCT
TCAGTAAGC.AAGTTCTCT	TCAGTAAGC.AAGTTCTCT
TCAGTAAGC.CCTTATCCG	TCAGTAAGC.CCTTATCCG
TCAGTAAGC.TTACACCTT	TCAGTAAGC.TTACACCTT
TCAGTGCAA.AGTATGACG	TCAGTGCAA.AGTATGACG
TCAGTGCAA.AGTGTCTCT	TCAGTGCAA.AGTGTCTCT
TCAGTGCAA.AGTGTGCAC	TCAGTGCAA.AGTGTGCAC
TCAGTGCAA.AGTTATCGC	TCAGTGCAA.AGTTATCGC
TCAGTGCAA.CCTTGACGG	TCAGTGCAA.CCTTGACGG
TCAGTGCAA.CTTAGAAGG	TCAGTGCAA.CTTAGAAGG
TCAGTGCAA.GGAGCTCAA	TCAGTGCAA.GGAGCTCAA
TCAGTGCAA.TGAGTTAAG	TCAGTGCAA.TGAGTTAAG
TCAGTGCAA.TGCTGCGTC	TCAGTGCAA.TGCTGCGTC
TCAGTGTTC.CGGTTGCGA	TCAGTGTTC.CGGTTGCGA
TCAGTGTTC.GATAAGCTG	TCAGTGTTC.GATAAGCTG
TCAGTGTTC.TAGTCAGAC	TCAGTGTTC.TAGTCAGAC
TCAGTGTTC.TGTAGGTTA	TCAGTGTTC.TGTAGGTTA
TCAGTGTTC.TGTCAACCT	TCAGTGTTC.TGTCAACCT
TCATATCGC.CTTGGATCA	TCATATCGC.CTTGGATCA
TCATCAGAG.AGGAGCAAT	TCATCAGAG.AGGAGCAAT
TCATCAGAG.AGTCGCGAC	TCATCAGAG.AGTCGCGAC
TCATCAGAG.ATACAACCG	TCATCAGAG.ATACAACCG
TCATCAGAG.CAAGCGCAT	TCATCAGAG.CAAGCGCAT
TCATCAGAG.TTCCGAGCG	TCATCAGAG.TTCCGAGCG
TCATCATCT.ACTGGTGCT	TCATCATCT.ACTGGTGCT
TCATCATCT.ATCGTAGTG	TCATCATCT.ATCGTAGTG
TCATCATCT.CACAACCAG	TCATCATCT.CACAACCAG
TCATCATCT.CGTCATGGA	TCATCATCT.CGTCATGGA
TCATCATCT.GTCCTTCAT	TCATCATCT.GTCCTTCAT
TCATCTGTC.CATCCTCTC	TCATCTGTC.CATCCTCTC
TCATCTGTC.CGGTTGCGA	TCATCTGTC.CGGTTGCGA
TCATCTGTC.CGTTAATGG	TCATCTGTC.CGTTAATGG
TCATCTGTC.GACCGTAGT	TCATCTGTC.GACCGTAGT
TCATCTGTC.GCCATCGCT	TCATCTGTC.GCCATCGCT
TCATCTGTC.TAAGCACTA	TCATCTGTC.TAAGCACTA
TCATCTGTC.TAAGGTCCG	TCATCTGTC.TAAGGTCCG
TCATGCAGG.AATCTGACC	TCATGCAGG.AATCTGACC
TCATGCAGG.ACTGTGTCA	TCATGCAGG.ACTGTGTCA
TCATGCAGG.AGTGTCTCT	TCATGCAGG.AGTGTCTCT
TCATGCAGG.CGATAGGTG	TCATGCAGG.CGATAGGTG
TCATGCAGG.GATGCGGTT	TCATGCAGG.GATGCGGTT
TCATGCAGG.GTGCGAGTA	TCATGCAGG.GTGCGAGTA
TCATGCTCA.ACCGATCGA	TCATGCTCA.ACCGATCGA
TCATGCTCA.ATCCGACCA	TCATGCTCA.ATCCGACCA
TCATGCTCA.CGACCTGTA	TCATGCTCA.CGACCTGTA
TCATGCTCA.TTGATGAGT	TCATGCTCA.TTGATGAGT
TCATGCTCA.TTGTATCAC	TCATGCTCA.TTGTATCAC
TCCAACGTG.CAGGTTGTC	TCCAACGTG.CAGGTTGTC
TCCAACGTG.CGTGCTTGA	TCCAACGTG.CGTGCTTGA
TCCAACGTG.GATGCAGAA	TCCAACGTG.GATGCAGAA
TCCAACGTG.GCTGGTTCG	TCCAACGTG.GCTGGTTCG
TCCAACGTG.GGTAAGGAT	TCCAACGTG.GGTAAGGAT
TCCAACGTG.TAGGTTAGT	TCCAACGTG.TAGGTTAGT
TCCAAGTAA.AATGCTGAT	TCCAAGTAA.AATGCTGAT
TCCAAGTAA.CCAGTCTCA	TCCAAGTAA.CCAGTCTCA
TCCAAGTAA.CTCTTCAGC	TCCAAGTAA.CTCTTCAGC
TCCAAGTAA.TACAAGAGG	TCCAAGTAA.TACAAGAGG
TCCAAGTAA.TCCACCTCA	TCCAAGTAA.TCCACCTCA
TCCAAGTAA.TGGTGGATC	TCCAAGTAA.TGGTGGATC
TCCAATCAT.ACGACTGCG	TCCAATCAT.ACGACTGCG
TCCAATCAT.GGAATTGGA	TCCAATCAT.GGAATTGGA
TCCACCGGT.CACTTCCTT	TCCACCGGT.CACTTCCTT
TCCACCGGT.CGCTTGTAG	TCCACCGGT.CGCTTGTAG
TCCACCGGT.TACCGATTG	TCCACCGGT.TACCGATTG
TCCACCGGT.TCTCAGGAT	TCCACCGGT.TCTCAGGAT
TCCACCGGT.TGCAACTCT	TCCACCGGT.TGCAACTCT
TCCACCTCA.ACGCTATGT	TCCACCTCA.ACGCTATGT
TCCACCTCA.ATCTCTGCT	TCCACCTCA.ATCTCTGCT
TCCACCTCA.GCCAATGAA	TCCACCTCA.GCCAATGAA
TCCACGTGC.AGAATCAGA	TCCACGTGC.AGAATCAGA
TCCACGTGC.ATGTCCTCC	TCCACGTGC.ATGTCCTCC
TCCACGTGC.CCTCGACCT	TCCACGTGC.CCTCGACCT
TCCAGAACG.CCACACAGA	TCCAGAACG.CCACACAGA
TCCAGAACG.GGTTCTATC	TCCAGAACG.GGTTCTATC
TCCAGAACG.TTGGAGAAC	TCCAGAACG.TTGGAGAAC
TCCAGCAGC.CATGACGTT	TCCAGCAGC.CATGACGTT
TCCAGCAGC.GCTTACGTT	TCCAGCAGC.GCTTACGTT
TCCAGCTAT.ACCGATCGA	TCCAGCTAT.ACCGATCGA
TCCAGCTAT.AGTCGATCA	TCCAGCTAT.AGTCGATCA
TCCAGCTAT.CGAACAATC	TCCAGCTAT.CGAACAATC
TCCAGCTAT.GGTTGCTAT	TCCAGCTAT.GGTTGCTAT
TCCATCATT.AGTCAGTTG	TCCATCATT.AGTCAGTTG
TCCATCATT.CTGATCAAG	TCCATCATT.CTGATCAAG
TCCATCATT.GTACGTCTA	TCCATCATT.GTACGTCTA
TCCATCATT.TGCTGCGTC	TCCATCATT.TGCTGCGTC
TCCGATAAC.ACCGAGTAG	TCCGATAAC.ACCGAGTAG
TCCGATAAC.AGACGGAGG	TCCGATAAC.AGACGGAGG
TCCGATAAC.ATAGACCGA	TCCGATAAC.ATAGACCGA
TCCGATAAC.ATATAGCGT	TCCGATAAC.ATATAGCGT
TCCGATAAC.CCTCGGTCA	TCCGATAAC.CCTCGGTCA
TCCGATAAC.CTAACCGGT	TCCGATAAC.CTAACCGGT
TCCGATAAC.CTGTTACCA	TCCGATAAC.CTGTTACCA
TCCGATAAC.GTGGTTACC	TCCGATAAC.GTGGTTACC
TCCGATAAC.TGCGTCTTA	TCCGATAAC.TGCGTCTTA
TCCGATCTG.AGGTCAGCA	TCCGATCTG.AGGTCAGCA
TCCGATCTG.CACTGCTTA	TCCGATCTG.CACTGCTTA
TCCGATCTG.CAGATCGAC	TCCGATCTG.CAGATCGAC
TCCGATCTG.TCGGATGTT	TCCGATCTG.TCGGATGTT
TCCGATCTG.TTCCTGCTA	TCCGATCTG.TTCCTGCTA
TCCGGAGCT.ACTCGTAGG	TCCGGAGCT.ACTCGTAGG
TCCGGAGCT.AGCGGAACA	TCCGGAGCT.AGCGGAACA
TCCGGAGCT.CCGAGCTGA	TCCGGAGCT.CCGAGCTGA
TCCGGAGCT.CGCTTATGA	TCCGGAGCT.CGCTTATGA
TCCGGAGCT.GCATTGATC	TCCGGAGCT.GCATTGATC
TCCGGAGCT.GCTTAGAAC	TCCGGAGCT.GCTTAGAAC
TCCGGAGCT.TGATTGCTG	TCCGGAGCT.TGATTGCTG
TCCGGAGCT.TGCTCACAC	TCCGGAGCT.TGCTCACAC
TCCGGAGCT.TGTTACTGA	TCCGGAGCT.TGTTACTGA
TCCGTATAC.ACCGTACGC	TCCGTATAC.ACCGTACGC
TCCGTATAC.AGTTGAGCG	TCCGTATAC.AGTTGAGCG
TCCGTATAC.CACGGAAGT	TCCGTATAC.CACGGAAGT
TCCGTATAC.CATAGTATG	TCCGTATAC.CATAGTATG
TCCGTATAC.GATATGGAC	TCCGTATAC.GATATGGAC
TCCGTATAC.GCTCCTAGC	TCCGTATAC.GCTCCTAGC
TCCGTATAC.TGGATTAGC	TCCGTATAC.TGGATTAGC
TCCTATTCC.AATGAGTCG	TCCTATTCC.AATGAGTCG
TCCTATTCC.AGGTCAGCA	TCCTATTCC.AGGTCAGCA
TCCTATTCC.GATAGTTCT	TCCTATTCC.GATAGTTCT
TCCTATTCC.GATGTCTAG	TCCTATTCC.GATGTCTAG
TCCTATTCC.TAATGTAGC	TCCTATTCC.TAATGTAGC
TCCTATTCC.TATAGTGCG	TCCTATTCC.TATAGTGCG
TCCTATTCC.TTACACCTT	TCCTATTCC.TTACACCTT
TCCTCGTCG.AACGAGGTG	TCCTCGTCG.AACGAGGTG
TCCTCGTCG.AGTGAGAGA	TCCTCGTCG.AGTGAGAGA
TCCTCGTCG.AGTTGCCTT	TCCTCGTCG.AGTTGCCTT
TCCTCGTCG.ATATAGCGT	TCCTCGTCG.ATATAGCGT
TCCTCGTCG.CATGTGAAC	TCCTCGTCG.CATGTGAAC
TCCTCGTCG.CCTCGGTCA	TCCTCGTCG.CCTCGGTCA
TCCTCGTCG.TTATGAGGA	TCCTCGTCG.TTATGAGGA
TCCTCTAGT.AATCCGCTG	TCCTCTAGT.AATCCGCTG
TCCTCTAGT.AGGTCCGTC	TCCTCTAGT.AGGTCCGTC
TCCTCTAGT.CATCCAGGA	TCCTCTAGT.CATCCAGGA
TCCTCTAGT.GCCGTCTTC	TCCTCTAGT.GCCGTCTTC
TCCTCTAGT.TCAGCGACC	TCCTCTAGT.TCAGCGACC
TCCTCTAGT.TGCCAATGG	TCCTCTAGT.TGCCAATGG
TCCTGAGAC.ATCAAGCAT	TCCTGAGAC.ATCAAGCAT
TCCTGAGAC.ATCCAATGA	TCCTGAGAC.ATCCAATGA
TCCTGAGAC.CATACGCAG	TCCTGAGAC.CATACGCAG
TCCTGAGAC.GCGACCTGT	TCCTGAGAC.GCGACCTGT
TCCTGAGAC.GTTCACTCC	TCCTGAGAC.GTTCACTCC
TCCTGTCCG.AGCGCATGA	TCCTGTCCG.AGCGCATGA
TCCTGTCCG.AGTTCAACC	TCCTGTCCG.AGTTCAACC
TCCTGTCCG.ATATAGCGT	TCCTGTCCG.ATATAGCGT
TCCTGTCCG.CACCTTCCT	TCCTGTCCG.CACCTTCCT
TCCTGTCCG.CGTGACCAG	TCCTGTCCG.CGTGACCAG
TCCTGTCCG.GAAGAGCAC	TCCTGTCCG.GAAGAGCAC
TCCTGTCCG.GATTGGAAG	TCCTGTCCG.GATTGGAAG
TCCTGTCCG.TCGCTTAAC	TCCTGTCCG.TCGCTTAAC
TCCTGTCCG.TGTCATAGC	TCCTGTCCG.TGTCATAGC
TCCTGTGGA.AACAGATCG	TCCTGTGGA.AACAGATCG
TCCTGTGGA.ACCTAGCAC	TCCTGTGGA.ACCTAGCAC
TCCTGTGGA.CAAGTACGA	TCCTGTGGA.CAAGTACGA
TCCTGTGGA.CTATTCCGT	TCCTGTGGA.CTATTCCGT
TCCTGTGGA.TACCTATCC	TCCTGTGGA.TACCTATCC
TCCTGTGGA.TATGATGTG	TCCTGTGGA.TATGATGTG
TCCTGTGGA.TCTAGCTGG	TCCTGTGGA.TCTAGCTGG
TCCTTAGGT.ACGTCTATG	TCCTTAGGT.ACGTCTATG
TCCTTAGGT.CCTTAACAT	TCCTTAGGT.CCTTAACAT
TCCTTAGGT.TGCAGATGC	TCCTTAGGT.TGCAGATGC
TCCTTCAAC.ACCATTCAC	TCCTTCAAC.ACCATTCAC
TCCTTCAAC.AGTGAGAGA	TCCTTCAAC.AGTGAGAGA
TCCTTCAAC.CATCTCACG	TCCTTCAAC.CATCTCACG
TCCTTCAAC.GCAGCGATA	TCCTTCAAC.GCAGCGATA
TCCTTCAAC.GTAAGTGAG	TCCTTCAAC.GTAAGTGAG
TCCTTCAAC.TGACCAAGT	TCCTTCAAC.TGACCAAGT
TCCTTCAAC.TTCATTCGC	TCCTTCAAC.TTCATTCGC
TCCTTCGTA.ATAACGACA	TCCTTCGTA.ATAACGACA
TCCTTCGTA.CGCTTCACG	TCCTTCGTA.CGCTTCACG
TCCTTCGTA.CTGGTACAT	TCCTTCGTA.CTGGTACAT
TCCTTCGTA.TGTGCAGTA	TCCTTCGTA.TGTGCAGTA
TCGAACGCT.AAGCAATCG	TCGAACGCT.AAGCAATCG
TCGAACGCT.ACGATGGAA	TCGAACGCT.ACGATGGAA
TCGAACGCT.GCGTCGTCT	TCGAACGCT.GCGTCGTCT
TCGAACGCT.GTCGAGTAC	TCGAACGCT.GTCGAGTAC
TCGAACGCT.TCACCGAGG	TCGAACGCT.TCACCGAGG
TCGAACGCT.TGGTGGATC	TCGAACGCT.TGGTGGATC
TCGAATAGA.ACGGACCAT	TCGAATAGA.ACGGACCAT
TCGAATAGA.ACTAACCGA	TCGAATAGA.ACTAACCGA
TCGAATAGA.CCACGTTCT	TCGAATAGA.CCACGTTCT
TCGAATAGA.TCCAGAACG	TCGAATAGA.TCCAGAACG
TCGACGTTG.ACTCTCACA	TCGACGTTG.ACTCTCACA
TCGACGTTG.AGGTGCGAG	TCGACGTTG.AGGTGCGAG
TCGACGTTG.CATCGAAGC	TCGACGTTG.CATCGAAGC
TCGACGTTG.CTATCCATC	TCGACGTTG.CTATCCATC
TCGACGTTG.TCGGATGTT	TCGACGTTG.TCGGATGTT
TCGACGTTG.TGCCGCTAC	TCGACGTTG.TGCCGCTAC
TCGATTCAG.CAGTGAGGA	TCGATTCAG.CAGTGAGGA
TCGATTCAG.CCGATCAGC	TCGATTCAG.CCGATCAGC
TCGATTCAG.CGTCTGTCC	TCGATTCAG.CGTCTGTCC
TCGATTCAG.GGTTGCTAT	TCGATTCAG.GGTTGCTAT
TCGATTCAG.GTGATGTGC	TCGATTCAG.GTGATGTGC
TCGATTCAG.GTTGACCAT	TCGATTCAG.GTTGACCAT
TCGCAAGCA.ATACCGAAG	TCGCAAGCA.ATACCGAAG
TCGCAAGCA.ATCCTGCCT	TCGCAAGCA.ATCCTGCCT
TCGCAAGCA.ATGCGCTAC	TCGCAAGCA.ATGCGCTAC
TCGCAAGCA.ATTAAGACC	TCGCAAGCA.ATTAAGACC
TCGCAAGCA.GGATGCGAA	TCGCAAGCA.GGATGCGAA
TCGCAAGCA.GTCGACATT	TCGCAAGCA.GTCGACATT
TCGCAAGCA.TACCATGTA	TCGCAAGCA.TACCATGTA
TCGCAAGCA.TCGGTATCA	TCGCAAGCA.TCGGTATCA
TCGCAAGCA.TTCCGAGCG	TCGCAAGCA.TTCCGAGCG
TCGCATTCG.CCAATGCCT	TCGCATTCG.CCAATGCCT
TCGCATTCG.CTGACGGAT	TCGCATTCG.CTGACGGAT
TCGCATTCG.GGTAGACAT	TCGCATTCG.GGTAGACAT
TCGCATTCG.GTAGAGAGC	TCGCATTCG.GTAGAGAGC
TCGCATTCG.TCGACGTTG	TCGCATTCG.TCGACGTTG
TCGCCAAGC.AAGTCATGA	TCGCCAAGC.AAGTCATGA
TCGCCAAGC.ACCGAGACA	TCGCCAAGC.ACCGAGACA
TCGCCAAGC.CGATTCGAG	TCGCCAAGC.CGATTCGAG
TCGCCAAGC.GACTCTGGT	TCGCCAAGC.GACTCTGGT
TCGCCAAGC.TACCTATCC	TCGCCAAGC.TACCTATCC
TCGCCAAGC.TATACGTGG	TCGCCAAGC.TATACGTGG
TCGCCAAGC.TGCAACTCT	TCGCCAAGC.TGCAACTCT
TCGCCAAGC.TGCCACCGA	TCGCCAAGC.TGCCACCGA
TCGCGTCAT.CACCTACGC	TCGCGTCAT.CACCTACGC
TCGCGTCAT.GCGAAGACA	TCGCGTCAT.GCGAAGACA
TCGCGTCAT.TAAGGTGAT	TCGCGTCAT.TAAGGTGAT
TCGCTGATT.CAAGTACGA	TCGCTGATT.CAAGTACGA
TCGCTGATT.GGATAGTCA	TCGCTGATT.GGATAGTCA
TCGCTGTAA.AGCTTCGAT	TCGCTGTAA.AGCTTCGAT
TCGCTGTAA.AGGTATTCC	TCGCTGTAA.AGGTATTCC
TCGCTGTAA.CATAGGTGT	TCGCTGTAA.CATAGGTGT
TCGCTGTAA.TCGTGCCAC	TCGCTGTAA.TCGTGCCAC
TCGCTGTAA.TGTGCTAAC	TCGCTGTAA.TGTGCTAAC
TCGCTTAAC.AGTGTCTCT	TCGCTTAAC.AGTGTCTCT
TCGCTTAAC.ATGAGCAGG	TCGCTTAAC.ATGAGCAGG
TCGCTTAAC.ATGGAGAGT	TCGCTTAAC.ATGGAGAGT
TCGCTTAAC.CAGTAATGT	TCGCTTAAC.CAGTAATGT
TCGCTTAAC.CGGAATGCA	TCGCTTAAC.CGGAATGCA
TCGCTTAAC.GAACTGCAA	TCGCTTAAC.GAACTGCAA
TCGCTTAAC.TCACATACT	TCGCTTAAC.TCACATACT
TCGCTTAAC.TGCTGCGTC	TCGCTTAAC.TGCTGCGTC
TCGCTTAAC.TGGTGGATC	TCGCTTAAC.TGGTGGATC
TCGCTTAAC.TGTACACGA	TCGCTTAAC.TGTACACGA
TCGCTTAAC.TTGATCGTA	TCGCTTAAC.TTGATCGTA
TCGGAACGA.AACGCATTG	TCGGAACGA.AACGCATTG
TCGGAACGA.AATACGTCT	TCGGAACGA.AATACGTCT
TCGGAACGA.ACAGGTATC	TCGGAACGA.ACAGGTATC
TCGGAACGA.AGCTATATG	TCGGAACGA.AGCTATATG
TCGGAACGA.ATTGGTTCC	TCGGAACGA.ATTGGTTCC
TCGGAACGA.CATCCTCTC	TCGGAACGA.CATCCTCTC
TCGGAACGA.CTGAGTCCA	TCGGAACGA.CTGAGTCCA
TCGGAACGA.GCCAACAAT	TCGGAACGA.GCCAACAAT
TCGGAACGA.GCCACGAGT	TCGGAACGA.GCCACGAGT
TCGGAACGA.TCACCGAGG	TCGGAACGA.TCACCGAGG
TCGGAACGA.TCAGGACTG	TCGGAACGA.TCAGGACTG
TCGGAACGA.TCCTGAGAC	TCGGAACGA.TCCTGAGAC
TCGGAACGA.TCGGATGTT	TCGGAACGA.TCGGATGTT
TCGGAACGA.TTATGAGGA	TCGGAACGA.TTATGAGGA
TCGGACAGT.AGAGGACGT	TCGGACAGT.AGAGGACGT
TCGGACAGT.GCGACACAG	TCGGACAGT.GCGACACAG
TCGGACAGT.TGTCTACAC	TCGGACAGT.TGTCTACAC
TCGGACAGT.TGTGTCTAC	TCGGACAGT.TGTGTCTAC
TCGGACAGT.TTCCAATTC	TCGGACAGT.TTCCAATTC
TCGGATGTT.AATTCGGAA	TCGGATGTT.AATTCGGAA
TCGGATGTT.GAGATGTAT	TCGGATGTT.GAGATGTAT
TCGGATGTT.GTCAGTTGT	TCGGATGTT.GTCAGTTGT
TCGGATGTT.TTCTGGTGC	TCGGATGTT.TTCTGGTGC
TCGGTATCA.ATCAGTCGA	TCGGTATCA.ATCAGTCGA
TCGGTATCA.CCGCTATCC	TCGGTATCA.CCGCTATCC
TCGGTATCA.CGTCTGCTG	TCGGTATCA.CGTCTGCTG
TCGGTATCA.TAGGTTAGT	TCGGTATCA.TAGGTTAGT
TCGGTATCA.TCCTATTCC	TCGGTATCA.TCCTATTCC
TCGTAATAG.ACCGGAGTA	TCGTAATAG.ACCGGAGTA
TCGTAATAG.ACGCGACAG	TCGTAATAG.ACGCGACAG
TCGTAATAG.TCAATCTAG	TCGTAATAG.TCAATCTAG
TCGTACCTT.AGCATTGTT	TCGTACCTT.AGCATTGTT
TCGTACCTT.ATAATCGAG	TCGTACCTT.ATAATCGAG
TCGTACCTT.ATAGCACGG	TCGTACCTT.ATAGCACGG
TCGTACCTT.CTCTAGTAA	TCGTACCTT.CTCTAGTAA
TCGTACCTT.GCTACCTTA	TCGTACCTT.GCTACCTTA
TCGTAGGAA.GTTAGATTG	TCGTAGGAA.GTTAGATTG
TCGTAGGAA.TTCAGTGCC	TCGTAGGAA.TTCAGTGCC
TCGTCATTC.AATGCACTT	TCGTCATTC.AATGCACTT
TCGTCATTC.CACCTCAAC	TCGTCATTC.CACCTCAAC
TCGTCATTC.CCACGTTCT	TCGTCATTC.CCACGTTCT
TCGTCATTC.CCTAGCAAT	TCGTCATTC.CCTAGCAAT
TCGTCATTC.CCTCTCTAG	TCGTCATTC.CCTCTCTAG
TCGTCATTC.CGTTAATGG	TCGTCATTC.CGTTAATGG
TCGTCATTC.TACCGATTG	TCGTCATTC.TACCGATTG
TCGTCATTC.TCCTTAGGT	TCGTCATTC.TCCTTAGGT
TCGTCATTC.TCGGATGTT	TCGTCATTC.TCGGATGTT
TCGTCATTC.TGTCGTACA	TCGTCATTC.TGTCGTACA
TCGTCCGAT.AACGTCGAG	TCGTCCGAT.AACGTCGAG
TCGTCCGAT.ATACAACCG	TCGTCCGAT.ATACAACCG
TCGTCCGAT.CAGATCATT	TCGTCCGAT.CAGATCATT
TCGTCCGAT.CAGCTTACC	TCGTCCGAT.CAGCTTACC
TCGTCCGAT.CATTATGTC	TCGTCCGAT.CATTATGTC
TCGTCCGAT.CTCGTTCAC	TCGTCCGAT.CTCGTTCAC
TCGTCCGAT.GCTCTGTGT	TCGTCCGAT.GCTCTGTGT
TCGTCCGAT.GTCCACAAC	TCGTCCGAT.GTCCACAAC
TCGTCCGAT.TAGACCATG	TCGTCCGAT.TAGACCATG
TCGTGACGT.AATAACTCC	TCGTGACGT.AATAACTCC
TCGTGACGT.AATCGTGTT	TCGTGACGT.AATCGTGTT
TCGTGACGT.ATTGATCAC	TCGTGACGT.ATTGATCAC
TCGTGACGT.CTGACGGAT	TCGTGACGT.CTGACGGAT
TCGTGACGT.GTCGTCGAC	TCGTGACGT.GTCGTCGAC
TCGTGACGT.TATCAGTGC	TCGTGACGT.TATCAGTGC
TCGTGCCAC.AGGTACCAA	TCGTGCCAC.AGGTACCAA
TCGTGCCAC.ATAAGTTCG	TCGTGCCAC.ATAAGTTCG
TCGTGCCAC.ATTGATTGG	TCGTGCCAC.ATTGATTGG
TCGTGCCAC.CAGTCGGTA	TCGTGCCAC.CAGTCGGTA
TCGTGCCAC.CTGCTGCTT	TCGTGCCAC.CTGCTGCTT
TCGTTCTCC.ATAGCTTGC	TCGTTCTCC.ATAGCTTGC
TCGTTCTCC.ATCTGCGTA	TCGTTCTCC.ATCTGCGTA
TCGTTCTCC.CGGTGTTAC	TCGTTCTCC.CGGTGTTAC
TCGTTCTCC.GATCTACTT	TCGTTCTCC.GATCTACTT
TCTAATACC.CACTTCCTT	TCTAATACC.CACTTCCTT
TCTAATACC.GACTCAGTG	TCTAATACC.GACTCAGTG
TCTAATACC.GCGACACAG	TCTAATACC.GCGACACAG
TCTACAGTT.AACAGATCG	TCTACAGTT.AACAGATCG
TCTACAGTT.CACTAGACT	TCTACAGTT.CACTAGACT
TCTACAGTT.CCACGTTCT	TCTACAGTT.CCACGTTCT
TCTACAGTT.GCGGTAGTC	TCTACAGTT.GCGGTAGTC
TCTACAGTT.GTTGCATGG	TCTACAGTT.GTTGCATGG
TCTACAGTT.TAGACCGCA	TCTACAGTT.TAGACCGCA
TCTACATCC.ACAGCATCA	TCTACATCC.ACAGCATCA
TCTACATCC.ACCATCTAA	TCTACATCC.ACCATCTAA
TCTACATCC.CCTGCTCCA	TCTACATCC.CCTGCTCCA
TCTACATCC.GGACTCCTT	TCTACATCC.GGACTCCTT
TCTACATCC.GTGGATAAG	TCTACATCC.GTGGATAAG
TCTACATCC.TATCGAGCC	TCTACATCC.TATCGAGCC
TCTACGCAA.ACAAGTACA	TCTACGCAA.ACAAGTACA
TCTACGCAA.ACAGCATCA	TCTACGCAA.ACAGCATCA
TCTACGCAA.ATCTCTGCT	TCTACGCAA.ATCTCTGCT
TCTACGCAA.CCATCACGA	TCTACGCAA.CCATCACGA
TCTACGCAA.CGGAACGAG	TCTACGCAA.CGGAACGAG
TCTACGCAA.CTTGATCTA	TCTACGCAA.CTTGATCTA
TCTACGCAA.GTCGCAGGT	TCTACGCAA.GTCGCAGGT
TCTACGCAA.TCAGGTGCA	TCTACGCAA.TCAGGTGCA
TCTACGCAA.TCGCTGTAA	TCTACGCAA.TCGCTGTAA
TCTAGCTGG.ACGACATCT	TCTAGCTGG.ACGACATCT
TCTAGCTGG.AGAGGACGT	TCTAGCTGG.AGAGGACGT
TCTAGCTGG.CCGTTAGAC	TCTAGCTGG.CCGTTAGAC
TCTAGCTGG.CGAGCCGTT	TCTAGCTGG.CGAGCCGTT
TCTAGCTGG.CTGACAGCA	TCTAGCTGG.CTGACAGCA
TCTAGCTGG.TAACGTGTC	TCTAGCTGG.TAACGTGTC
TCTAGGATG.CTCCTGACG	TCTAGGATG.CTCCTGACG
TCTAGGATG.CTTGGTCAT	TCTAGGATG.CTTGGTCAT
TCTAGGATG.GTCTTCATA	TCTAGGATG.GTCTTCATA
TCTAGGATG.GTTAGATTG	TCTAGGATG.GTTAGATTG
TCTAGGATG.GTTGCATGG	TCTAGGATG.GTTGCATGG
TCTAGGATG.TGGTGGTAA	TCTAGGATG.TGGTGGTAA
TCTAGTGAC.AGAGGTGAA	TCTAGTGAC.AGAGGTGAA
TCTAGTGAC.AGCTTGGTG	TCTAGTGAC.AGCTTGGTG
TCTAGTGAC.ATCTGCGTA	TCTAGTGAC.ATCTGCGTA
TCTAGTGAC.CCGAATATG	TCTAGTGAC.CCGAATATG
TCTAGTGAC.GCGCTAGAA	TCTAGTGAC.GCGCTAGAA
TCTAGTGAC.GGAATTGGA	TCTAGTGAC.GGAATTGGA
TCTAGTGAC.GTGTTGGAA	TCTAGTGAC.GTGTTGGAA
TCTAGTGAC.TCTCCGCGT	TCTAGTGAC.TCTCCGCGT
TCTATGACA.ATCATTACG	TCTATGACA.ATCATTACG
TCTATGACA.CCGGATTGC	TCTATGACA.CCGGATTGC
TCTATGACA.CCTCGACCT	TCTATGACA.CCTCGACCT
TCTATGACA.GATCGCACT	TCTATGACA.GATCGCACT
TCTATGACA.TAGCAGAGT	TCTATGACA.TAGCAGAGT
TCTATGACA.TAGTAGTCT	TCTATGACA.TAGTAGTCT
TCTATGACA.TATGTATGC	TCTATGACA.TATGTATGC
TCTATGACA.TTCCATACC	TCTATGACA.TTCCATACC
TCTATTAGG.GTCCGCTCA	TCTATTAGG.GTCCGCTCA
TCTATTAGG.TTATTCGAC	TCTATTAGG.TTATTCGAC
TCTCAGGAT.AAGACGAAG	TCTCAGGAT.AAGACGAAG
TCTCAGGAT.AGTGGAATG	TCTCAGGAT.AGTGGAATG
TCTCAGGAT.CCGTAGTTG	TCTCAGGAT.CCGTAGTTG
TCTCAGGAT.CTTCCTGAT	TCTCAGGAT.CTTCCTGAT
TCTCAGGAT.GCGACAACC	TCTCAGGAT.GCGACAACC
TCTCAGGAT.GTCTGACGT	TCTCAGGAT.GTCTGACGT
TCTCAGGAT.TATGAAGAC	TCTCAGGAT.TATGAAGAC
TCTCATCGG.ACGCGACAG	TCTCATCGG.ACGCGACAG
TCTCATCGG.ATTAGCACA	TCTCATCGG.ATTAGCACA
TCTCATCGG.GTGTATCTG	TCTCATCGG.GTGTATCTG
TCTCATCGG.TACAGTTAG	TCTCATCGG.TACAGTTAG
TCTCATCGG.TAGTGCACT	TCTCATCGG.TAGTGCACT
TCTCATCGG.TGCGCTGCA	TCTCATCGG.TGCGCTGCA
TCTCCGCGT.ACCACGCTA	TCTCCGCGT.ACCACGCTA
TCTCCGCGT.GCTGTTCGG	TCTCCGCGT.GCTGTTCGG
TCTCCGCGT.TGATGACAG	TCTCCGCGT.TGATGACAG
TCTCGATGC.CAGATCGAC	TCTCGATGC.CAGATCGAC
TCTCGATGC.CAGCGACGT	TCTCGATGC.CAGCGACGT
TCTCGATGC.CATGGTTAC	TCTCGATGC.CATGGTTAC
TCTCGATGC.GACGTAGCA	TCTCGATGC.GACGTAGCA
TCTCGATGC.TAATTCGTG	TCTCGATGC.TAATTCGTG
TCTCGATGC.TACGTTACC	TCTCGATGC.TACGTTACC
TCTCGTATC.AGTCTGGAA	TCTCGTATC.AGTCTGGAA
TCTCGTATC.CAAGCTGCA	TCTCGTATC.CAAGCTGCA
TCTCGTATC.CTACGTTGG	TCTCGTATC.CTACGTTGG
TCTCGTATC.CTTCCGGTA	TCTCGTATC.CTTCCGGTA
TCTCGTATC.GTACTCTAC	TCTCGTATC.GTACTCTAC
TCTGAGATA.ATGCTGTCG	TCTGAGATA.ATGCTGTCG
TCTGAGATA.CCGATCTCT	TCTGAGATA.CCGATCTCT
TCTGATGAA.ACACCGCCA	TCTGATGAA.ACACCGCCA
TCTGATGAA.GGTGTTCAT	TCTGATGAA.GGTGTTCAT
TCTGATGAA.TGTGGTCCT	TCTGATGAA.TGTGGTCCT
TCTGCAACA.CAACACCTA	TCTGCAACA.CAACACCTA
TCTGCAACA.CATACGCAG	TCTGCAACA.CATACGCAG
TCTGCAACA.CCATTCTGC	TCTGCAACA.CCATTCTGC
TCTGCAACA.CCGACTGTT	TCTGCAACA.CCGACTGTT
TCTGCAACA.GAGCAGGAA	TCTGCAACA.GAGCAGGAA
TCTGCAACA.GGATAGTCA	TCTGCAACA.GGATAGTCA
TCTGCAACA.GTGTTGGAA	TCTGCAACA.GTGTTGGAA
TCTGCGCTG.ACGCTCTTA	TCTGCGCTG.ACGCTCTTA
TCTGCGCTG.CGAACAGAG	TCTGCGCTG.CGAACAGAG
TCTGCGCTG.CTGAGATAG	TCTGCGCTG.CTGAGATAG
TCTGCGCTG.GCAATGAGA	TCTGCGCTG.GCAATGAGA
TCTGCGCTG.TGACGGTTG	TCTGCGCTG.TGACGGTTG
TCTGGAGGA.ACAGGAACT	TCTGGAGGA.ACAGGAACT
TCTGGAGGA.ATTCCGTAC	TCTGGAGGA.ATTCCGTAC
TCTGGAGGA.CAACGATCG	TCTGGAGGA.CAACGATCG
TCTGGAGGA.CCATAGCCA	TCTGGAGGA.CCATAGCCA
TCTGGAGGA.CGCCATTAC	TCTGGAGGA.CGCCATTAC
TCTGGAGGA.CTTGATCTA	TCTGGAGGA.CTTGATCTA
TCTGGAGGA.GACTCTCAC	TCTGGAGGA.GACTCTCAC
TCTGTGAAG.GAGTATCGC	TCTGTGAAG.GAGTATCGC
TCTGTGAAG.GCAACACCT	TCTGTGAAG.GCAACACCT
TCTGTGAAG.GGTACTTCC	TCTGTGAAG.GGTACTTCC
TCTGTGAAG.TATCTGTCA	TCTGTGAAG.TATCTGTCA
TCTTAAGTG.ACGGTGTAC	TCTTAAGTG.ACGGTGTAC
TCTTAAGTG.CACATTCTG	TCTTAAGTG.CACATTCTG
TCTTAAGTG.CCACACAGA	TCTTAAGTG.CCACACAGA
TCTTAAGTG.CTGACGATG	TCTTAAGTG.CTGACGATG
TCTTAAGTG.GGTGAGTTC	TCTTAAGTG.GGTGAGTTC
