GACACCGAT.CAACTAATC	GACACCGAT.CAACTAATC
GACACCGAT.CAGGAGCCT	GACACCGAT.CAGGAGCCT
GACACCGAT.CTCAGGTAC	GACACCGAT.CTCAGGTAC
GACACCGAT.GCACATGTT	GACACCGAT.GCACATGTT
GACACCGAT.GCTGGTAAC	GACACCGAT.GCTGGTAAC
GACACCGAT.TATGTACCT	GACACCGAT.TATGTACCT
GACACGCAA.ATATAGCGT	GACACGCAA.ATATAGCGT
GACACGCAA.CCAAGCGAG	GACACGCAA.CCAAGCGAG
GACACGCAA.CCTAGTCTC	GACACGCAA.CCTAGTCTC
GACACGCAA.CTAATACGC	GACACGCAA.CTAATACGC
GACACGCAA.GCGCATTAC	GACACGCAA.GCGCATTAC
GACACGCAA.GGAACCTAG	GACACGCAA.GGAACCTAG
GACACGCAA.GTCAAGATC	GACACGCAA.GTCAAGATC
GACACGCAA.TCGGTATCA	GACACGCAA.TCGGTATCA
GACACGCAA.TGTCACATA	GACACGCAA.TGTCACATA
GACACGCAA.TTATCCAAG	GACACGCAA.TTATCCAAG
GACAGGTTA.ATCGAATCG	GACAGGTTA.ATCGAATCG
GACAGGTTA.ATGGTTCGA	GACAGGTTA.ATGGTTCGA
GACAGGTTA.GCTTACTAG	GACAGGTTA.GCTTACTAG
GACATAACG.ACGACATCT	GACATAACG.ACGACATCT
GACATAACG.ACTAACCGA	GACATAACG.ACTAACCGA
GACATAACG.GTAAGGTCC	GACATAACG.GTAAGGTCC
GACATAACG.TATGACCGA	GACATAACG.TATGACCGA
GACATAACG.TCGGACAGT	GACATAACG.TCGGACAGT
GACATAACG.TCTAGGATG	GACATAACG.TCTAGGATG
GACATATGT.AAGGAAGTC	GACATATGT.AAGGAAGTC
GACATATGT.CCGCTATCC	GACATATGT.CCGCTATCC
GACATATGT.TAGGAGGAT	GACATATGT.TAGGAGGAT
GACATATGT.TGTGTAGAG	GACATATGT.TGTGTAGAG
GACATATGT.TTATCGCAC	GACATATGT.TTATCGCAC
GACCAACAG.ATCGGTGGT	GACCAACAG.ATCGGTGGT
GACCAACAG.CCGCACTCA	GACCAACAG.CCGCACTCA
GACCAACAG.GTGCTCTTG	GACCAACAG.GTGCTCTTG
GACCAACAG.TGGACGAGA	GACCAACAG.TGGACGAGA
GACCACTCG.ACCTAGTTA	GACCACTCG.ACCTAGTTA
GACCACTCG.CAGCTCTTC	GACCACTCG.CAGCTCTTC
GACCACTCG.CGAACAATC	GACCACTCG.CGAACAATC
GACCAGAGA.ATCCTGCCT	GACCAGAGA.ATCCTGCCT
GACCAGAGA.CTTGCACAA	GACCAGAGA.CTTGCACAA
GACCAGAGA.GTAACCATA	GACCAGAGA.GTAACCATA
GACCAGAGA.TCATATCGC	GACCAGAGA.TCATATCGC
GACCAGAGA.TCGCTGATT	GACCAGAGA.TCGCTGATT
GACCGCTTC.AAGGTGCTG	GACCGCTTC.AAGGTGCTG
GACCGCTTC.AGCTCTCCG	GACCGCTTC.AGCTCTCCG
GACCGCTTC.ATTCGAAGA	GACCGCTTC.ATTCGAAGA
GACCGCTTC.CCGATACCG	GACCGCTTC.CCGATACCG
GACCGCTTC.TACGACTTG	GACCGCTTC.TACGACTTG
GACCGGTAG.ATGCGCTAC	GACCGGTAG.ATGCGCTAC
GACCGGTAG.CACTTCCTT	GACCGGTAG.CACTTCCTT
GACCGGTAG.CATGTGAAC	GACCGGTAG.CATGTGAAC
GACCGGTAG.GGTTCAGAC	GACCGGTAG.GGTTCAGAC
GACCGTAGT.AGCGGTCTA	GACCGTAGT.AGCGGTCTA
GACCTTGTG.CATATGCGA	GACCTTGTG.CATATGCGA
GACGCCGTA.CCATTACAG	GACGCCGTA.CCATTACAG
GACGCCGTA.CTCGTCTTG	GACGCCGTA.CTCGTCTTG
GACGCCGTA.GATGTCTAG	GACGCCGTA.GATGTCTAG
GACGCCGTA.GCGAAGACA	GACGCCGTA.GCGAAGACA
GACGCCGTA.GCGTGAGCT	GACGCCGTA.GCGTGAGCT
GACGCCGTA.TCAGCGACC	GACGCCGTA.TCAGCGACC
GACGCTTGC.AAGCAATCG	GACGCTTGC.AAGCAATCG
GACGCTTGC.AATGCTGAT	GACGCTTGC.AATGCTGAT
GACGCTTGC.ACTGGACCA	GACGCTTGC.ACTGGACCA
GACGCTTGC.AGTAACGTA	GACGCTTGC.AGTAACGTA
GACGCTTGC.CACGATAGA	GACGCTTGC.CACGATAGA
GACGCTTGC.CCTGTCATT	GACGCTTGC.CCTGTCATT
GACGCTTGC.GAGACTCGA	GACGCTTGC.GAGACTCGA
GACGGACTA.AGATGTTGG	GACGGACTA.AGATGTTGG
GACGGACTA.ATGGAGAGT	GACGGACTA.ATGGAGAGT
GACGGACTA.CGTGCTTGA	GACGGACTA.CGTGCTTGA
GACGGACTA.GTATCGTCG	GACGGACTA.GTATCGTCG
GACGGACTA.TAGTCAGAC	GACGGACTA.TAGTCAGAC
GACGGACTA.TGATCTCGG	GACGGACTA.TGATCTCGG
GACGGTGCT.AAGACGAAG	GACGGTGCT.AAGACGAAG
GACGGTGCT.ACGAGAGCA	GACGGTGCT.ACGAGAGCA
GACGGTGCT.CAGTGCCAT	GACGGTGCT.CAGTGCCAT
GACGGTGCT.CATTGCAGA	GACGGTGCT.CATTGCAGA
GACGGTGCT.CTTAATCGT	GACGGTGCT.CTTAATCGT
GACGTAGCA.CAACTCCAG	GACGTAGCA.CAACTCCAG
GACGTAGCA.CCACACAGA	GACGTAGCA.CCACACAGA
GACGTAGCA.CGCATCTAC	GACGTAGCA.CGCATCTAC
GACGTAGCA.CTTATCTCA	GACGTAGCA.CTTATCTCA
GACGTCAAT.CAGCTGGAG	GACGTCAAT.CAGCTGGAG
GACGTCAAT.CGGAACGAG	GACGTCAAT.CGGAACGAG
GACGTCAAT.CGGTTCGTA	GACGTCAAT.CGGTTCGTA
GACGTCAAT.GATGCTCCT	GACGTCAAT.GATGCTCCT
GACGTGGTC.ATTCATGTG	GACGTGGTC.ATTCATGTG
GACGTGGTC.CAATGTGCT	GACGTGGTC.CAATGTGCT
GACGTGGTC.CGCAACCTC	GACGTGGTC.CGCAACCTC
GACGTGGTC.GGTTAGATG	GACGTGGTC.GGTTAGATG
GACGTGGTC.GTAACGCGA	GACGTGGTC.GTAACGCGA
GACGTGGTC.TCCTTCGTA	GACGTGGTC.TCCTTCGTA
GACGTTCAG.AGGTCACGT	GACGTTCAG.AGGTCACGT
GACGTTCAG.CATCGCTGG	GACGTTCAG.CATCGCTGG
GACGTTCAG.TACTGATGA	GACGTTCAG.TACTGATGA
GACTAGCAT.AACGCATTG	GACTAGCAT.AACGCATTG
GACTAGCAT.AAGCCACAC	GACTAGCAT.AAGCCACAC
GACTAGCAT.AATGCACTT	GACTAGCAT.AATGCACTT
GACTAGCAT.ATAGACCGA	GACTAGCAT.ATAGACCGA
GACTAGCAT.CGCAGTGTC	GACTAGCAT.CGCAGTGTC
GACTAGCAT.GAGGTGAGC	GACTAGCAT.GAGGTGAGC
GACTAGCAT.GGATTACGC	GACTAGCAT.GGATTACGC
GACTAGCAT.GTATCCTGC	GACTAGCAT.GTATCCTGC
GACTAGCAT.TAATGTAGC	GACTAGCAT.TAATGTAGC
GACTAGCAT.TATTCAACG	GACTAGCAT.TATTCAACG
GACTATTGA.ACGTTCAAT	GACTATTGA.ACGTTCAAT
GACTATTGA.CACGATAGA	GACTATTGA.CACGATAGA
GACTATTGA.CATCTCGAT	GACTATTGA.CATCTCGAT
GACTATTGA.CTATTCCGT	GACTATTGA.CTATTCCGT
GACTATTGA.GCGTAACAA	GACTATTGA.GCGTAACAA
GACTATTGA.TGCATACAT	GACTATTGA.TGCATACAT
GACTCAGTG.AACAACCTA	GACTCAGTG.AACAACCTA
GACTCAGTG.ACCATACTT	GACTCAGTG.ACCATACTT
GACTCAGTG.CAAGCCTCG	GACTCAGTG.CAAGCCTCG
GACTCAGTG.TCCAATCAT	GACTCAGTG.TCCAATCAT
GACTCTCAC.ACGATGGAA	GACTCTCAC.ACGATGGAA
GACTCTCAC.ATCAGGATG	GACTCTCAC.ATCAGGATG
GACTCTCAC.CTTGGATCA	GACTCTCAC.CTTGGATCA
GACTCTCAC.GAACTATGG	GACTCTCAC.GAACTATGG
GACTCTCAC.GACTAGCAT	GACTCTCAC.GACTAGCAT
GACTCTCAC.GATCGCGAA	GACTCTCAC.GATCGCGAA
GACTCTCAC.GGAGTTAGC	GACTCTCAC.GGAGTTAGC
GACTCTCAC.GTGATGTGC	GACTCTCAC.GTGATGTGC
GACTCTCAC.TTGCCAGAT	GACTCTCAC.TTGCCAGAT
GACTCTGGT.ACTGCTAGT	GACTCTGGT.ACTGCTAGT
GACTCTGGT.AGTCATACT	GACTCTGGT.AGTCATACT
GACTCTGGT.ATTGATTGG	GACTCTGGT.ATTGATTGG
GACTCTGGT.CCGTCCACT	GACTCTGGT.CCGTCCACT
GACTCTGGT.GTGAATGCC	GACTCTGGT.GTGAATGCC
GACTGCCTG.CATCAATAG	GACTGCCTG.CATCAATAG
GACTGCCTG.GAGTCACCA	GACTGCCTG.GAGTCACCA
GACTGCGCA.AACGCCTAC	GACTGCGCA.AACGCCTAC
GACTGCGCA.CCGACTGTT	GACTGCGCA.CCGACTGTT
GACTGCGCA.GCTCAGCCA	GACTGCGCA.GCTCAGCCA
GACTGCGCA.TTCAACTAC	GACTGCGCA.TTCAACTAC
GACTTCACC.CCTAGTCTC	GACTTCACC.CCTAGTCTC
GACTTCACC.CCTCATAAC	GACTTCACC.CCTCATAAC
GACTTCACC.CGCCATTAC	GACTTCACC.CGCCATTAC
GACTTCACC.GCTACCGAG	GACTTCACC.GCTACCGAG
GACTTCACC.GTCTTATGC	GACTTCACC.GTCTTATGC
GACTTGATT.AAGCAATCG	GACTTGATT.AAGCAATCG
GACTTGATT.AGGATCATG	GACTTGATT.AGGATCATG
GACTTGATT.CCATATGCC	GACTTGATT.CCATATGCC
GACTTGATT.CCGGATTGC	GACTTGATT.CCGGATTGC
GACTTGATT.CTTATCTCA	GACTTGATT.CTTATCTCA
GACTTGATT.TGGAGAGTG	GACTTGATT.TGGAGAGTG
GAGAACAGG.ACGGTGCCT	GAGAACAGG.ACGGTGCCT
GAGAACAGG.AGAGCGGAG	GAGAACAGG.AGAGCGGAG
GAGAACAGG.CTACTGTCA	GAGAACAGG.CTACTGTCA
GAGAATCAG.AGGTGTACA	GAGAATCAG.AGGTGTACA
GAGAATCAG.ATGATAGCT	GAGAATCAG.ATGATAGCT
GAGAATCAG.CAACGTCTT	GAGAATCAG.CAACGTCTT
GAGAATCAG.CACGGAAGT	GAGAATCAG.CACGGAAGT
GAGAATCAG.TAAGCACTA	GAGAATCAG.TAAGCACTA
GAGAATCAG.TTGGACTTC	GAGAATCAG.TTGGACTTC
GAGACATTG.AATGAGTCG	GAGACATTG.AATGAGTCG
GAGACATTG.ACGGTGTAC	GAGACATTG.ACGGTGTAC
GAGACATTG.ATAATCGAG	GAGACATTG.ATAATCGAG
GAGACATTG.CACGACTCA	GAGACATTG.CACGACTCA
GAGACATTG.CATACAACC	GAGACATTG.CATACAACC
GAGACATTG.CATCGAAGC	GAGACATTG.CATCGAAGC
GAGACATTG.GATATGGAC	GAGACATTG.GATATGGAC
GAGACATTG.GGAGAATGA	GAGACATTG.GGAGAATGA
GAGACATTG.TAACATTGG	GAGACATTG.TAACATTGG
GAGACATTG.TAATCTGGA	GAGACATTG.TAATCTGGA
GAGACGATC.AACAACTGG	GAGACGATC.AACAACTGG
GAGACGATC.AATTGGTGA	GAGACGATC.AATTGGTGA
GAGACGATC.ACCGTCACG	GAGACGATC.ACCGTCACG
GAGACGATC.CACAATAAC	GAGACGATC.CACAATAAC
GAGACGATC.CTGGAGCGA	GAGACGATC.CTGGAGCGA
GAGACTCGA.ATATCCGAT	GAGACTCGA.ATATCCGAT
GAGACTCGA.CCAGCCAAT	GAGACTCGA.CCAGCCAAT
GAGACTCGA.CTGCATGTT	GAGACTCGA.CTGCATGTT
GAGACTCGA.CTTATCTCA	GAGACTCGA.CTTATCTCA
GAGACTCGA.GTACAATGC	GAGACTCGA.GTACAATGC
GAGACTCGA.TACCAGCCA	GAGACTCGA.TACCAGCCA
GAGACTCGA.TCTGCGCTG	GAGACTCGA.TCTGCGCTG
GAGACTCGA.TTACGCTCG	GAGACTCGA.TTACGCTCG
GAGACTCGA.TTCTCCACA	GAGACTCGA.TTCTCCACA
GAGATACAC.ATCTCTGCT	GAGATACAC.ATCTCTGCT
GAGATACAC.CAATCTCCG	GAGATACAC.CAATCTCCG
GAGATACAC.CTATCCATC	GAGATACAC.CTATCCATC
GAGATACAC.GGTTAACAG	GAGATACAC.GGTTAACAG
GAGATACAC.TAAGCACTA	GAGATACAC.TAAGCACTA
GAGATACAC.TACTACTGT	GAGATACAC.TACTACTGT
GAGATACAC.TCCTCTAGT	GAGATACAC.TCCTCTAGT
GAGATACAC.TGCGCACTG	GAGATACAC.TGCGCACTG
GAGATGTAT.GTGAGGACG	GAGATGTAT.GTGAGGACG
GAGATGTAT.GTGGACTGG	GAGATGTAT.GTGGACTGG
GAGATGTAT.TACGAGTGA	GAGATGTAT.TACGAGTGA
GAGATGTAT.TCGTTCTCC	GAGATGTAT.TCGTTCTCC
GAGATGTAT.TGCGACGTT	GAGATGTAT.TGCGACGTT
GAGATGTAT.TTCCAGGAG	GAGATGTAT.TTCCAGGAG
GAGATTCCT.AGCCAGGAC	GAGATTCCT.AGCCAGGAC
GAGATTCCT.AGTACTACA	GAGATTCCT.AGTACTACA
GAGATTCCT.CGACGTGAT	GAGATTCCT.CGACGTGAT
GAGATTCCT.CTAGAGGTA	GAGATTCCT.CTAGAGGTA
GAGATTCCT.GATCTGTTC	GAGATTCCT.GATCTGTTC
GAGATTCCT.GTGTACCGT	GAGATTCCT.GTGTACCGT
GAGCACATT.AAGCAATCG	GAGCACATT.AAGCAATCG
GAGCACATT.ACGGTGCCT	GAGCACATT.ACGGTGCCT
GAGCACATT.ACTCATTCA	GAGCACATT.ACTCATTCA
GAGCACATT.CCTTCGAGC	GAGCACATT.CCTTCGAGC
GAGCACATT.CTATTCCGT	GAGCACATT.CTATTCCGT
GAGCACATT.GGAACCTAG	GAGCACATT.GGAACCTAG
GAGCACATT.GGAAGGTAT	GAGCACATT.GGAAGGTAT
GAGCACATT.TCGGATGTT	GAGCACATT.TCGGATGTT
GAGCACATT.TGACTGAGA	GAGCACATT.TGACTGAGA
GAGCAGGAA.ACCACTAGG	GAGCAGGAA.ACCACTAGG
GAGCAGGAA.GATCGATAC	GAGCAGGAA.GATCGATAC
GAGCAGGAA.GTCGTTGCG	GAGCAGGAA.GTCGTTGCG
GAGCAGGAA.TCGTAGGAA	GAGCAGGAA.TCGTAGGAA
GAGCAGGAA.TGAACCAAT	GAGCAGGAA.TGAACCAAT
GAGCAGGAA.TGTCATAGC	GAGCAGGAA.TGTCATAGC
GAGCATACA.ACTCATTCA	GAGCATACA.ACTCATTCA
GAGCATACA.CATTCAGTT	GAGCATACA.CATTCAGTT
GAGCATACA.CTTGCGACC	GAGCATACA.CTTGCGACC
GAGCATACA.TATAGTGCG	GAGCATACA.TATAGTGCG
GAGCATACA.TGAAGACCA	GAGCATACA.TGAAGACCA
GAGCATACA.TTGTCAACC	GAGCATACA.TTGTCAACC
GAGCCATCC.AGCGTCGTC	GAGCCATCC.AGCGTCGTC
GAGCCATCC.AGTCCGTGT	GAGCCATCC.AGTCCGTGT
GAGCCATCC.CACGGAAGT	GAGCCATCC.CACGGAAGT
GAGCCATCC.CCTCTTGTA	GAGCCATCC.CCTCTTGTA
GAGCCATCC.GAGACTCGA	GAGCCATCC.GAGACTCGA
GAGCCGTTA.AACAACCTA	GAGCCGTTA.AACAACCTA
GAGCCGTTA.ATCACTTCC	GAGCCGTTA.ATCACTTCC
GAGCCGTTA.GAAGGATCA	GAGCCGTTA.GAAGGATCA
GAGCCGTTA.GTCAGCGTC	GAGCCGTTA.GTCAGCGTC
GAGCCGTTA.TATGCCTTC	GAGCCGTTA.TATGCCTTC
GAGCCGTTA.TATGTACCT	GAGCCGTTA.TATGTACCT
GAGCGACTC.AAGGTCTGA	GAGCGACTC.AAGGTCTGA
GAGCGACTC.ATAATGTGG	GAGCGACTC.ATAATGTGG
GAGCGACTC.CCGTTAGAC	GAGCGACTC.CCGTTAGAC
GAGCTCTCA.AGTTGTGTA	GAGCTCTCA.AGTTGTGTA
GAGCTCTCA.ATGCGCTAC	GAGCTCTCA.ATGCGCTAC
GAGCTCTCA.GCGCTCTAT	GAGCTCTCA.GCGCTCTAT
GAGCTCTCA.GGATCAATG	GAGCTCTCA.GGATCAATG
GAGCTCTCA.TATACCACT	GAGCTCTCA.TATACCACT
GAGCTCTCA.TGTTACTGA	GAGCTCTCA.TGTTACTGA
GAGGACTTA.ATCTACATC	GAGGACTTA.ATCTACATC
GAGGACTTA.ATGATAGCT	GAGGACTTA.ATGATAGCT
GAGGACTTA.CATAGAGAT	GAGGACTTA.CATAGAGAT
GAGGACTTA.GTCAACTGA	GAGGACTTA.GTCAACTGA
GAGGACTTA.GTGACTCTC	GAGGACTTA.GTGACTCTC
GAGGACTTA.TAGGATGCC	GAGGACTTA.TAGGATGCC
GAGGTCACG.AGCCTCGCA	GAGGTCACG.AGCCTCGCA
GAGGTCACG.CTGAGTCCA	GAGGTCACG.CTGAGTCCA
GAGGTCACG.GAGTATCGC	GAGGTCACG.GAGTATCGC
GAGGTCACG.GGTTGCTAT	GAGGTCACG.GGTTGCTAT
GAGGTCCTT.AACACACTC	GAGGTCCTT.AACACACTC
GAGGTCCTT.ACAGAGATG	GAGGTCCTT.ACAGAGATG
GAGGTCCTT.CAGATCGAC	GAGGTCCTT.CAGATCGAC
GAGGTCCTT.CGAGCCGTT	GAGGTCCTT.CGAGCCGTT
GAGGTCCTT.TATGAGACC	GAGGTCCTT.TATGAGACC
GAGGTCCTT.TGTCATAGC	GAGGTCCTT.TGTCATAGC
GAGGTGAGC.ATTAGCGGT	GAGGTGAGC.ATTAGCGGT
GAGGTGAGC.CCACTGAAG	GAGGTGAGC.CCACTGAAG
GAGGTGAGC.GTAGCATAC	GAGGTGAGC.GTAGCATAC
GAGGTGAGC.GTGGAGGTC	GAGGTGAGC.GTGGAGGTC
GAGGTGAGC.TCAAGCGTA	GAGGTGAGC.TCAAGCGTA
GAGGTGAGC.TGGAGAGTG	GAGGTGAGC.TGGAGAGTG
GAGTATCGC.ATCCGTCTC	GAGTATCGC.ATCCGTCTC
GAGTATCGC.CCTCCTTGT	GAGTATCGC.CCTCCTTGT
GAGTATCGC.CTTAAGTTG	GAGTATCGC.CTTAAGTTG
GAGTATCGC.TACGACTTG	GAGTATCGC.TACGACTTG
GAGTATCGC.TCAAGGTCG	GAGTATCGC.TCAAGGTCG
GAGTATCGC.TGATACCGT	GAGTATCGC.TGATACCGT
GAGTATCGC.TGGTCCTAG	GAGTATCGC.TGGTCCTAG
GAGTATCGC.TGTGCCATG	GAGTATCGC.TGTGCCATG
GAGTATCGC.TGTGGACAA	GAGTATCGC.TGTGGACAA
GAGTCAAGG.ACACCACAT	GAGTCAAGG.ACACCACAT
GAGTCAAGG.GCTTCTGAA	GAGTCAAGG.GCTTCTGAA
GAGTCAAGG.GGTTCTATC	GAGTCAAGG.GGTTCTATC
GAGTCAAGG.TCTAGTGAC	GAGTCAAGG.TCTAGTGAC
GAGTCACCA.AACGGTAGC	GAGTCACCA.AACGGTAGC
GAGTCACCA.AGACTAGTA	GAGTCACCA.AGACTAGTA
GAGTCACCA.ATCTACATC	GAGTCACCA.ATCTACATC
GAGTCACCA.CCACTGAAG	GAGTCACCA.CCACTGAAG
GAGTCACCA.CTGGTACAT	GAGTCACCA.CTGGTACAT
GAGTCCAAT.ACGTTCAAT	GAGTCCAAT.ACGTTCAAT
GAGTCCAAT.CACTTCCTT	GAGTCCAAT.CACTTCCTT
GAGTCCAAT.CCGTTCCAA	GAGTCCAAT.CCGTTCCAA
GAGTCCAAT.GATTAGTGT	GAGTCCAAT.GATTAGTGT
GAGTCCAAT.GTCTTATGC	GAGTCCAAT.GTCTTATGC
GAGTCCAAT.TGATTGCTG	GAGTCCAAT.TGATTGCTG
GAGTCCAAT.TGCTGCGTC	GAGTCCAAT.TGCTGCGTC
GAGTCGTAC.ACCATGTCT	GAGTCGTAC.ACCATGTCT
GAGTCGTAC.AGAAGAGTC	GAGTCGTAC.AGAAGAGTC
GAGTCGTAC.AGCTCGTCT	GAGTCGTAC.AGCTCGTCT
GAGTCGTAC.CATACAACC	GAGTCGTAC.CATACAACC
GAGTCGTAC.CGCAACCTC	GAGTCGTAC.CGCAACCTC
GAGTCGTAC.CGCCACCAT	GAGTCGTAC.CGCCACCAT
GAGTCGTAC.CTACGGTAT	GAGTCGTAC.CTACGGTAT
GAGTCGTAC.GATCGCACT	GAGTCGTAC.GATCGCACT
GAGTCGTAC.TCACTCGCT	GAGTCGTAC.TCACTCGCT
GAGTCTTCG.ACCTAGCAC	GAGTCTTCG.ACCTAGCAC
GAGTCTTCG.ACGATGGAA	GAGTCTTCG.ACGATGGAA
GAGTCTTCG.GGTAAGGAT	GAGTCTTCG.GGTAAGGAT
GAGTGCATA.CATGTCCTG	GAGTGCATA.CATGTCCTG
GAGTGCATA.CATTATGTC	GAGTGCATA.CATTATGTC
GAGTGCATA.CCAGTACTC	GAGTGCATA.CCAGTACTC
GAGTGCATA.CTTGCGACC	GAGTGCATA.CTTGCGACC
GAGTGCATA.GATTGAGTA	GAGTGCATA.GATTGAGTA
GAGTGTGCC.ATTGGTTCC	GAGTGTGCC.ATTGGTTCC
GAGTGTGCC.CCATAAGTA	GAGTGTGCC.CCATAAGTA
GAGTGTGCC.GCCATCGCT	GAGTGTGCC.GCCATCGCT
GAGTGTGCC.TAAGCCATT	GAGTGTGCC.TAAGCCATT
GAGTGTGCC.TCTATTAGG	GAGTGTGCC.TCTATTAGG
GAGTGTGCC.TGCTCAGCG	GAGTGTGCC.TGCTCAGCG
GAGTTAACT.AGAAGAGTC	GAGTTAACT.AGAAGAGTC
GAGTTAACT.AGTTGCCTT	GAGTTAACT.AGTTGCCTT
GAGTTAACT.TCGTCATTC	GAGTTAACT.TCGTCATTC
GAGTTATAG.AGTACTCTC	GAGTTATAG.AGTACTCTC
GAGTTATAG.ATATCAGCC	GAGTTATAG.ATATCAGCC
GAGTTATAG.CCTCCTTGT	GAGTTATAG.CCTCCTTGT
GAGTTATAG.CGCGATGTA	GAGTTATAG.CGCGATGTA
GAGTTATAG.GGATCAATG	GAGTTATAG.GGATCAATG
GAGTTATAG.TATACGGAT	GAGTTATAG.TATACGGAT
GAGTTATAG.TTCGGAGTC	GAGTTATAG.TTCGGAGTC
GATAACGTC.AATCGTGTT	GATAACGTC.AATCGTGTT
GATAACGTC.AGCATTGTT	GATAACGTC.AGCATTGTT
GATAACGTC.CACCTACGC	GATAACGTC.CACCTACGC
GATAACGTC.CTATCTTGA	GATAACGTC.CTATCTTGA
GATAACGTC.GCTGATGTC	GATAACGTC.GCTGATGTC
GATAACGTC.GGACACTGG	GATAACGTC.GGACACTGG
GATAACGTC.GTGCTAAGC	GATAACGTC.GTGCTAAGC
GATAACGTC.TAAGCCATT	GATAACGTC.TAAGCCATT
GATAACGTC.TCATGCTCA	GATAACGTC.TCATGCTCA
GATAAGCTG.AATTCGGAA	GATAAGCTG.AATTCGGAA
GATAAGCTG.ACATTGACA	GATAAGCTG.ACATTGACA
GATAAGCTG.AGTTGCCTT	GATAAGCTG.AGTTGCCTT
GATAAGCTG.CCGTTAGAC	GATAAGCTG.CCGTTAGAC
GATAAGCTG.CTGGTCGGT	GATAAGCTG.CTGGTCGGT
GATAAGCTG.GCATACATG	GATAAGCTG.GCATACATG
GATACACTA.ATCCGACCA	GATACACTA.ATCCGACCA
GATACACTA.ATGATAGCT	GATACACTA.ATGATAGCT
GATACACTA.CAACCGGTC	GATACACTA.CAACCGGTC
GATACACTA.CCTTCCTCA	GATACACTA.CCTTCCTCA
GATACACTA.CGACAGGAA	GATACACTA.CGACAGGAA
GATACACTA.CTTCTGAGT	GATACACTA.CTTCTGAGT
GATACACTA.GTTGATGCA	GATACACTA.GTTGATGCA
GATACACTA.TCAATCTAG	GATACACTA.TCAATCTAG
GATACACTA.TCTCAGGAT	GATACACTA.TCTCAGGAT
GATACCGGA.AGAGGACGT	GATACCGGA.AGAGGACGT
GATACCGGA.CCGAGTACT	GATACCGGA.CCGAGTACT
GATACCGGA.GATCTACTT	GATACCGGA.GATCTACTT
GATACCGGA.GCTTACTAG	GATACCGGA.GCTTACTAG
GATACCGGA.TACCTCACT	GATACCGGA.TACCTCACT
GATACCGGA.TCGCTTAAC	GATACCGGA.TCGCTTAAC
GATACCGGA.TCTACAGTT	GATACCGGA.TCTACAGTT
GATACCGGA.TTGCCAGAT	GATACCGGA.TTGCCAGAT
GATACTGTG.AGTGAACGG	GATACTGTG.AGTGAACGG
GATACTGTG.ATGCGCCGT	GATACTGTG.ATGCGCCGT
GATACTGTG.GTAACGCGA	GATACTGTG.GTAACGCGA
GATAGTTCT.AAGCTTGCA	GATAGTTCT.AAGCTTGCA
GATAGTTCT.ACCGACGGT	GATAGTTCT.ACCGACGGT
GATAGTTCT.GTACCACAA	GATAGTTCT.GTACCACAA
GATAGTTCT.TCGCGTCAT	GATAGTTCT.TCGCGTCAT
GATAGTTCT.TGCTCACAC	GATAGTTCT.TGCTCACAC
GATAGTTCT.TTAACGTTC	GATAGTTCT.TTAACGTTC
GATATATCC.AATCCGCTG	GATATATCC.AATCCGCTG
GATATATCC.CCATTCTGC	GATATATCC.CCATTCTGC
GATATATCC.GGTCGGATA	GATATATCC.GGTCGGATA
GATATATCC.GTGCTCTTG	GATATATCC.GTGCTCTTG
GATATGGAC.ACCGGTTAC	GATATGGAC.ACCGGTTAC
GATATGGAC.ACGCAAGAT	GATATGGAC.ACGCAAGAT
GATATGGAC.AGCCGTTCT	GATATGGAC.AGCCGTTCT
GATATGGAC.ATTGCCGAC	GATATGGAC.ATTGCCGAC
GATATGGAC.CCTGCGTTA	GATATGGAC.CCTGCGTTA
GATATGGAC.CTGTAGAAG	GATATGGAC.CTGTAGAAG
GATATGGAC.GCTTGGTTC	GATATGGAC.GCTTGGTTC
GATATGGAC.TATCGAGCC	GATATGGAC.TATCGAGCC
GATATGGAC.TCCTCTAGT	GATATGGAC.TCCTCTAGT
GATATGGAC.TTATTCGAC	GATATGGAC.TTATTCGAC
GATCCGCAC.AGTGACGAT	GATCCGCAC.AGTGACGAT
GATCCGCAC.CGTTCGTAC	GATCCGCAC.CGTTCGTAC
GATCCGCAC.TACCTCCTC	GATCCGCAC.TACCTCCTC
GATCGATAC.AGACATCCA	GATCGATAC.AGACATCCA
GATCGATAC.AGACTTCGT	GATCGATAC.AGACTTCGT
GATCGATAC.CCGACTTGG	GATCGATAC.CCGACTTGG
GATCGATAC.CGTTAATGG	GATCGATAC.CGTTAATGG
GATCGATAC.GGATCAGGT	GATCGATAC.GGATCAGGT
GATCGATAC.GTACGCGAT	GATCGATAC.GTACGCGAT
GATCGATAC.TAGAGCGTC	GATCGATAC.TAGAGCGTC
GATCGATAC.TCAGACAAG	GATCGATAC.TCAGACAAG
GATCGATAC.TCCAAGTAA	GATCGATAC.TCCAAGTAA
GATCGCACT.ATGGAGGAA	GATCGCACT.ATGGAGGAA
GATCGCACT.CCTAGCAAT	GATCGCACT.CCTAGCAAT
GATCGCACT.GAGGACTTA	GATCGCACT.GAGGACTTA
GATCGCACT.GGAGCTCAA	GATCGCACT.GGAGCTCAA
GATCGCGAA.AATAACTCC	GATCGCGAA.AATAACTCC
GATCGCGAA.ATCATTACG	GATCGCGAA.ATCATTACG
GATCGCGAA.ATCCTGCCT	GATCGCGAA.ATCCTGCCT
GATCGCGAA.CGTCTGCTG	GATCGCGAA.CGTCTGCTG
GATCGCGAA.TAGGTCAAC	GATCGCGAA.TAGGTCAAC
GATCGTTGA.ACTGGTCAG	GATCGTTGA.ACTGGTCAG
GATCGTTGA.GACCTTGTG	GATCGTTGA.GACCTTGTG
GATCGTTGA.GATGTCTAG	GATCGTTGA.GATGTCTAG
GATCGTTGA.TGTGTAGAG	GATCGTTGA.TGTGTAGAG
GATCGTTGA.TTAGTCGGA	GATCGTTGA.TTAGTCGGA
GATCTACTT.AAGACTGGT	GATCTACTT.AAGACTGGT
GATCTACTT.AGACGGAGG	GATCTACTT.AGACGGAGG
GATCTACTT.ATCCTCCGA	GATCTACTT.ATCCTCCGA
GATCTACTT.GGTTAACAG	GATCTACTT.GGTTAACAG
GATCTACTT.TACCTATCC	GATCTACTT.TACCTATCC
GATCTACTT.TACGACCAT	GATCTACTT.TACGACCAT
GATCTAGAG.AGCATATGG	GATCTAGAG.AGCATATGG
GATCTAGAG.CACTCACTA	GATCTAGAG.CACTCACTA
GATCTAGAG.CCGAGCTGA	GATCTAGAG.CCGAGCTGA
GATCTAGAG.GCGACACAG	GATCTAGAG.GCGACACAG
GATCTAGAG.GTCCTAGTT	GATCTAGAG.GTCCTAGTT
GATCTAGAG.GTGCGTTCC	GATCTAGAG.GTGCGTTCC
GATCTAGAG.TCATGCAGG	GATCTAGAG.TCATGCAGG
GATCTAGAG.TCTGTGAAG	GATCTAGAG.TCTGTGAAG
GATCTGAAT.AGCAACATT	GATCTGAAT.AGCAACATT
GATCTGAAT.CCTTAATTC	GATCTGAAT.CCTTAATTC
GATCTGAAT.CCTTCGAGC	GATCTGAAT.CCTTCGAGC
GATCTGAAT.CGAACAGAG	GATCTGAAT.CGAACAGAG
GATCTGAAT.GTGTTGGAA	GATCTGAAT.GTGTTGGAA
GATCTGAAT.TCAGTGTTC	GATCTGAAT.TCAGTGTTC
GATCTGAAT.TGATGGACA	GATCTGAAT.TGATGGACA
GATCTGTTC.ACTATCCTG	GATCTGTTC.ACTATCCTG
GATCTGTTC.CAAGGTGTG	GATCTGTTC.CAAGGTGTG
GATCTGTTC.GATACACTA	GATCTGTTC.GATACACTA
GATCTGTTC.GATCGATAC	GATCTGTTC.GATCGATAC
GATCTGTTC.GTTCAGAAG	GATCTGTTC.GTTCAGAAG
GATCTGTTC.TACGACTTG	GATCTGTTC.TACGACTTG
GATCTGTTC.TAGAGACTA	GATCTGTTC.TAGAGACTA
GATCTGTTC.TTAGCGTCT	GATCTGTTC.TTAGCGTCT
GATCTTCGC.GACGTCAAT	GATCTTCGC.GACGTCAAT
GATCTTCGC.GCAACACCT	GATCTTCGC.GCAACACCT
GATCTTCGC.GCAACTCGC	GATCTTCGC.GCAACTCGC
GATCTTCGC.GTAGCTACA	GATCTTCGC.GTAGCTACA
GATCTTCGC.TAGCTGTTG	GATCTTCGC.TAGCTGTTG
GATGCAGAA.AAGTTGCCA	GATGCAGAA.AAGTTGCCA
GATGCAGAA.GACGCTTGC	GATGCAGAA.GACGCTTGC
GATGCGACG.AAGCAGCAT	GATGCGACG.AAGCAGCAT
GATGCGACG.ATTCACCTC	GATGCGACG.ATTCACCTC
GATGCGACG.CCTAGTCTC	GATGCGACG.CCTAGTCTC
GATGCGACG.CGAACAGAG	GATGCGACG.CGAACAGAG
GATGCGACG.GCTGTTCGG	GATGCGACG.GCTGTTCGG
GATGCGACG.GTCTACCAA	GATGCGACG.GTCTACCAA
GATGCGACG.TAACCGTGA	GATGCGACG.TAACCGTGA
GATGCGACG.TCCAATCAT	GATGCGACG.TCCAATCAT
GATGCGACG.TTCCTCGGT	GATGCGACG.TTCCTCGGT
GATGCGGTT.CAAGTACGA	GATGCGGTT.CAAGTACGA
GATGCGGTT.CACCTACGC	GATGCGGTT.CACCTACGC
GATGCGGTT.CATGTCCTG	GATGCGGTT.CATGTCCTG
GATGCGGTT.CCACTGAAG	GATGCGGTT.CCACTGAAG
GATGCGGTT.CTCTAAGAG	GATGCGGTT.CTCTAAGAG
GATGCGGTT.TCAGGTGCA	GATGCGGTT.TCAGGTGCA
GATGCTCCT.CACGGAAGT	GATGCTCCT.CACGGAAGT
GATGCTCCT.GGAACTGCT	GATGCTCCT.GGAACTGCT
GATGCTCCT.GTACCACAA	GATGCTCCT.GTACCACAA
GATGCTCCT.GTTAGAGAC	GATGCTCCT.GTTAGAGAC
GATGCTCCT.TATGAAGAC	GATGCTCCT.TATGAAGAC
GATGTAAGG.AGATCTGAC	GATGTAAGG.AGATCTGAC
GATGTAAGG.CGCACTCTT	GATGTAAGG.CGCACTCTT
GATGTAAGG.GGTAAGTGA	GATGTAAGG.GGTAAGTGA
GATGTAAGG.TTGCTCTGC	GATGTAAGG.TTGCTCTGC
GATGTCTAG.ACTATCCTG	GATGTCTAG.ACTATCCTG
GATGTCTAG.ATTAGCGGT	GATGTCTAG.ATTAGCGGT
GATGTCTAG.CCTCATAAC	GATGTCTAG.CCTCATAAC
GATGTCTAG.GTAGCCTTG	GATGTCTAG.GTAGCCTTG
GATGTTACA.ATGACACAA	GATGTTACA.ATGACACAA
GATGTTACA.CAGTATGAT	GATGTTACA.CAGTATGAT
GATGTTACA.CCAGTCTCA	GATGTTACA.CCAGTCTCA
GATGTTACA.CGAAGAGGT	GATGTTACA.CGAAGAGGT
GATGTTACA.CTGGACTAA	GATGTTACA.CTGGACTAA
GATGTTACA.GGATGCGAA	GATGTTACA.GGATGCGAA
GATGTTACA.GTCTCCAGG	GATGTTACA.GTCTCCAGG
GATGTTACA.TCACCGAGG	GATGTTACA.TCACCGAGG
GATTAGACA.CAGGATCAA	GATTAGACA.CAGGATCAA
GATTAGACA.CTGTCTAGT	GATTAGACA.CTGTCTAGT
GATTAGACA.GCTCCTAGC	GATTAGACA.GCTCCTAGC
GATTAGACA.GTACGTCTA	GATTAGACA.GTACGTCTA
GATTAGACA.GTACTCTAC	GATTAGACA.GTACTCTAC
GATTAGACA.GTTCCAACA	GATTAGACA.GTTCCAACA
GATTAGTGT.ACGCGACAG	GATTAGTGT.ACGCGACAG
GATTAGTGT.GGTAGTGTT	GATTAGTGT.GGTAGTGTT
GATTAGTGT.TATAGTGCG	GATTAGTGT.TATAGTGCG
GATTAGTGT.TCAGACAAG	GATTAGTGT.TCAGACAAG
GATTAGTGT.TCCAATCAT	GATTAGTGT.TCCAATCAT
GATTAGTGT.TCGTCATTC	GATTAGTGT.TCGTCATTC
GATTATGCG.AAGCCAAGT	GATTATGCG.AAGCCAAGT
GATTATGCG.AATCCTCGT	GATTATGCG.AATCCTCGT
GATTATGCG.AGAAGTAAC	GATTATGCG.AGAAGTAAC
GATTATGCG.CGCTTGTAG	GATTATGCG.CGCTTGTAG
GATTATGCG.GAGCCGTTA	GATTATGCG.GAGCCGTTA
GATTATGCG.GCAGGAGAA	GATTATGCG.GCAGGAGAA
GATTATGCG.TACCATGTA	GATTATGCG.TACCATGTA
GATTCCTCT.AATCGCCAT	GATTCCTCT.AATCGCCAT
GATTCCTCT.CATCCAGGA	GATTCCTCT.CATCCAGGA
GATTCCTCT.GAACCTTCA	GATTCCTCT.GAACCTTCA
GATTCCTCT.GATCTGTTC	GATTCCTCT.GATCTGTTC
GATTCCTCT.GCGTAACAA	GATTCCTCT.GCGTAACAA
GATTCCTCT.TTCCTCGGT	GATTCCTCT.TTCCTCGGT
GATTCCTCT.TTGGACTTC	GATTCCTCT.TTGGACTTC
GATTCTCGG.AACACACTC	GATTCTCGG.AACACACTC
GATTCTCGG.AGTCTGGAA	GATTCTCGG.AGTCTGGAA
