CCATATCTT.CCATAGCCA	CCATATCTT.CCATAGCCA
CCATATCTT.CTCCTGACG	CCATATCTT.CTCCTGACG
CCATATCTT.TAGCGAGAA	CCATATCTT.TAGCGAGAA
CCATATCTT.TGAACCAAT	CCATATCTT.TGAACCAAT
CCATATGCC.CAATGTGCT	CCATATGCC.CAATGTGCT
CCATATGCC.CTTCCGGTA	CCATATGCC.CTTCCGGTA
CCATATGCC.GATATATCC	CCATATGCC.GATATATCC
CCATATGCC.GTTCAGAAG	CCATATGCC.GTTCAGAAG
CCATATGCC.TCTACAGTT	CCATATGCC.TCTACAGTT
CCATATGCC.TGTCTACAC	CCATATGCC.TGTCTACAC
CCATCACGA.ATGTGAGAC	CCATCACGA.ATGTGAGAC
CCATCACGA.ATTCCTACG	CCATCACGA.ATTCCTACG
CCATCACGA.CCGTCAGGT	CCATCACGA.CCGTCAGGT
CCATCACGA.GAGGTCCTT	CCATCACGA.GAGGTCCTT
CCATCACGA.GCTACCTTA	CCATCACGA.GCTACCTTA
CCATCACGA.GTGCCATGA	CCATCACGA.GTGCCATGA
CCATCTAGG.ATGCGCTAC	CCATCTAGG.ATGCGCTAC
CCATCTAGG.CAAGTCACT	CCATCTAGG.CAAGTCACT
CCATCTAGG.GCCGTCTTC	CCATCTAGG.GCCGTCTTC
CCATCTAGG.GCGAACTCG	CCATCTAGG.GCGAACTCG
CCATCTAGG.TACGGTCGT	CCATCTAGG.TACGGTCGT
CCATCTAGG.TAGCCAGTG	CCATCTAGG.TAGCCAGTG
CCATCTAGG.TCCAACGTG	CCATCTAGG.TCCAACGTG
CCATGATGT.CAGTTACTG	CCATGATGT.CAGTTACTG
CCATGATGT.CGCGTGAGA	CCATGATGT.CGCGTGAGA
CCATGATGT.GAACATGAC	CCATGATGT.GAACATGAC
CCATGATGT.GTCCTAGTT	CCATGATGT.GTCCTAGTT
CCATGCGTC.CAAGTCACT	CCATGCGTC.CAAGTCACT
CCATGCGTC.GCTGACAGA	CCATGCGTC.GCTGACAGA
CCATTACAG.ATAAGACAG	CCATTACAG.ATAAGACAG
CCATTACAG.ATTCCGTAC	CCATTACAG.ATTCCGTAC
CCATTACAG.GAACCTTCA	CCATTACAG.GAACCTTCA
CCATTACAG.GAACTGCAA	CCATTACAG.GAACTGCAA
CCATTACAG.GGATGCTCG	CCATTACAG.GGATGCTCG
CCATTCTGC.ACTCACGAA	CCATTCTGC.ACTCACGAA
CCATTCTGC.CTCCAGCGT	CCATTCTGC.CTCCAGCGT
CCATTCTGC.CTGACGGAT	CCATTCTGC.CTGACGGAT
CCATTCTGC.GTCCACAAC	CCATTCTGC.GTCCACAAC
CCATTCTGC.GTCTCTTCA	CCATTCTGC.GTCTCTTCA
CCATTCTGC.TGATGGACA	CCATTCTGC.TGATGGACA
CCGAAGCGT.AGCACACCT	CCGAAGCGT.AGCACACCT
CCGAAGCGT.ATACCGCTT	CCGAAGCGT.ATACCGCTT
CCGAAGCGT.ATTGCCGAC	CCGAAGCGT.ATTGCCGAC
CCGAAGCGT.CGGTCGACA	CCGAAGCGT.CGGTCGACA
CCGAAGCGT.CTATTCCGT	CCGAAGCGT.CTATTCCGT
CCGAAGCGT.CTCCACGTC	CCGAAGCGT.CTCCACGTC
CCGAAGCGT.TACAAGAGG	CCGAAGCGT.TACAAGAGG
CCGAAGCGT.TCTGCAACA	CCGAAGCGT.TCTGCAACA
CCGAAGCGT.TTACGGACC	CCGAAGCGT.TTACGGACC
CCGAAGCGT.TTGAGACGG	CCGAAGCGT.TTGAGACGG
CCGAATATG.AGACGCCTG	CCGAATATG.AGACGCCTG
CCGAATATG.ATGCTTCAG	CCGAATATG.ATGCTTCAG
CCGAATATG.CCTTCCTCA	CCGAATATG.CCTTCCTCA
CCGAATATG.TCAGTAAGC	CCGAATATG.TCAGTAAGC
CCGACGTCA.CGCATAACT	CCGACGTCA.CGCATAACT
CCGACGTCA.TATGGTTGG	CCGACGTCA.TATGGTTGG
CCGACGTCA.TCGTGCCAC	CCGACGTCA.TCGTGCCAC
CCGACGTCA.TTCTGAATG	CCGACGTCA.TTCTGAATG
CCGACTGTT.AATATCGCT	CCGACTGTT.AATATCGCT
CCGACTGTT.ACGACAGTC	CCGACTGTT.ACGACAGTC
CCGACTGTT.AGAAGCTGC	CCGACTGTT.AGAAGCTGC
CCGACTGTT.AGTGACGAT	CCGACTGTT.AGTGACGAT
CCGACTGTT.CCAGGAGTT	CCGACTGTT.CCAGGAGTT
CCGACTGTT.GCGTCGTCT	CCGACTGTT.GCGTCGTCT
CCGACTGTT.GGTGAGTTC	CCGACTGTT.GGTGAGTTC
CCGACTGTT.TGTGGTCCT	CCGACTGTT.TGTGGTCCT
CCGACTGTT.TGTTGTCGA	CCGACTGTT.TGTTGTCGA
CCGACTTGG.AATCCGCTG	CCGACTTGG.AATCCGCTG
CCGACTTGG.ATCAGGATG	CCGACTTGG.ATCAGGATG
CCGACTTGG.CAGCTTACC	CCGACTTGG.CAGCTTACC
CCGACTTGG.GTAGTTGGT	CCGACTTGG.GTAGTTGGT
CCGACTTGG.TGATTGTGC	CCGACTTGG.TGATTGTGC
CCGAGCTGA.AACGCCTAC	CCGAGCTGA.AACGCCTAC
CCGAGCTGA.AACTTAGCT	CCGAGCTGA.AACTTAGCT
CCGAGCTGA.AGGAATTGG	CCGAGCTGA.AGGAATTGG
CCGAGCTGA.TGATAGAGG	CCGAGCTGA.TGATAGAGG
CCGAGCTGA.TTAGATCGG	CCGAGCTGA.TTAGATCGG
CCGAGTACT.AACAATGCA	CCGAGTACT.AACAATGCA
CCGAGTACT.ACTCCAACT	CCGAGTACT.ACTCCAACT
CCGAGTACT.CCACACAGA	CCGAGTACT.CCACACAGA
CCGAGTACT.CCGATCTCT	CCGAGTACT.CCGATCTCT
CCGAGTACT.CGGTCGACA	CCGAGTACT.CGGTCGACA
CCGAGTACT.CTCAGTGAT	CCGAGTACT.CTCAGTGAT
CCGAGTACT.GATATATCC	CCGAGTACT.GATATATCC
CCGAGTACT.TAGAGCCAG	CCGAGTACT.TAGAGCCAG
CCGAGTACT.TTGTTAGAG	CCGAGTACT.TTGTTAGAG
CCGATACCG.AGCAGACAA	CCGATACCG.AGCAGACAA
CCGATACCG.GTCTTATGC	CCGATACCG.GTCTTATGC
CCGATACCG.TAACTCCGA	CCGATACCG.TAACTCCGA
CCGATACCG.TACATGCAC	CCGATACCG.TACATGCAC
CCGATACCG.TCCACCGGT	CCGATACCG.TCCACCGGT
CCGATACCG.TGACCTCCT	CCGATACCG.TGACCTCCT
CCGATCAGC.CAGTTACTG	CCGATCAGC.CAGTTACTG
CCGATCTCT.ATGAGATCC	CCGATCTCT.ATGAGATCC
CCGATCTCT.CGGAGACTT	CCGATCTCT.CGGAGACTT
CCGATCTCT.GATCGATAC	CCGATCTCT.GATCGATAC
CCGATCTCT.GCTTACTAG	CCGATCTCT.GCTTACTAG
CCGATCTCT.TCTAGTGAC	CCGATCTCT.TCTAGTGAC
CCGATCTCT.TGTCATAGC	CCGATCTCT.TGTCATAGC
CCGATGTTC.AAGCTTGCA	CCGATGTTC.AAGCTTGCA
CCGATGTTC.CTTATTGAG	CCGATGTTC.CTTATTGAG
CCGATGTTC.GACCTTGTG	CCGATGTTC.GACCTTGTG
CCGATGTTC.GCCTTATCT	CCGATGTTC.GCCTTATCT
CCGCAACAC.CCTCCAATC	CCGCAACAC.CCTCCAATC
CCGCAACAC.CGAGCCGTT	CCGCAACAC.CGAGCCGTT
CCGCAACAC.CGATCCAGA	CCGCAACAC.CGATCCAGA
CCGCAACAC.GCTTAGAAC	CCGCAACAC.GCTTAGAAC
CCGCAACAC.TCGCGTCAT	CCGCAACAC.TCGCGTCAT
CCGCAACAC.TGAGAGGAC	CCGCAACAC.TGAGAGGAC
CCGCAATGG.CGTACATCT	CCGCAATGG.CGTACATCT
CCGCAATGG.TATGAGACC	CCGCAATGG.TATGAGACC
CCGCAATGG.TCTCCGCGT	CCGCAATGG.TCTCCGCGT
CCGCAATGG.TTACAGTGT	CCGCAATGG.TTACAGTGT
CCGCACTCA.AAGAGAACT	CCGCACTCA.AAGAGAACT
CCGCACTCA.ACCTTGAAG	CCGCACTCA.ACCTTGAAG
CCGCACTCA.CTTACCTAG	CCGCACTCA.CTTACCTAG
CCGCACTCA.GTCTGAGCC	CCGCACTCA.GTCTGAGCC
CCGCACTCA.TTAGGAAGG	CCGCACTCA.TTAGGAAGG
CCGCAGAAT.AGCGGAACA	CCGCAGAAT.AGCGGAACA
CCGCAGAAT.CAGTGAGGA	CCGCAGAAT.CAGTGAGGA
CCGCAGAAT.CCTATTGGT	CCGCAGAAT.CCTATTGGT
CCGCAGAAT.GGATCAGGT	CCGCAGAAT.GGATCAGGT
CCGCAGAAT.TACGAACTC	CCGCAGAAT.TACGAACTC
CCGCAGAAT.TAGGATGCC	CCGCAGAAT.TAGGATGCC
CCGCAGAAT.TGCACGATG	CCGCAGAAT.TGCACGATG
CCGCAGAAT.TGGTTATAC	CCGCAGAAT.TGGTTATAC
CCGCAGAAT.TGTAGATCG	CCGCAGAAT.TGTAGATCG
CCGCAGCTA.GTATGCCTT	CCGCAGCTA.GTATGCCTT
CCGCAGCTA.GTGCGAGTA	CCGCAGCTA.GTGCGAGTA
CCGCAGCTA.TGGAACTAA	CCGCAGCTA.TGGAACTAA
CCGCATCCT.ACTATTGTC	CCGCATCCT.ACTATTGTC
CCGCATCCT.AGTCGCCGA	CCGCATCCT.AGTCGCCGA
CCGCATCCT.CGCAGTGTC	CCGCATCCT.CGCAGTGTC
CCGCATCCT.CTGAGTAGC	CCGCATCCT.CTGAGTAGC
CCGCATCCT.GGTACTTCC	CCGCATCCT.GGTACTTCC
CCGCTATCC.CAGCTTACC	CCGCTATCC.CAGCTTACC
CCGCTATCC.CCGCTATCC	CCGCTATCC.CCGCTATCC
CCGCTCATG.ACGGTGCCT	CCGCTCATG.ACGGTGCCT
CCGCTCATG.CGCGTGAGA	CCGCTCATG.CGCGTGAGA
CCGCTCATG.CGTGTGTGG	CCGCTCATG.CGTGTGTGG
CCGCTCATG.CTGGAGCGA	CCGCTCATG.CTGGAGCGA
CCGCTCATG.GGAATTCAC	CCGCTCATG.GGAATTCAC
CCGCTCATG.TATTACAGC	CCGCTCATG.TATTACAGC
CCGGATTGC.AGCGCATGA	CCGGATTGC.AGCGCATGA
CCGGATTGC.AGTGAGAGA	CCGGATTGC.AGTGAGAGA
CCGGATTGC.ATTATGCAG	CCGGATTGC.ATTATGCAG
CCGGATTGC.CTGAGTCCA	CCGGATTGC.CTGAGTCCA
CCGGATTGC.GCGACAACC	CCGGATTGC.GCGACAACC
CCGGATTGC.GTAATCAGC	CCGGATTGC.GTAATCAGC
CCGGATTGC.GTCTACCAA	CCGGATTGC.GTCTACCAA
CCGGTGGTT.ACTCGTCTA	CCGGTGGTT.ACTCGTCTA
CCGGTGGTT.ATCTCTGCT	CCGGTGGTT.ATCTCTGCT
CCGGTGGTT.ATGATAGCT	CCGGTGGTT.ATGATAGCT
CCGGTGGTT.CATCTCGAT	CCGGTGGTT.CATCTCGAT
CCGGTTCTA.CCTATTCAA	CCGGTTCTA.CCTATTCAA
CCGGTTCTA.GCAATGAGA	CCGGTTCTA.GCAATGAGA
CCGGTTCTA.GTCCACAAC	CCGGTTCTA.GTCCACAAC
CCGGTTCTA.TGGAATCGT	CCGGTTCTA.TGGAATCGT
CCGGTTCTA.TTCCTTGAC	CCGGTTCTA.TTCCTTGAC
CCGGTTGAG.ACATGACTA	CCGGTTGAG.ACATGACTA
CCGGTTGAG.GGACTCCTT	CCGGTTGAG.GGACTCCTT
CCGGTTGAG.GGTGGAGCT	CCGGTTGAG.GGTGGAGCT
CCGGTTGAG.GTTGACCAT	CCGGTTGAG.GTTGACCAT
CCGGTTGAG.TCAGTAAGC	CCGGTTGAG.TCAGTAAGC
CCGGTTGAG.TTCGCATCC	CCGGTTGAG.TTCGCATCC
CCGTACGGA.AATACCTTG	CCGTACGGA.AATACCTTG
CCGTACGGA.ATCAAGAGA	CCGTACGGA.ATCAAGAGA
CCGTACGGA.ATCATAGAC	CCGTACGGA.ATCATAGAC
CCGTACGGA.GTTAGTCAA	CCGTACGGA.GTTAGTCAA
CCGTACGGA.TGGATTAGC	CCGTACGGA.TGGATTAGC
CCGTAGTTG.ACAAGTACA	CCGTAGTTG.ACAAGTACA
CCGTAGTTG.ATCACTTCC	CCGTAGTTG.ATCACTTCC
CCGTAGTTG.ATGATAGCT	CCGTAGTTG.ATGATAGCT
CCGTAGTTG.TAATGTAGC	CCGTAGTTG.TAATGTAGC
CCGTAGTTG.TACAAGAGG	CCGTAGTTG.TACAAGAGG
CCGTAGTTG.TCTGCAACA	CCGTAGTTG.TCTGCAACA
CCGTCAGGT.AAGACGAAG	CCGTCAGGT.AAGACGAAG
CCGTCAGGT.ACACAGAAC	CCGTCAGGT.ACACAGAAC
CCGTCAGGT.AGGAATTGG	CCGTCAGGT.AGGAATTGG
CCGTCAGGT.ATCATGTTC	CCGTCAGGT.ATCATGTTC
CCGTCAGGT.CACCAAGAT	CCGTCAGGT.CACCAAGAT
CCGTCAGGT.GGTAAGGAT	CCGTCAGGT.GGTAAGGAT
CCGTCAGGT.GGTCTCATG	CCGTCAGGT.GGTCTCATG
CCGTCAGGT.TCCGTATAC	CCGTCAGGT.TCCGTATAC
CCGTCAGGT.TGAAGACCA	CCGTCAGGT.TGAAGACCA
CCGTCCACT.AGTACGAAT	CCGTCCACT.AGTACGAAT
CCGTCCACT.CACACTGCC	CCGTCCACT.CACACTGCC
CCGTCCACT.CTGAGTAGC	CCGTCCACT.CTGAGTAGC
CCGTCCACT.CTTCGACTG	CCGTCCACT.CTTCGACTG
CCGTCCACT.GATCGATAC	CCGTCCACT.GATCGATAC
CCGTCCACT.GATCTTCGC	CCGTCCACT.GATCTTCGC
CCGTCCACT.TCCAGCAGC	CCGTCCACT.TCCAGCAGC
CCGTTAGAC.AGTCGATCA	CCGTTAGAC.AGTCGATCA
CCGTTAGAC.ATACCGAAG	CCGTTAGAC.ATACCGAAG
CCGTTAGAC.ATGCTCACC	CCGTTAGAC.ATGCTCACC
CCGTTAGAC.CACGACTCA	CCGTTAGAC.CACGACTCA
CCGTTAGAC.CCTTAACAT	CCGTTAGAC.CCTTAACAT
CCGTTAGAC.CGAACAGAG	CCGTTAGAC.CGAACAGAG
CCGTTAGAC.GCCTTATCT	CCGTTAGAC.GCCTTATCT
CCGTTAGAC.GCGTTCAGA	CCGTTAGAC.GCGTTCAGA
CCGTTAGAC.GGTCTCATG	CCGTTAGAC.GGTCTCATG
CCGTTAGAC.GTCGTGTTA	CCGTTAGAC.GTCGTGTTA
CCGTTAGAC.TGAAGACCA	CCGTTAGAC.TGAAGACCA
CCGTTAGAC.TGATTATCG	CCGTTAGAC.TGATTATCG
CCGTTAGAC.TTATCCAAG	CCGTTAGAC.TTATCCAAG
CCGTTCCAA.CACTAGACT	CCGTTCCAA.CACTAGACT
CCGTTCCAA.CGCACTGAA	CCGTTCCAA.CGCACTGAA
CCGTTCCAA.CTGGTCGGT	CCGTTCCAA.CTGGTCGGT
CCGTTCCAA.GGACGAGCA	CCGTTCCAA.GGACGAGCA
CCGTTCCAA.GGTGAGTTC	CCGTTCCAA.GGTGAGTTC
CCGTTCCAA.TGGTTATAC	CCGTTCCAA.TGGTTATAC
CCTAAGAAG.AACTAACTG	CCTAAGAAG.AACTAACTG
CCTAAGAAG.ACTTGATCT	CCTAAGAAG.ACTTGATCT
CCTAAGAAG.AGTTATCGC	CCTAAGAAG.AGTTATCGC
CCTAAGAAG.ATGTCGCCT	CCTAAGAAG.ATGTCGCCT
CCTAAGAAG.CATCCACCG	CCTAAGAAG.CATCCACCG
CCTAAGAAG.GTAACGCGA	CCTAAGAAG.GTAACGCGA
CCTAAGAAG.TATACGTGG	CCTAAGAAG.TATACGTGG
CCTAAGAAG.TATTACTCG	CCTAAGAAG.TATTACTCG
CCTAAGAAG.TGACCAAGT	CCTAAGAAG.TGACCAAGT
CCTAAGTCT.AATGCAGCG	CCTAAGTCT.AATGCAGCG
CCTAAGTCT.ACTCTGCTC	CCTAAGTCT.ACTCTGCTC
CCTAAGTCT.AGACATATC	CCTAAGTCT.AGACATATC
CCTAAGTCT.AGCGGTCTA	CCTAAGTCT.AGCGGTCTA
CCTAAGTCT.ATGTCCTCC	CCTAAGTCT.ATGTCCTCC
CCTAAGTCT.CACTACAGG	CCTAAGTCT.CACTACAGG
CCTAAGTCT.CTTGATCTA	CCTAAGTCT.CTTGATCTA
CCTAAGTCT.GACCACTCG	CCTAAGTCT.GACCACTCG
CCTAAGTCT.GTTGCATGG	CCTAAGTCT.GTTGCATGG
CCTAAGTCT.TCGACGTTG	CCTAAGTCT.TCGACGTTG
CCTACTAGA.AGCTTGGTG	CCTACTAGA.AGCTTGGTG
CCTACTAGA.TGAGACAGC	CCTACTAGA.TGAGACAGC
CCTAGAGTA.ACGTGCTCG	CCTAGAGTA.ACGTGCTCG
CCTAGAGTA.ATTCCTACG	CCTAGAGTA.ATTCCTACG
CCTAGAGTA.TCGTCATTC	CCTAGAGTA.TCGTCATTC
CCTAGCAAT.ACAGCATCA	CCTAGCAAT.ACAGCATCA
CCTAGCAAT.GACGTTCAG	CCTAGCAAT.GACGTTCAG
CCTAGCAAT.GGTAACTAC	CCTAGCAAT.GGTAACTAC
CCTAGCAAT.GTCTGAGCC	CCTAGCAAT.GTCTGAGCC
CCTAGCAAT.TAGTTGACG	CCTAGCAAT.TAGTTGACG
CCTAGTCTC.ACTCTGCTC	CCTAGTCTC.ACTCTGCTC
CCTAGTTAG.AGCCGTTCT	CCTAGTTAG.AGCCGTTCT
CCTAGTTAG.ATCTACATC	CCTAGTTAG.ATCTACATC
CCTAGTTAG.GAGATTCCT	CCTAGTTAG.GAGATTCCT
CCTAGTTAG.GGTTGCTAT	CCTAGTTAG.GGTTGCTAT
CCTAGTTAG.TCGTTCTCC	CCTAGTTAG.TCGTTCTCC
CCTAGTTAG.TTAGATCGG	CCTAGTTAG.TTAGATCGG
CCTATTCAA.ATTGCCGAC	CCTATTCAA.ATTGCCGAC
CCTATTCAA.CACCTCGGA	CCTATTCAA.CACCTCGGA
CCTATTCAA.CGTCATGGA	CCTATTCAA.CGTCATGGA
CCTATTCAA.GACTAGCAT	CCTATTCAA.GACTAGCAT
CCTATTCAA.GCGGAGATT	CCTATTCAA.GCGGAGATT
CCTATTCAA.TAGATCTGT	CCTATTCAA.TAGATCTGT
CCTATTGGT.CACCTTCCT	CCTATTGGT.CACCTTCCT
CCTATTGGT.TTGACCTGA	CCTATTGGT.TTGACCTGA
CCTCAGGTG.CCTGACCTC	CCTCAGGTG.CCTGACCTC
CCTCAGGTG.CCTTCCTCA	CCTCAGGTG.CCTTCCTCA
CCTCATAAC.AACACACTC	CCTCATAAC.AACACACTC
CCTCATAAC.ACGTAGTAT	CCTCATAAC.ACGTAGTAT
CCTCATAAC.AGCACCGTG	CCTCATAAC.AGCACCGTG
CCTCATAAC.AGTAATGGT	CCTCATAAC.AGTAATGGT
CCTCATAAC.GAGTCACCA	CCTCATAAC.GAGTCACCA
CCTCATAAC.TATGCCTTC	CCTCATAAC.TATGCCTTC
CCTCATAAC.TCCGGAGCT	CCTCATAAC.TCCGGAGCT
CCTCCAATC.AAGTAGGAC	CCTCCAATC.AAGTAGGAC
CCTCCAATC.CAATCTCCG	CCTCCAATC.CAATCTCCG
CCTCCAATC.GCACTGGAT	CCTCCAATC.GCACTGGAT
CCTCCAATC.GTAGAGAGC	CCTCCAATC.GTAGAGAGC
CCTCCAATC.TAACTCCGA	CCTCCAATC.TAACTCCGA
CCTCCAATC.TACGAACTC	CCTCCAATC.TACGAACTC
CCTCCAATC.TCTAGGATG	CCTCCAATC.TCTAGGATG
CCTCCAATC.TGAGGTCTC	CCTCCAATC.TGAGGTCTC
CCTCCTTGT.ATATAGCGT	CCTCCTTGT.ATATAGCGT
CCTCCTTGT.CGTGACCAG	CCTCCTTGT.CGTGACCAG
CCTCCTTGT.TATGTACCT	CCTCCTTGT.TATGTACCT
CCTCCTTGT.TCGCTGATT	CCTCCTTGT.TCGCTGATT
CCTCGACCT.AACGGTAGC	CCTCGACCT.AACGGTAGC
CCTCGACCT.AGGTCAGCA	CCTCGACCT.AGGTCAGCA
CCTCGACCT.ATGGAGAGT	CCTCGACCT.ATGGAGAGT
CCTCGACCT.CCAGATCAC	CCTCGACCT.CCAGATCAC
CCTCGACCT.CCTGACCTC	CCTCGACCT.CCTGACCTC
CCTCGACCT.CTGTAGAAG	CCTCGACCT.CTGTAGAAG
CCTCGACCT.GACCGTAGT	CCTCGACCT.GACCGTAGT
CCTCGACCT.GAGGTCCTT	CCTCGACCT.GAGGTCCTT
CCTCGACCT.TATCAGTGC	CCTCGACCT.TATCAGTGC
CCTCGAGAG.AAGGTGCTG	CCTCGAGAG.AAGGTGCTG
CCTCGAGAG.ATCATAGAC	CCTCGAGAG.ATCATAGAC
CCTCGAGAG.CCACTTCGC	CCTCGAGAG.CCACTTCGC
CCTCGAGAG.CTTAGAAGG	CCTCGAGAG.CTTAGAAGG
CCTCGAGAG.GATCTGTTC	CCTCGAGAG.GATCTGTTC
CCTCGAGAG.GTCACTATG	CCTCGAGAG.GTCACTATG
CCTCGAGAG.GTTGCATGG	CCTCGAGAG.GTTGCATGG
CCTCGCGTT.AACTAACTG	CCTCGCGTT.AACTAACTG
CCTCGCGTT.ATAATGTGG	CCTCGCGTT.ATAATGTGG
CCTCGCGTT.CGGTTCTAT	CCTCGCGTT.CGGTTCTAT
CCTCGCGTT.CTGCATGTT	CCTCGCGTT.CTGCATGTT
CCTCGCGTT.CTTAAGTTG	CCTCGCGTT.CTTAAGTTG
CCTCGCGTT.GATAAGCTG	CCTCGCGTT.GATAAGCTG
CCTCGCGTT.TATCATGCT	CCTCGCGTT.TATCATGCT
CCTCGGTCA.AACTGCGAC	CCTCGGTCA.AACTGCGAC
CCTCGGTCA.AAGGAACAG	CCTCGGTCA.AAGGAACAG
CCTCGGTCA.CTGACAGCA	CCTCGGTCA.CTGACAGCA
CCTCGGTCA.CTGAGGTTA	CCTCGGTCA.CTGAGGTTA
CCTCGGTCA.CTGTCACTT	CCTCGGTCA.CTGTCACTT
CCTCGGTCA.TAGGAGCTA	CCTCGGTCA.TAGGAGCTA
CCTCTCTAG.CCTAGTCTC	CCTCTCTAG.CCTAGTCTC
CCTCTCTAG.GAATAAGAG	CCTCTCTAG.GAATAAGAG
CCTCTCTAG.GCTAGCTCC	CCTCTCTAG.GCTAGCTCC
CCTCTGCAT.ATCTCGAAC	CCTCTGCAT.ATCTCGAAC
CCTCTGCAT.GATCGATAC	CCTCTGCAT.GATCGATAC
CCTCTGCAT.GCGCTCTAT	CCTCTGCAT.GCGCTCTAT
CCTCTGCAT.GGTCCTAAG	CCTCTGCAT.GGTCCTAAG
CCTCTGCAT.TATACCACT	CCTCTGCAT.TATACCACT
CCTCTGCAT.TTCCTTGAC	CCTCTGCAT.TTCCTTGAC
CCTCTTGTA.ACTGGTGCT	CCTCTTGTA.ACTGGTGCT
CCTCTTGTA.AGACCACGC	CCTCTTGTA.AGACCACGC
CCTCTTGTA.GATATATCC	CCTCTTGTA.GATATATCC
CCTCTTGTA.GATCGATAC	CCTCTTGTA.GATCGATAC
CCTCTTGTA.GCGGACGAA	CCTCTTGTA.GCGGACGAA
CCTCTTGTA.GGTTAGATG	CCTCTTGTA.GGTTAGATG
CCTCTTGTA.TCTACATCC	CCTCTTGTA.TCTACATCC
CCTCTTGTA.TCTTAGCGA	CCTCTTGTA.TCTTAGCGA
CCTCTTGTA.TGATAGAGG	CCTCTTGTA.TGATAGAGG
CCTCTTGTA.TTCCTCGGT	CCTCTTGTA.TTCCTCGGT
CCTCTTGTA.TTGCTCTGC	CCTCTTGTA.TTGCTCTGC
CCTGACCTC.ACGCGACAG	CCTGACCTC.ACGCGACAG
CCTGACCTC.CTCGTTCAC	CCTGACCTC.CTCGTTCAC
CCTGACCTC.TATTGCTAC	CCTGACCTC.TATTGCTAC
CCTGACCTC.TGAACGGTT	CCTGACCTC.TGAACGGTT
CCTGCAGAT.ACCGTACGC	CCTGCAGAT.ACCGTACGC
CCTGCAGAT.AGCCGTTCT	CCTGCAGAT.AGCCGTTCT
CCTGCAGAT.AGGTGCGAG	CCTGCAGAT.AGGTGCGAG
CCTGCAGAT.CACAGCGAA	CCTGCAGAT.CACAGCGAA
CCTGCAGAT.CGTCTGTCC	CCTGCAGAT.CGTCTGTCC
CCTGCAGAT.CTAACCGGT	CCTGCAGAT.CTAACCGGT
CCTGCAGAT.GACCGGTAG	CCTGCAGAT.GACCGGTAG
CCTGCAGAT.GTGTATCTG	CCTGCAGAT.GTGTATCTG
CCTGCGTTA.AATTAGAGG	CCTGCGTTA.AATTAGAGG
CCTGCGTTA.AGGTATTCC	CCTGCGTTA.AGGTATTCC
CCTGCGTTA.ATGCTGTCG	CCTGCGTTA.ATGCTGTCG
CCTGCTCCA.ATAGCCTAA	CCTGCTCCA.ATAGCCTAA
CCTGCTCCA.CACATATCA	CCTGCTCCA.CACATATCA
CCTGCTCCA.CAGCTTCGA	CCTGCTCCA.CAGCTTCGA
CCTGCTCCA.CTGTCTAGT	CCTGCTCCA.CTGTCTAGT
CCTGCTCCA.GGTCTTGCA	CCTGCTCCA.GGTCTTGCA
CCTGCTCCA.TGAAGACCA	CCTGCTCCA.TGAAGACCA
CCTGTATCT.ACGACTGCG	CCTGTATCT.ACGACTGCG
CCTGTATCT.ATGGACGTT	CCTGTATCT.ATGGACGTT
CCTGTATCT.CAACACCTA	CCTGTATCT.CAACACCTA
CCTGTATCT.CAAGCCTCG	CCTGTATCT.CAAGCCTCG
CCTGTATCT.GCTAGCTCC	CCTGTATCT.GCTAGCTCC
CCTGTATCT.TTACTTACG	CCTGTATCT.TTACTTACG
CCTGTATCT.TTCCGAGCG	CCTGTATCT.TTCCGAGCG
CCTGTCATT.AGGAGGTGA	CCTGTCATT.AGGAGGTGA
CCTGTCATT.CGCACTGAA	CCTGTCATT.CGCACTGAA
CCTGTCGAC.AACTTGTCG	CCTGTCGAC.AACTTGTCG
CCTGTCGAC.AAGGTCTGA	CCTGTCGAC.AAGGTCTGA
CCTGTCGAC.ACAGGAACT	CCTGTCGAC.ACAGGAACT
CCTGTCGAC.ATCATAGAC	CCTGTCGAC.ATCATAGAC
CCTGTCGAC.CCTCCTTGT	CCTGTCGAC.CCTCCTTGT
CCTGTCGAC.CGATCCAGA	CCTGTCGAC.CGATCCAGA
CCTGTCGAC.CGTGGTACC	CCTGTCGAC.CGTGGTACC
CCTGTCGAC.CTGGACACT	CCTGTCGAC.CTGGACACT
CCTGTCGAC.GGTACTTCC	CCTGTCGAC.GGTACTTCC
CCTGTCGAC.TAATTCGTG	CCTGTCGAC.TAATTCGTG
CCTGTCGAC.TACCATGTA	CCTGTCGAC.TACCATGTA
CCTGTCGAC.TTCTGCCGA	CCTGTCGAC.TTCTGCCGA
CCTGTTAGC.AGAGAGTGG	CCTGTTAGC.AGAGAGTGG
CCTGTTAGC.CCATAGCCA	CCTGTTAGC.CCATAGCCA
CCTGTTAGC.CCTATTGGT	CCTGTTAGC.CCTATTGGT
CCTGTTAGC.GGACGAGCA	CCTGTTAGC.GGACGAGCA
CCTGTTAGC.TCGTGACGT	CCTGTTAGC.TCGTGACGT
CCTGTTAGC.TGACGATGA	CCTGTTAGC.TGACGATGA
CCTGTTAGC.TTATCCAAG	CCTGTTAGC.TTATCCAAG
CCTTAACAT.AGGTATTCC	CCTTAACAT.AGGTATTCC
CCTTAACAT.CAAGAGGAG	CCTTAACAT.CAAGAGGAG
CCTTAACAT.CACTTCCTT	CCTTAACAT.CACTTCCTT
CCTTAACAT.GCCAACAAT	CCTTAACAT.GCCAACAAT
CCTTAACAT.TCCGATCTG	CCTTAACAT.TCCGATCTG
CCTTAACAT.TGCCGACTA	CCTTAACAT.TGCCGACTA
CCTTAACAT.TGTTACTGA	CCTTAACAT.TGTTACTGA
CCTTAATTC.ACTACCATC	CCTTAATTC.ACTACCATC
CCTTAATTC.ACTCGTCTA	CCTTAATTC.ACTCGTCTA
CCTTAATTC.GGAGCATCT	CCTTAATTC.GGAGCATCT
CCTTATCCG.ACGTGAATC	CCTTATCCG.ACGTGAATC
CCTTATCCG.ATCCGTCTC	CCTTATCCG.ATCCGTCTC
CCTTATCCG.ATTGCCGAC	CCTTATCCG.ATTGCCGAC
CCTTATCCG.GTTGCTCAG	CCTTATCCG.GTTGCTCAG
CCTTATCCG.TACAGTTAG	CCTTATCCG.TACAGTTAG
CCTTATCCG.TCCACCGGT	CCTTATCCG.TCCACCGGT
CCTTCCTCA.AATCTGACC	CCTTCCTCA.AATCTGACC
CCTTCCTCA.ACTCCAACT	CCTTCCTCA.ACTCCAACT
CCTTCCTCA.CAATCATAC	CCTTCCTCA.CAATCATAC
CCTTCCTCA.CAGTACATC	CCTTCCTCA.CAGTACATC
CCTTCCTCA.CTATGGATG	CCTTCCTCA.CTATGGATG
CCTTCCTCA.TAGCCTTGT	CCTTCCTCA.TAGCCTTGT
CCTTCGAGC.CTATGGATG	CCTTCGAGC.CTATGGATG
CCTTGACGG.AGTTACAAG	CCTTGACGG.AGTTACAAG
CCTTGACGG.TATGGTTGG	CCTTGACGG.TATGGTTGG
CCTTGACGG.TCTCAGGAT	CCTTGACGG.TCTCAGGAT
CCTTGACGG.TTGCAGTCA	CCTTGACGG.TTGCAGTCA
CCTTGCTTG.CATTGACAA	CCTTGCTTG.CATTGACAA
CCTTGCTTG.CCGATCAGC	CCTTGCTTG.CCGATCAGC
CCTTGCTTG.CGGTCGACA	CCTTGCTTG.CGGTCGACA
CCTTGCTTG.GCAACTCGC	CCTTGCTTG.GCAACTCGC
CCTTGCTTG.TCCAATCAT	CCTTGCTTG.TCCAATCAT
CCTTGTTGC.AGGATGCGT	CCTTGTTGC.AGGATGCGT
CCTTGTTGC.CAATCATAC	CCTTGTTGC.CAATCATAC
CCTTGTTGC.CGTCATGGA	CCTTGTTGC.CGTCATGGA
CCTTGTTGC.TCTTAGCGA	CCTTGTTGC.TCTTAGCGA
CGAACAATC.ACGAGCTTC	CGAACAATC.ACGAGCTTC
CGAACAATC.CCAGATCAC	CGAACAATC.CCAGATCAC
CGAACAATC.CTGGTGACA	CGAACAATC.CTGGTGACA
CGAACAATC.TAACGGATA	CGAACAATC.TAACGGATA
CGAACAATC.TGACTGAGA	CGAACAATC.TGACTGAGA
CGAACAGAG.ATCGTAGTG	CGAACAGAG.ATCGTAGTG
CGAACAGAG.CTAGTCGTC	CGAACAGAG.CTAGTCGTC
CGAAGAGGT.ACACGTTGC	CGAAGAGGT.ACACGTTGC
CGAAGAGGT.CGGAACGAG	CGAAGAGGT.CGGAACGAG
CGAAGAGGT.TACTAGTAG	CGAAGAGGT.TACTAGTAG
CGAATCCTG.AGTGGAATG	CGAATCCTG.AGTGGAATG
CGAATCCTG.CGCTTATGA	CGAATCCTG.CGCTTATGA
CGAATGAGT.AAGCTGGTC	CGAATGAGT.AAGCTGGTC
CGAATGAGT.CTCGTCTTG	CGAATGAGT.CTCGTCTTG
CGACAGACC.ATACTTGCT	CGACAGACC.ATACTTGCT
CGACAGACC.TACGTTACC	CGACAGACC.TACGTTACC
CGACAGACC.TTACTAGTC	CGACAGACC.TTACTAGTC
CGACAGGAA.CCTCGCGTT	CGACAGGAA.CCTCGCGTT
CGACCACTT.ACGTACTGC	CGACCACTT.ACGTACTGC
CGACCACTT.ATCCTCCGA	CGACCACTT.ATCCTCCGA
CGACCACTT.CCGCAGCTA	CGACCACTT.CCGCAGCTA
CGACCACTT.CCTCAGGTG	CGACCACTT.CCTCAGGTG
CGACCATCA.AGAAGTAAC	CGACCATCA.AGAAGTAAC
CGACCATCA.AGGATTGAG	CGACCATCA.AGGATTGAG
CGACCATCA.CACGTAGAC	CGACCATCA.CACGTAGAC
CGACCATCA.CGTTGATCC	CGACCATCA.CGTTGATCC
CGACCATCA.GGTACGAGC	CGACCATCA.GGTACGAGC
CGACCATCA.TCGGATGTT	CGACCATCA.TCGGATGTT
CGACCATCA.TTACTAGTC	CGACCATCA.TTACTAGTC
CGACCTAGC.AATGCTATC	CGACCTAGC.AATGCTATC
CGACCTAGC.ACAAGAATG	CGACCTAGC.ACAAGAATG
CGACCTAGC.ACTGTAATC	CGACCTAGC.ACTGTAATC
CGACCTAGC.ATGCTCACC	CGACCTAGC.ATGCTCACC
CGACCTAGC.CACTACAGG	CGACCTAGC.CACTACAGG
CGACCTAGC.TAGCACTAT	CGACCTAGC.TAGCACTAT
CGACCTGTA.CAGCTTACC	CGACCTGTA.CAGCTTACC
CGACCTGTA.CCACGAAGG	CGACCTGTA.CCACGAAGG
CGACCTGTA.GTAACCATA	CGACCTGTA.GTAACCATA
CGACCTGTA.GTCTCCAGG	CGACCTGTA.GTCTCCAGG
CGACGTACG.ACGGTGTAC	CGACGTACG.ACGGTGTAC
CGACGTACG.CAGCTTACC	CGACGTACG.CAGCTTACC
CGACGTACG.TCCAGAACG	CGACGTACG.TCCAGAACG
CGACGTGAT.AGTTACAAG	CGACGTGAT.AGTTACAAG
CGACGTGAT.ATCGGTGGT	CGACGTGAT.ATCGGTGGT
CGACGTGAT.ATCTTACAG	CGACGTGAT.ATCTTACAG
CGACGTGAT.GCCATTAAG	CGACGTGAT.GCCATTAAG
CGACGTGAT.GCTACCGAG	CGACGTGAT.GCTACCGAG
CGACGTGAT.TTGTCAACC	CGACGTGAT.TTGTCAACC
CGAGCCGTT.ATGAACTAG	CGAGCCGTT.ATGAACTAG
CGAGCTTAC.CCGGATTGC	CGAGCTTAC.CCGGATTGC
CGAGTAGCA.AATTAGAGG	CGAGTAGCA.AATTAGAGG
CGAGTAGCA.AGAGCCGCA	CGAGTAGCA.AGAGCCGCA
CGAGTAGCA.AGGAGCAAT	CGAGTAGCA.AGGAGCAAT
CGAGTAGCA.ATTCGAAGA	CGAGTAGCA.ATTCGAAGA
CGAGTAGCA.CACGTAGAC	CGAGTAGCA.CACGTAGAC
CGAGTAGCA.CAGCACGTG	CGAGTAGCA.CAGCACGTG
CGAGTAGCA.CCGCATCCT	CGAGTAGCA.CCGCATCCT
CGAGTAGCA.GAGAATCAG	CGAGTAGCA.GAGAATCAG
CGAGTAGCA.TGTATGTAG	CGAGTAGCA.TGTATGTAG
CGATACTCT.AACAGCAGT	CGATACTCT.AACAGCAGT
CGATACTCT.AGGAAGGTG	CGATACTCT.AGGAAGGTG
CGATAGGTG.ATCCTGCCT	CGATAGGTG.ATCCTGCCT
CGATAGGTG.CAACACTCC	CGATAGGTG.CAACACTCC
CGATAGGTG.CATATGTCG	CGATAGGTG.CATATGTCG
CGATAGGTG.CATCCTCTC	CGATAGGTG.CATCCTCTC
CGATAGGTG.CTTGCGACC	CGATAGGTG.CTTGCGACC
CGATAGGTG.TCAATCTAG	CGATAGGTG.TCAATCTAG
CGATCCAGA.AAGGAAGTC	CGATCCAGA.AAGGAAGTC
CGATCCAGA.AATTAGAGG	CGATCCAGA.AATTAGAGG
CGATCCAGA.GTCGTCGAC	CGATCCAGA.GTCGTCGAC
CGATCCAGA.GTGGTACGG	CGATCCAGA.GTGGTACGG
CGATTCGAG.AACAATGCA	CGATTCGAG.AACAATGCA
CGATTCGAG.ACATTCCAC	CGATTCGAG.ACATTCCAC
CGATTCGAG.ACGCTAGTG	CGATTCGAG.ACGCTAGTG
CGATTCGAG.AGCGTAGAA	CGATTCGAG.AGCGTAGAA
CGATTCGAG.GACGGACTA	CGATTCGAG.GACGGACTA
CGATTCGAG.GCCAACAAT	CGATTCGAG.GCCAACAAT
CGATTCGAG.GCTAGCTCC	CGATTCGAG.GCTAGCTCC
CGATTCGAG.TGACCAAGT	CGATTCGAG.TGACCAAGT
CGATTGAAC.AATCCTCGT	CGATTGAAC.AATCCTCGT
CGATTGAAC.ACCGAGTAG	CGATTGAAC.ACCGAGTAG
CGATTGAAC.ATATAGCGT	CGATTGAAC.ATATAGCGT
CGATTGAAC.CCGTTCCAA	CGATTGAAC.CCGTTCCAA
CGATTGAAC.GGTGTTCAT	CGATTGAAC.GGTGTTCAT
CGATTGAAC.TAGCTGTTG	CGATTGAAC.TAGCTGTTG
CGATTGAAC.TGAAGACCA	CGATTGAAC.TGAAGACCA
CGATTGAAC.TGCGTCTTA	CGATTGAAC.TGCGTCTTA
CGCAACCTC.AACTAACTG	CGCAACCTC.AACTAACTG
CGCAACCTC.ACAGTATTG	CGCAACCTC.ACAGTATTG
CGCAACCTC.CAACCTGGT	CGCAACCTC.CAACCTGGT
