AGTCATACT.CCTCCAATC	AGTCATACT.CCTCCAATC
AGTCATACT.CTCTTCAGC	AGTCATACT.CTCTTCAGC
AGTCATACT.CTGAGTAGC	AGTCATACT.CTGAGTAGC
AGTCATACT.TATACCACT	AGTCATACT.TATACCACT
AGTCCAGTG.AACGAGGTG	AGTCCAGTG.AACGAGGTG
AGTCCAGTG.AAGTACAGA	AGTCCAGTG.AAGTACAGA
AGTCCAGTG.ACCTAGTTA	AGTCCAGTG.ACCTAGTTA
AGTCCAGTG.ATACCGCTT	AGTCCAGTG.ATACCGCTT
AGTCCAGTG.CAGCTGGAG	AGTCCAGTG.CAGCTGGAG
AGTCCAGTG.CCAATATAC	AGTCCAGTG.CCAATATAC
AGTCCAGTG.CGTGACCAG	AGTCCAGTG.CGTGACCAG
AGTCCAGTG.GAGATTCCT	AGTCCAGTG.GAGATTCCT
AGTCCAGTG.GGATCGTTC	AGTCCAGTG.GGATCGTTC
AGTCCAGTG.TAGAGACTA	AGTCCAGTG.TAGAGACTA
AGTCCAGTG.TAGTTGACG	AGTCCAGTG.TAGTTGACG
AGTCCGTGT.GACCGTAGT	AGTCCGTGT.GACCGTAGT
AGTCCGTGT.GCGCTAGAA	AGTCCGTGT.GCGCTAGAA
AGTCCGTGT.GGAGACACA	AGTCCGTGT.GGAGACACA
AGTCCGTGT.TGTACACGA	AGTCCGTGT.TGTACACGA
AGTCGATCA.ACAGCATCA	AGTCGATCA.ACAGCATCA
AGTCGCCGA.AGAGAGTGG	AGTCGCCGA.AGAGAGTGG
AGTCGCCGA.CACATGTGC	AGTCGCCGA.CACATGTGC
AGTCGCCGA.CATCCTCTC	AGTCGCCGA.CATCCTCTC
AGTCGCCGA.CTGTAGAAG	AGTCGCCGA.CTGTAGAAG
AGTCGCCGA.TAACACATC	AGTCGCCGA.TAACACATC
AGTCGCCGA.TAGACACGT	AGTCGCCGA.TAGACACGT
AGTCGCCGA.TGGTGGTAA	AGTCGCCGA.TGGTGGTAA
AGTCGCCGA.TGTCATAGC	AGTCGCCGA.TGTCATAGC
AGTCGCCGA.TTAAGTGGT	AGTCGCCGA.TTAAGTGGT
AGTCGCCGA.TTCTGCCGA	AGTCGCCGA.TTCTGCCGA
AGTCGCGAC.ACGTGTAGT	AGTCGCGAC.ACGTGTAGT
AGTCGCGAC.AGAATCAGA	AGTCGCGAC.AGAATCAGA
AGTCGCGAC.ATTCTCTGG	AGTCGCGAC.ATTCTCTGG
AGTCGCGAC.CAAGAGGAG	AGTCGCGAC.CAAGAGGAG
AGTCGCGAC.TATTGACTG	AGTCGCGAC.TATTGACTG
AGTCGTCCG.AAGCAATCG	AGTCGTCCG.AAGCAATCG
AGTCGTCCG.AATCCGCTG	AGTCGTCCG.AATCCGCTG
AGTCGTCCG.CTCCTGACG	AGTCGTCCG.CTCCTGACG
AGTCGTCCG.GAGTTATAG	AGTCGTCCG.GAGTTATAG
AGTCTAAGC.AATACTCCG	AGTCTAAGC.AATACTCCG
AGTCTAAGC.CCATTCTGC	AGTCTAAGC.CCATTCTGC
AGTCTAAGC.CGATTGAAC	AGTCTAAGC.CGATTGAAC
AGTCTAAGC.GCTTGTCCT	AGTCTAAGC.GCTTGTCCT
AGTCTAAGC.GTATTACTG	AGTCTAAGC.GTATTACTG
AGTCTAAGC.GTGTCCGTG	AGTCTAAGC.GTGTCCGTG
AGTCTAAGC.TGTCATAGC	AGTCTAAGC.TGTCATAGC
AGTCTGGAA.AGTCGCCGA	AGTCTGGAA.AGTCGCCGA
AGTCTGGAA.ATTAAGACC	AGTCTGGAA.ATTAAGACC
AGTCTGGAA.CAGGAGCCT	AGTCTGGAA.CAGGAGCCT
AGTCTGGAA.GCCATTAAG	AGTCTGGAA.GCCATTAAG
AGTCTGGAA.TCACATACT	AGTCTGGAA.TCACATACT
AGTCTGGAA.TTCACTCCT	AGTCTGGAA.TTCACTCCT
AGTGAACGG.CCGTTAGAC	AGTGAACGG.CCGTTAGAC
AGTGAACGG.CCTCAGGTG	AGTGAACGG.CCTCAGGTG
AGTGAACGG.GGAACCTAG	AGTGAACGG.GGAACCTAG
AGTGAACGG.TCAATCTAG	AGTGAACGG.TCAATCTAG
AGTGAACGG.TGACGATGA	AGTGAACGG.TGACGATGA
AGTGAACGG.TGAGAATCC	AGTGAACGG.TGAGAATCC
AGTGACGAT.ATGCTTCAG	AGTGACGAT.ATGCTTCAG
AGTGACGAT.CATGACGTT	AGTGACGAT.CATGACGTT
AGTGACGAT.CCAATATAC	AGTGACGAT.CCAATATAC
AGTGACGAT.CCGCAACAC	AGTGACGAT.CCGCAACAC
AGTGACGAT.GGAAGTATG	AGTGACGAT.GGAAGTATG
AGTGACGAT.TTCCTAAGG	AGTGACGAT.TTCCTAAGG
AGTGAGAGA.AAGACGAAG	AGTGAGAGA.AAGACGAAG
AGTGAGAGA.AAGGAAGTC	AGTGAGAGA.AAGGAAGTC
AGTGAGAGA.ACGGTGCCT	AGTGAGAGA.ACGGTGCCT
AGTGAGAGA.GAACCAGTT	AGTGAGAGA.GAACCAGTT
AGTGATGCG.CATGTCCTG	AGTGATGCG.CATGTCCTG
AGTGATGCG.GTACGTCTA	AGTGATGCG.GTACGTCTA
AGTGGAATG.AAGTTCTCT	AGTGGAATG.AAGTTCTCT
AGTGGAATG.ACTCCGGTT	AGTGGAATG.ACTCCGGTT
AGTGGAATG.CACACCACA	AGTGGAATG.CACACCACA
AGTGGAATG.CCATCTAGG	AGTGGAATG.CCATCTAGG
AGTGGAATG.CGAGCCGTT	AGTGGAATG.CGAGCCGTT
AGTGGAATG.GCTGGTTCG	AGTGGAATG.GCTGGTTCG
AGTGGAATG.TATTGCTAC	AGTGGAATG.TATTGCTAC
AGTGTCTCT.ACTCATTCA	AGTGTCTCT.ACTCATTCA
AGTGTCTCT.ATAAGACAG	AGTGTCTCT.ATAAGACAG
AGTGTCTCT.CACTTCCTT	AGTGTCTCT.CACTTCCTT
AGTGTCTCT.GTAGACTCT	AGTGTCTCT.GTAGACTCT
AGTGTGCAC.CCGAGCTGA	AGTGTGCAC.CCGAGCTGA
AGTGTGCAC.GAGACTCGA	AGTGTGCAC.GAGACTCGA
AGTGTGCAC.GAGGACTTA	AGTGTGCAC.GAGGACTTA
AGTGTTCTG.AGGATTACT	AGTGTTCTG.AGGATTACT
AGTGTTCTG.CTAATACGC	AGTGTTCTG.CTAATACGC
AGTGTTCTG.CTCGCAAGA	AGTGTTCTG.CTCGCAAGA
AGTGTTCTG.GCGCTCTAT	AGTGTTCTG.GCGCTCTAT
AGTTACAAG.ACGACTGCG	AGTTACAAG.ACGACTGCG
AGTTACAAG.CAAGGTGTG	AGTTACAAG.CAAGGTGTG
AGTTACAAG.GTGACTCTC	AGTTACAAG.GTGACTCTC
AGTTAGGTC.AGATACGTT	AGTTAGGTC.AGATACGTT
AGTTAGGTC.CGATTCGAG	AGTTAGGTC.CGATTCGAG
AGTTAGGTC.GGATCGTTC	AGTTAGGTC.GGATCGTTC
AGTTAGGTC.TGCGCACTG	AGTTAGGTC.TGCGCACTG
AGTTAGGTC.TTATTCGAC	AGTTAGGTC.TTATTCGAC
AGTTATCGC.AGATACGTT	AGTTATCGC.AGATACGTT
AGTTATCGC.AGTCCGTGT	AGTTATCGC.AGTCCGTGT
AGTTATCGC.ATTATGCAG	AGTTATCGC.ATTATGCAG
AGTTATCGC.GCGCTAGAA	AGTTATCGC.GCGCTAGAA
AGTTATCGC.TGCGCACTG	AGTTATCGC.TGCGCACTG
AGTTCAACC.AACGCATTG	AGTTCAACC.AACGCATTG
AGTTCAACC.AAGAGAACT	AGTTCAACC.AAGAGAACT
AGTTCAACC.CTCAGTGAT	AGTTCAACC.CTCAGTGAT
AGTTCAACC.GAGGTGAGC	AGTTCAACC.GAGGTGAGC
AGTTCAACC.TCGTGCCAC	AGTTCAACC.TCGTGCCAC
AGTTCGATA.ACTGGTGCT	AGTTCGATA.ACTGGTGCT
AGTTCGATA.CGGTTCGTA	AGTTCGATA.CGGTTCGTA
AGTTCGATA.CTCTGTCAA	AGTTCGATA.CTCTGTCAA
AGTTCGATA.TACTGATGA	AGTTCGATA.TACTGATGA
AGTTGAGCG.ATCCAGCTG	AGTTGAGCG.ATCCAGCTG
AGTTGAGCG.CCACGGATC	AGTTGAGCG.CCACGGATC
AGTTGAGCG.CGCTTCACG	AGTTGAGCG.CGCTTCACG
AGTTGAGCG.GATATATCC	AGTTGAGCG.GATATATCC
AGTTGAGCG.TACTCGACC	AGTTGAGCG.TACTCGACC
AGTTGAGCG.TGCCATCTC	AGTTGAGCG.TGCCATCTC
AGTTGAGCG.TGTAGATCG	AGTTGAGCG.TGTAGATCG
AGTTGAGCG.TTACCTCTC	AGTTGAGCG.TTACCTCTC
AGTTGCCTT.CAGATCGAC	AGTTGCCTT.CAGATCGAC
AGTTGCCTT.CGTCATGGA	AGTTGCCTT.CGTCATGGA
AGTTGCCTT.GAGAATCAG	AGTTGCCTT.GAGAATCAG
AGTTGCCTT.TATTACAGC	AGTTGCCTT.TATTACAGC
AGTTGTGTA.AGGATGCGT	AGTTGTGTA.AGGATGCGT
AGTTGTGTA.CAACTCCAG	AGTTGTGTA.CAACTCCAG
AGTTGTGTA.CGATCCAGA	AGTTGTGTA.CGATCCAGA
AGTTGTGTA.GTACGCGAT	AGTTGTGTA.GTACGCGAT
AGTTGTGTA.GTATGATCT	AGTTGTGTA.GTATGATCT
AGTTGTGTA.GTCCGCTCA	AGTTGTGTA.GTCCGCTCA
AGTTGTGTA.TATTCAACG	AGTTGTGTA.TATTCAACG
AGTTGTGTA.TCGTAATAG	AGTTGTGTA.TCGTAATAG
AGTTGTGTA.TGTTACTGA	AGTTGTGTA.TGTTACTGA
AGTTGTGTA.TTAGTCGGA	AGTTGTGTA.TTAGTCGGA
ATAACGACA.ATTATGCAG	ATAACGACA.ATTATGCAG
ATAACGACA.CCGCAGCTA	ATAACGACA.CCGCAGCTA
ATAACGACA.CGTGGTACC	ATAACGACA.CGTGGTACC
ATAACGACA.GCTCCTAGC	ATAACGACA.GCTCCTAGC
ATAACGACA.GTCTTCTCG	ATAACGACA.GTCTTCTCG
ATAAGACAG.ACAATTCGG	ATAAGACAG.ACAATTCGG
ATAAGACAG.GTAACAGTC	ATAAGACAG.GTAACAGTC
ATAAGACAG.TAGCTGTTG	ATAAGACAG.TAGCTGTTG
ATAAGACAG.TCTCGATGC	ATAAGACAG.TCTCGATGC
ATAAGTTCG.ACTGTGTCA	ATAAGTTCG.ACTGTGTCA
ATAAGTTCG.AGATCGAGT	ATAAGTTCG.AGATCGAGT
ATAAGTTCG.CACATGTGC	ATAAGTTCG.CACATGTGC
ATAATCGAG.ACGTTCAAT	ATAATCGAG.ACGTTCAAT
ATAATCGAG.AGCGGAACA	ATAATCGAG.AGCGGAACA
ATAATCGAG.AGGAAGGTG	ATAATCGAG.AGGAAGGTG
ATAATCGAG.GGTTCTATC	ATAATCGAG.GGTTCTATC
ATAATCGAG.GTCCTTCAT	ATAATCGAG.GTCCTTCAT
ATAATCGAG.GTCTTCATA	ATAATCGAG.GTCTTCATA
ATAATCGAG.TAAGTACAC	ATAATCGAG.TAAGTACAC
ATAATGTGG.ACGCTATGT	ATAATGTGG.ACGCTATGT
ATAATGTGG.AGGAGCAAT	ATAATGTGG.AGGAGCAAT
ATAATGTGG.GATGCGACG	ATAATGTGG.GATGCGACG
ATAATGTGG.TCAAGCGTA	ATAATGTGG.TCAAGCGTA
ATAATGTGG.TCACTCGCT	ATAATGTGG.TCACTCGCT
ATAATGTGG.TCCTGTCCG	ATAATGTGG.TCCTGTCCG
ATACAACCG.AGATACGTT	ATACAACCG.AGATACGTT
ATACAACCG.CATCCTCTC	ATACAACCG.CATCCTCTC
ATACAACCG.GATTGAGTA	ATACAACCG.GATTGAGTA
ATACAACCG.TAAGTACAC	ATACAACCG.TAAGTACAC
ATACAACCG.TACAAGAGG	ATACAACCG.TACAAGAGG
ATACAACCG.TAGGATTAG	ATACAACCG.TAGGATTAG
ATACAACCG.TCCACGTGC	ATACAACCG.TCCACGTGC
ATACCGAAG.AGATATGGA	ATACCGAAG.AGATATGGA
ATACCGAAG.GAAGGATCA	ATACCGAAG.GAAGGATCA
ATACCGAAG.GCTACAATG	ATACCGAAG.GCTACAATG
ATACCGAAG.GGAGCATCT	ATACCGAAG.GGAGCATCT
ATACCGAAG.TCACACTGC	ATACCGAAG.TCACACTGC
ATACCGCTT.AATGTGCGT	ATACCGCTT.AATGTGCGT
ATACCGCTT.TCCTATTCC	ATACCGCTT.TCCTATTCC
ATACGAGGT.ATAATCGAG	ATACGAGGT.ATAATCGAG
ATACTTGCT.ATGGACGTT	ATACTTGCT.ATGGACGTT
ATACTTGCT.CACACCTGT	ATACTTGCT.CACACCTGT
ATACTTGCT.CATACGCAG	ATACTTGCT.CATACGCAG
ATACTTGCT.CCTGCGTTA	ATACTTGCT.CCTGCGTTA
ATACTTGCT.TCATGCTCA	ATACTTGCT.TCATGCTCA
ATAGACCGA.AACCATGGT	ATAGACCGA.AACCATGGT
ATAGACCGA.CCGATACCG	ATAGACCGA.CCGATACCG
ATAGACCGA.CGTGTGTGG	ATAGACCGA.CGTGTGTGG
ATAGACCGA.CTGCTTAGG	ATAGACCGA.CTGCTTAGG
ATAGAGCAG.AACGCTCAA	ATAGAGCAG.AACGCTCAA
ATAGAGCAG.AGATATGGA	ATAGAGCAG.AGATATGGA
ATAGCCTAA.TTGTTAGAG	ATAGCCTAA.TTGTTAGAG
ATAGCTTGC.CCAATGCCT	ATAGCTTGC.CCAATGCCT
ATAGCTTGC.CGGTTCGTA	ATAGCTTGC.CGGTTCGTA
ATAGCTTGC.GATACACTA	ATAGCTTGC.GATACACTA
ATAGCTTGC.TAAGCCATT	ATAGCTTGC.TAAGCCATT
ATAGCTTGC.TGTGGTCCT	ATAGCTTGC.TGTGGTCCT
ATAGCTTGC.TTAACGGAG	ATAGCTTGC.TTAACGGAG
ATAGTCAGT.TGCAGTTCA	ATAGTCAGT.TGCAGTTCA
ATAGTCTCC.CACCTCGGA	ATAGTCTCC.CACCTCGGA
ATAGTCTCC.CAGGATCAA	ATAGTCTCC.CAGGATCAA
ATAGTCTCC.CTTGGATCA	ATAGTCTCC.CTTGGATCA
ATAGTCTCC.GGTAAGTGA	ATAGTCTCC.GGTAAGTGA
ATAGTCTCC.TGATTCACC	ATAGTCTCC.TGATTCACC
ATAGTGGTT.AATCAGGAG	ATAGTGGTT.AATCAGGAG
ATAGTGGTT.ACACAGAAC	ATAGTGGTT.ACACAGAAC
ATAGTGGTT.ACCGTCCTA	ATAGTGGTT.ACCGTCCTA
ATAGTGGTT.AGCAACATT	ATAGTGGTT.AGCAACATT
ATAGTGGTT.ATCAGAAGC	ATAGTGGTT.ATCAGAAGC
ATAGTGGTT.GCATACTCC	ATAGTGGTT.GCATACTCC
ATATAGCGT.ACCTTGAAG	ATATAGCGT.ACCTTGAAG
ATATAGCGT.ACTCCTGAG	ATATAGCGT.ACTCCTGAG
ATATAGCGT.AGAGGTGAA	ATATAGCGT.AGAGGTGAA
ATATAGCGT.CATCCAGGA	ATATAGCGT.CATCCAGGA
ATATAGCGT.CTCTAGTAA	ATATAGCGT.CTCTAGTAA
ATATAGCGT.CTCTGTCAA	ATATAGCGT.CTCTGTCAA
ATATAGCGT.GGATACCTA	ATATAGCGT.GGATACCTA
ATATAGCGT.GGTCCTAAG	ATATAGCGT.GGTCCTAAG
ATATAGCGT.GTATGATCT	ATATAGCGT.GTATGATCT
ATATAGCGT.TCGATTCAG	ATATAGCGT.TCGATTCAG
ATATAGCGT.TGAGCAGAT	ATATAGCGT.TGAGCAGAT
ATATCAGCC.ATCTCGTGA	ATATCAGCC.ATCTCGTGA
ATATCAGCC.CAGCTGGAG	ATATCAGCC.CAGCTGGAG
ATATCAGCC.CGAATGAGT	ATATCAGCC.CGAATGAGT
ATATCCGAT.AGTGAGAGA	ATATCCGAT.AGTGAGAGA
ATATCCGAT.CCATCACGA	ATATCCGAT.CCATCACGA
ATATCCGAT.CTAGAGTCG	ATATCCGAT.CTAGAGTCG
ATATCCGAT.GCGTTCAGA	ATATCCGAT.GCGTTCAGA
ATATCCGAT.TCGCTGTAA	ATATCCGAT.TCGCTGTAA
ATATCCGAT.TGATGACAG	ATATCCGAT.TGATGACAG
ATATGCAGC.AGTCGATCA	ATATGCAGC.AGTCGATCA
ATATGCAGC.CATAATTGG	ATATGCAGC.CATAATTGG
ATATGCAGC.CGCGCACAT	ATATGCAGC.CGCGCACAT
ATATGCAGC.GTAACAGTC	ATATGCAGC.GTAACAGTC
ATATGCAGC.GTGCTAAGC	ATATGCAGC.GTGCTAAGC
ATATGCAGC.TACTAGTAG	ATATGCAGC.TACTAGTAG
ATATGCAGC.TCGCCAAGC	ATATGCAGC.TCGCCAAGC
ATATGTCCA.ACTGGTCAG	ATATGTCCA.ACTGGTCAG
ATATGTCCA.ACTTCAGTA	ATATGTCCA.ACTTCAGTA
ATATGTCCA.AGAGGTGAA	ATATGTCCA.AGAGGTGAA
ATATGTCCA.ATAGAGCAG	ATATGTCCA.ATAGAGCAG
ATATGTCCA.ATGGAGAGT	ATATGTCCA.ATGGAGAGT
ATATGTCCA.ATTCATGTG	ATATGTCCA.ATTCATGTG
ATATGTCCA.GCACAACTC	ATATGTCCA.GCACAACTC
ATATGTCCA.TGAGCTAGA	ATATGTCCA.TGAGCTAGA
ATATTCGCA.CCGCTATCC	ATATTCGCA.CCGCTATCC
ATATTCGCA.CTCTAAGAG	ATATTCGCA.CTCTAAGAG
ATATTCGCA.CTGTAGAAG	ATATTCGCA.CTGTAGAAG
ATATTCGCA.GTGCATCAA	ATATTCGCA.GTGCATCAA
ATATTCGCA.TCTATTAGG	ATATTCGCA.TCTATTAGG
ATCAAGAGA.AGTGTCTCT	ATCAAGAGA.AGTGTCTCT
ATCAAGAGA.CAATGTGCT	ATCAAGAGA.CAATGTGCT
ATCAAGAGA.GCAACCAAC	ATCAAGAGA.GCAACCAAC
ATCAAGAGA.GCGCTAGAA	ATCAAGAGA.GCGCTAGAA
ATCAAGAGA.GCTGGTAAC	ATCAAGAGA.GCTGGTAAC
ATCAAGAGA.GGTAAGTGA	ATCAAGAGA.GGTAAGTGA
ATCAAGCAT.ACGCTCTTA	ATCAAGCAT.ACGCTCTTA
ATCAAGCAT.AGGAGGTGA	ATCAAGCAT.AGGAGGTGA
ATCAAGCAT.GATCTACTT	ATCAAGCAT.GATCTACTT
ATCAAGCAT.GCACTGGAT	ATCAAGCAT.GCACTGGAT
ATCAAGCAT.TGCTATGAA	ATCAAGCAT.TGCTATGAA
ATCACCGCA.ACTACCATC	ATCACCGCA.ACTACCATC
ATCACCGCA.AGATACGTT	ATCACCGCA.AGATACGTT
ATCACCGCA.AGCAAGTCC	ATCACCGCA.AGCAAGTCC
ATCACCGCA.GACGTCAAT	ATCACCGCA.GACGTCAAT
ATCACCGCA.GGTTCGCAA	ATCACCGCA.GGTTCGCAA
ATCACCGCA.TCGTGCCAC	ATCACCGCA.TCGTGCCAC
ATCACCGCA.TGAAGACCA	ATCACCGCA.TGAAGACCA
ATCACCGCA.TTAACGTTC	ATCACCGCA.TTAACGTTC
ATCACTTCC.CGCGTGAGA	ATCACTTCC.CGCGTGAGA
ATCAGAAGC.ACTGTAATC	ATCAGAAGC.ACTGTAATC
ATCAGAAGC.CCAGATCAC	ATCAGAAGC.CCAGATCAC
ATCAGAAGC.CCGGATTGC	ATCAGAAGC.CCGGATTGC
ATCAGAAGC.CCTAGAGTA	ATCAGAAGC.CCTAGAGTA
ATCAGAAGC.GTCGAGTAC	ATCAGAAGC.GTCGAGTAC
ATCAGAAGC.TAGATCTGT	ATCAGAAGC.TAGATCTGT
ATCAGAAGC.TCGCCAAGC	ATCAGAAGC.TCGCCAAGC
ATCAGGATG.AGGTACCAA	ATCAGGATG.AGGTACCAA
ATCAGGATG.CACCTCAAC	ATCAGGATG.CACCTCAAC
ATCAGGATG.CCACCATGC	ATCAGGATG.CCACCATGC
ATCAGGATG.GGTAAGTGA	ATCAGGATG.GGTAAGTGA
ATCAGGATG.GTAGTTGGT	ATCAGGATG.GTAGTTGGT
ATCAGGATG.GTCAACTGA	ATCAGGATG.GTCAACTGA
ATCAGGATG.TACCATGTA	ATCAGGATG.TACCATGTA
ATCAGGATG.TTCACCTTG	ATCAGGATG.TTCACCTTG
ATCAGGATG.TTGACCTGA	ATCAGGATG.TTGACCTGA
ATCAGTCGA.AACAACTGG	ATCAGTCGA.AACAACTGG
ATCAGTCGA.CGTATTCCT	ATCAGTCGA.CGTATTCCT
ATCAGTCGA.CTCGTCTTG	ATCAGTCGA.CTCGTCTTG
ATCAGTCGA.TATGCCTTC	ATCAGTCGA.TATGCCTTC
ATCAGTCGA.TGAAGACCA	ATCAGTCGA.TGAAGACCA
ATCAGTCGA.TGAGAGGAC	ATCAGTCGA.TGAGAGGAC
ATCAGTCGA.TGATGTGTG	ATCAGTCGA.TGATGTGTG
ATCATAGAC.AGATGAAGA	ATCATAGAC.AGATGAAGA
ATCATAGAC.GATACTGTG	ATCATAGAC.GATACTGTG
ATCATAGAC.GCGGACGAA	ATCATAGAC.GCGGACGAA
ATCATAGAC.TACAAGAGG	ATCATAGAC.TACAAGAGG
ATCATAGAC.TCTGTGAAG	ATCATAGAC.TCTGTGAAG
ATCATAGAC.TTATCCAAG	ATCATAGAC.TTATCCAAG
ATCATGTTC.AAGTCATGA	ATCATGTTC.AAGTCATGA
ATCATGTTC.ACTTCAGTA	ATCATGTTC.ACTTCAGTA
ATCATGTTC.ATAGACCGA	ATCATGTTC.ATAGACCGA
ATCATGTTC.CGTGCCTAT	ATCATGTTC.CGTGCCTAT
ATCATGTTC.GCGTCGTCT	ATCATGTTC.GCGTCGTCT
ATCATGTTC.GGTGATAGG	ATCATGTTC.GGTGATAGG
ATCATGTTC.TAATGTAGC	ATCATGTTC.TAATGTAGC
ATCATTACG.CACGTCATA	ATCATTACG.CACGTCATA
ATCATTACG.TCGTAATAG	ATCATTACG.TCGTAATAG
ATCCAATGA.CCATATGCC	ATCCAATGA.CCATATGCC
ATCCAATGA.CGATTGAAC	ATCCAATGA.CGATTGAAC
ATCCAATGA.GCGGACGAA	ATCCAATGA.GCGGACGAA
ATCCAATGA.GGAGATGAG	ATCCAATGA.GGAGATGAG
ATCCAATGA.GGTCCTGGT	ATCCAATGA.GGTCCTGGT
ATCCAATGA.TCTGCAACA	ATCCAATGA.TCTGCAACA
ATCCAATGA.TGTGCTAAC	ATCCAATGA.TGTGCTAAC
ATCCACAGT.AATTGGTGA	ATCCACAGT.AATTGGTGA
ATCCACAGT.AGTGGAATG	ATCCACAGT.AGTGGAATG
ATCCACAGT.ATCCTCCGA	ATCCACAGT.ATCCTCCGA
ATCCACAGT.CCACGTTCT	ATCCACAGT.CCACGTTCT
ATCCACAGT.CCGAGCTGA	ATCCACAGT.CCGAGCTGA
ATCCACAGT.CTTAGAAGG	ATCCACAGT.CTTAGAAGG
ATCCACAGT.GTTGCATGG	ATCCACAGT.GTTGCATGG
ATCCACAGT.TGAGTTAAG	ATCCACAGT.TGAGTTAAG
ATCCAGCTG.ACAAGGTAC	ATCCAGCTG.ACAAGGTAC
ATCCAGCTG.GAATTGTTG	ATCCAGCTG.GAATTGTTG
ATCCAGCTG.GCGCTAGAA	ATCCAGCTG.GCGCTAGAA
ATCCAGCTG.TTCCAATTC	ATCCAGCTG.TTCCAATTC
ATCCATTAG.CAAGGTGTG	ATCCATTAG.CAAGGTGTG
ATCCATTAG.TGAGAATCC	ATCCATTAG.TGAGAATCC
ATCCATTAG.TTCCTCGGT	ATCCATTAG.TTCCTCGGT
ATCCGACCA.AGCGACACC	ATCCGACCA.AGCGACACC
ATCCGACCA.ATCTGCGTA	ATCCGACCA.ATCTGCGTA
ATCCGACCA.CCGATGTTC	ATCCGACCA.CCGATGTTC
ATCCGACCA.TCGTGCCAC	ATCCGACCA.TCGTGCCAC
ATCCGACCA.TTGTATCAC	ATCCGACCA.TTGTATCAC
ATCCGGTCC.AACAGCAGT	ATCCGGTCC.AACAGCAGT
ATCCGGTCC.ACGTTCAAT	ATCCGGTCC.ACGTTCAAT
ATCCGGTCC.ATGCCTGTC	ATCCGGTCC.ATGCCTGTC
ATCCGGTCC.CCGATACCG	ATCCGGTCC.CCGATACCG
ATCCGGTCC.CCTTCCTCA	ATCCGGTCC.CCTTCCTCA
ATCCGGTCC.CGTGTATTC	ATCCGGTCC.CGTGTATTC
ATCCGGTCC.GAATAAGAG	ATCCGGTCC.GAATAAGAG
ATCCGGTCC.GATACACTA	ATCCGGTCC.GATACACTA
ATCCGGTCC.GATCCGCAC	ATCCGGTCC.GATCCGCAC
ATCCGGTCC.GTAGACTCT	ATCCGGTCC.GTAGACTCT
ATCCGGTCC.GTCGTTAGA	ATCCGGTCC.GTCGTTAGA
ATCCGGTCC.TAGACCATG	ATCCGGTCC.TAGACCATG
ATCCGGTCC.TCGTCATTC	ATCCGGTCC.TCGTCATTC
ATCCGGTCC.TTACCTCTC	ATCCGGTCC.TTACCTCTC
ATCCGTCTC.ACTGGTCAG	ATCCGTCTC.ACTGGTCAG
ATCCGTCTC.CACCTAGCG	ATCCGTCTC.CACCTAGCG
ATCCGTCTC.CTAACTAAG	ATCCGTCTC.CTAACTAAG
ATCCGTCTC.GTGTCCGTG	ATCCGTCTC.GTGTCCGTG
ATCCGTCTC.TAACGTGTC	ATCCGTCTC.TAACGTGTC
ATCCGTCTC.TGGAAGATT	ATCCGTCTC.TGGAAGATT
ATCCGTCTC.TGTGTCTAC	ATCCGTCTC.TGTGTCTAC
ATCCTCCGA.AACGATGAC	ATCCTCCGA.AACGATGAC
ATCCTCCGA.CTCTACGCA	ATCCTCCGA.CTCTACGCA
ATCCTCCGA.CTTCGTGCA	ATCCTCCGA.CTTCGTGCA
ATCCTCCGA.GGTTCGCAA	ATCCTCCGA.GGTTCGCAA
ATCCTCCGA.TCACTCGCT	ATCCTCCGA.TCACTCGCT
ATCCTCCGA.TCGATTCAG	ATCCTCCGA.TCGATTCAG
ATCCTGCCT.AATATCAGC	ATCCTGCCT.AATATCAGC
ATCCTGCCT.AGGTCCGTC	ATCCTGCCT.AGGTCCGTC
ATCCTGCCT.CCTGCAGAT	ATCCTGCCT.CCTGCAGAT
ATCCTGCCT.GTGTTCCAG	ATCCTGCCT.GTGTTCCAG
ATCCTGCCT.TAAGTACAC	ATCCTGCCT.TAAGTACAC
ATCCTGCCT.TAGATAGCC	ATCCTGCCT.TAGATAGCC
ATCCTGCCT.TAGTCAGAC	ATCCTGCCT.TAGTCAGAC
ATCCTGCCT.TCAGGTGCA	ATCCTGCCT.TCAGGTGCA
ATCCTGCCT.TGCCGCTAC	ATCCTGCCT.TGCCGCTAC
ATCGAATCG.AAGGATACG	ATCGAATCG.AAGGATACG
ATCGAATCG.AGAAGTAAC	ATCGAATCG.AGAAGTAAC
ATCGAATCG.CGTCGTCAA	ATCGAATCG.CGTCGTCAA
ATCGAATCG.GTACGAACG	ATCGAATCG.GTACGAACG
ATCGAATCG.TCCTTCAAC	ATCGAATCG.TCCTTCAAC
ATCGAATCG.TGAGAGGAC	ATCGAATCG.TGAGAGGAC
ATCGATCCT.AGTCGTCCG	ATCGATCCT.AGTCGTCCG
ATCGATCCT.CCAGTACTC	ATCGATCCT.CCAGTACTC
ATCGATCCT.CTCGTTCAC	ATCGATCCT.CTCGTTCAC
ATCGCCTCT.GTTCACTCC	ATCGCCTCT.GTTCACTCC
ATCGCCTCT.GTTGCTCAG	ATCGCCTCT.GTTGCTCAG
ATCGGTGGT.ATCAGAAGC	ATCGGTGGT.ATCAGAAGC
ATCGGTGGT.CTCTAGTAA	ATCGGTGGT.CTCTAGTAA
ATCGGTGGT.GGATCGTTC	ATCGGTGGT.GGATCGTTC
ATCGGTGGT.GTGGTTACC	ATCGGTGGT.GTGGTTACC
ATCGTAGTG.ACTGGACCA	ATCGTAGTG.ACTGGACCA
ATCGTAGTG.AGCCAGGAC	ATCGTAGTG.AGCCAGGAC
ATCGTAGTG.ATCTCGTGA	ATCGTAGTG.ATCTCGTGA
ATCGTAGTG.CAGTCCTAA	ATCGTAGTG.CAGTCCTAA
ATCGTAGTG.CGTGTCCGA	ATCGTAGTG.CGTGTCCGA
ATCGTAGTG.GATCTGAAT	ATCGTAGTG.GATCTGAAT
ATCGTAGTG.TTACAGTGT	ATCGTAGTG.TTACAGTGT
ATCTACATC.CAATCATAC	ATCTACATC.CAATCATAC
ATCTACATC.CATGACGTT	ATCTACATC.CATGACGTT
ATCTACATC.CATTCAGTT	ATCTACATC.CATTCAGTT
ATCTACATC.GAGCAGGAA	ATCTACATC.GAGCAGGAA
ATCTACATC.GCCATCGCT	ATCTACATC.GCCATCGCT
ATCTACATC.GCCGCCTAA	ATCTACATC.GCCGCCTAA
ATCTACATC.TACCTATCC	ATCTACATC.TACCTATCC
ATCTAGGTT.ATAAGTTCG	ATCTAGGTT.ATAAGTTCG
ATCTAGGTT.CATAATTGG	ATCTAGGTT.CATAATTGG
ATCTAGGTT.GACCGCTTC	ATCTAGGTT.GACCGCTTC
ATCTAGGTT.GATTAGTGT	ATCTAGGTT.GATTAGTGT
ATCTAGGTT.GCCACGAGT	ATCTAGGTT.GCCACGAGT
ATCTCGAAC.CACTACAGG	ATCTCGAAC.CACTACAGG
ATCTCGAAC.CCAAGTCGA	ATCTCGAAC.CCAAGTCGA
ATCTCGAAC.CGTGAGACT	ATCTCGAAC.CGTGAGACT
ATCTCGTGA.CATAGGTGT	ATCTCGTGA.CATAGGTGT
ATCTCGTGA.CCATAAGTA	ATCTCGTGA.CCATAAGTA
ATCTCGTGA.TAAGGTCCG	ATCTCGTGA.TAAGGTCCG
ATCTCGTGA.TGTAGATCG	ATCTCGTGA.TGTAGATCG
ATCTCGTGA.TTGCGAACA	ATCTCGTGA.TTGCGAACA
ATCTCTGCT.AAGCAGCAT	ATCTCTGCT.AAGCAGCAT
ATCTCTGCT.CCGATCTCT	ATCTCTGCT.CCGATCTCT
ATCTCTGCT.CTGAGTAGC	ATCTCTGCT.CTGAGTAGC
ATCTCTGCT.GTCGTGTTA	ATCTCTGCT.GTCGTGTTA
ATCTCTGCT.GTTGATGCA	ATCTCTGCT.GTTGATGCA
ATCTCTGCT.TAGCCAGTG	ATCTCTGCT.TAGCCAGTG
ATCTGCGTA.AATCAGGAG	ATCTGCGTA.AATCAGGAG
ATCTGCGTA.ACTGACTAC	ATCTGCGTA.ACTGACTAC
ATCTGCGTA.ACTTCTTGG	ATCTGCGTA.ACTTCTTGG
ATCTGCGTA.AGAGCGGAG	ATCTGCGTA.AGAGCGGAG
ATCTGCGTA.AGCTCGTCT	ATCTGCGTA.AGCTCGTCT
ATCTGCGTA.GCAGCTCTT	ATCTGCGTA.GCAGCTCTT
ATCTGCGTA.GCTTCTACG	ATCTGCGTA.GCTTCTACG
ATCTGCGTA.TCTAATACC	ATCTGCGTA.TCTAATACC
ATCTGCGTA.TCTGTGAAG	ATCTGCGTA.TCTGTGAAG
ATCTGCGTA.TGGTGGATC	ATCTGCGTA.TGGTGGATC
ATCTGCGTA.TGTAGCAAG	ATCTGCGTA.TGTAGCAAG
ATCTGGTAG.ACTTAGCTT	ATCTGGTAG.ACTTAGCTT
ATCTGGTAG.AGTGTCTCT	ATCTGGTAG.AGTGTCTCT
ATCTGGTAG.ATAAGTTCG	ATCTGGTAG.ATAAGTTCG
ATCTGGTAG.CGACCACTT	ATCTGGTAG.CGACCACTT
ATCTGGTAG.CGATACTCT	ATCTGGTAG.CGATACTCT
ATCTGGTAG.CTTGCGACC	ATCTGGTAG.CTTGCGACC
ATCTTACAG.GAGCCATCC	ATCTTACAG.GAGCCATCC
ATCTTACAG.GAGTCTTCG	ATCTTACAG.GAGTCTTCG
ATCTTACAG.TGCGTGCCA	ATCTTACAG.TGCGTGCCA
ATGAACTAG.ACAGAGATG	ATGAACTAG.ACAGAGATG
ATGAACTAG.ACAGTATTG	ATGAACTAG.ACAGTATTG
ATGAACTAG.CCATCACGA	ATGAACTAG.CCATCACGA
ATGAACTAG.TGAAGACCA	ATGAACTAG.TGAAGACCA
ATGAACTAG.TGTCTACAC	ATGAACTAG.TGTCTACAC
ATGAACTAG.TTCATTCGC	ATGAACTAG.TTCATTCGC
ATGACACAA.ACACAGAAC	ATGACACAA.ACACAGAAC
ATGACACAA.CCATGCGTC	ATGACACAA.CCATGCGTC
ATGACACAA.GTATCCTGC	ATGACACAA.GTATCCTGC
ATGACACAA.GTGAATGCC	ATGACACAA.GTGAATGCC
ATGACACAA.TCAATCTAG	ATGACACAA.TCAATCTAG
ATGAGATCC.AACGATGAC	ATGAGATCC.AACGATGAC
ATGAGATCC.CTGATGCAC	ATGAGATCC.CTGATGCAC
ATGAGCAGG.ACAACGAGC	ATGAGCAGG.ACAACGAGC
ATGAGCAGG.ACATCGTCC	ATGAGCAGG.ACATCGTCC
ATGAGCAGG.ACGACTGCG	ATGAGCAGG.ACGACTGCG
ATGAGCAGG.AGATGAGAT	ATGAGCAGG.AGATGAGAT
ATGAGCAGG.AGTAATCAG	ATGAGCAGG.AGTAATCAG
ATGAGCAGG.TCTGCAACA	ATGAGCAGG.TCTGCAACA
ATGAGCAGG.TGGACGAGA	ATGAGCAGG.TGGACGAGA
ATGAGGTAT.AAGACTACC	ATGAGGTAT.AAGACTACC
ATGAGGTAT.AGCATTGTT	ATGAGGTAT.AGCATTGTT
ATGAGGTAT.ATATAGCGT	ATGAGGTAT.ATATAGCGT
ATGAGGTAT.CACAATAAC	ATGAGGTAT.CACAATAAC
ATGAGGTAT.CGTGACCAG	ATGAGGTAT.CGTGACCAG
ATGAGGTAT.GTTACTACT	ATGAGGTAT.GTTACTACT
ATGAGTGTG.ACCATACTT	ATGAGTGTG.ACCATACTT
ATGAGTGTG.AGCAAGTCC	ATGAGTGTG.AGCAAGTCC
ATGAGTGTG.GAGCCGTTA	ATGAGTGTG.GAGCCGTTA
ATGAGTGTG.GTACTCTAC	ATGAGTGTG.GTACTCTAC
ATGAGTGTG.GTTAGATTG	ATGAGTGTG.GTTAGATTG
ATGAGTGTG.TCCAGCAGC	ATGAGTGTG.TCCAGCAGC
ATGAGTGTG.TCTAATACC	ATGAGTGTG.TCTAATACC
ATGATAGCT.ATGCCTTCA	ATGATAGCT.ATGCCTTCA
ATGATAGCT.CCTATTCAA	ATGATAGCT.CCTATTCAA
ATGATAGCT.GAGCAGGAA	ATGATAGCT.GAGCAGGAA
ATGATAGCT.GCACTGGAT	ATGATAGCT.GCACTGGAT
ATGCAGTTC.GACCTTGTG	ATGCAGTTC.GACCTTGTG
ATGCAGTTC.GACGTCAAT	ATGCAGTTC.GACGTCAAT
ATGCAGTTC.GCCGAACCA	ATGCAGTTC.GCCGAACCA
ATGCAGTTC.GTTCAGAAG	ATGCAGTTC.GTTCAGAAG
ATGCAGTTC.TGTCACATA	ATGCAGTTC.TGTCACATA
ATGCAGTTC.TTCATTCGC	ATGCAGTTC.TTCATTCGC
ATGCCTGTC.ATCCAATGA	ATGCCTGTC.ATCCAATGA
ATGCCTGTC.CAGTCTAAC	ATGCCTGTC.CAGTCTAAC
ATGCCTGTC.CTATAGCTC	ATGCCTGTC.CTATAGCTC
ATGCCTGTC.CTCCGCATT	ATGCCTGTC.CTCCGCATT
ATGCCTGTC.TACTCGACC	ATGCCTGTC.TACTCGACC
ATGCCTGTC.TTACGCTCG	ATGCCTGTC.TTACGCTCG
ATGCCTTCA.AACAACCTA	ATGCCTTCA.AACAACCTA
ATGCCTTCA.AGGAGGTGA	ATGCCTTCA.AGGAGGTGA
ATGCCTTCA.CGATCCAGA	ATGCCTTCA.CGATCCAGA
ATGCCTTCA.CTGGAGCGA	ATGCCTTCA.CTGGAGCGA
ATGCCTTCA.GTACCTAAC	ATGCCTTCA.GTACCTAAC
ATGCCTTCA.GTCCACAAC	ATGCCTTCA.GTCCACAAC
ATGCCTTCA.TACCTATCC	ATGCCTTCA.TACCTATCC
ATGCCTTCA.TGTCAACCT	ATGCCTTCA.TGTCAACCT
ATGCGCCGT.AGCCGGATC	ATGCGCCGT.AGCCGGATC
ATGCGCCGT.ATCAGGATG	ATGCGCCGT.ATCAGGATG
ATGCGCCGT.ATGGAGGAA	ATGCGCCGT.ATGGAGGAA
ATGCGCCGT.GAAGTGTGA	ATGCGCCGT.GAAGTGTGA
ATGCGCTAC.AGATCTGAC	ATGCGCTAC.AGATCTGAC
ATGCGCTAC.AGTTGAGCG	ATGCGCTAC.AGTTGAGCG
ATGCGCTAC.ATTCGAAGA	ATGCGCTAC.ATTCGAAGA
ATGCGCTAC.GATAGTTCT	ATGCGCTAC.GATAGTTCT
ATGCGCTAC.GTACGCGAT	ATGCGCTAC.GTACGCGAT
ATGCGCTAC.TCTCGTATC	ATGCGCTAC.TCTCGTATC
ATGCGCTAC.TGACAAGTT	ATGCGCTAC.TGACAAGTT
ATGCGGATT.ACATTCCAC	ATGCGGATT.ACATTCCAC
