CTCGCTACG.ATAGCACGG	CTCGCTACG.ATAGCACGG
CTCGCTACG.GTGCGAGTA	CTCGCTACG.GTGCGAGTA
CTCGCTACG.TTGCCGTAG	CTCGCTACG.TTGCCGTAG
CTCGTCTTG.AACCGTGAG	CTCGTCTTG.AACCGTGAG
CTCGTCTTG.ACACCACAT	CTCGTCTTG.ACACCACAT
CTCGTCTTG.ACGACAGTC	CTCGTCTTG.ACGACAGTC
CTCGTCTTG.ACTCTCACA	CTCGTCTTG.ACTCTCACA
CTCGTCTTG.CAAGTACGA	CTCGTCTTG.CAAGTACGA
CTCGTCTTG.CTGGTAATC	CTCGTCTTG.CTGGTAATC
CTCGTCTTG.CTTCGTGCA	CTCGTCTTG.CTTCGTGCA
CTCGTCTTG.TACAACACC	CTCGTCTTG.TACAACACC
CTCGTCTTG.TAGCCTTGT	CTCGTCTTG.TAGCCTTGT
CTCGTCTTG.TCGCCAAGC	CTCGTCTTG.TCGCCAAGC
CTCGTGTCC.AAGTCATGA	CTCGTGTCC.AAGTCATGA
CTCGTGTCC.ACAGGAACT	CTCGTGTCC.ACAGGAACT
CTCGTGTCC.CCGGTTCTA	CTCGTGTCC.CCGGTTCTA
CTCGTGTCC.CCTTATCCG	CTCGTGTCC.CCTTATCCG
CTCGTGTCC.CTGACGGAT	CTCGTGTCC.CTGACGGAT
CTCGTGTCC.TAGTCGCAT	CTCGTGTCC.TAGTCGCAT
CTCGTGTCC.TCAGCTCAG	CTCGTGTCC.TCAGCTCAG
CTCGTGTCC.TGAAGACCA	CTCGTGTCC.TGAAGACCA
CTCGTTCAC.TGACCAAGT	CTCGTTCAC.TGACCAAGT
CTCTAAGAG.ATGAGTGTG	CTCTAAGAG.ATGAGTGTG
CTCTAAGAG.ATGGATATC	CTCTAAGAG.ATGGATATC
CTCTAAGAG.CTAGTTCCA	CTCTAAGAG.CTAGTTCCA
CTCTAAGAG.GATTATGCG	CTCTAAGAG.GATTATGCG
CTCTAAGAG.GGACTCCTT	CTCTAAGAG.GGACTCCTT
CTCTAAGAG.GTCAATACA	CTCTAAGAG.GTCAATACA
CTCTAAGAG.TAGACCGCA	CTCTAAGAG.TAGACCGCA
CTCTAAGAG.TATCACCTG	CTCTAAGAG.TATCACCTG
CTCTAAGAG.TCAGAGCGT	CTCTAAGAG.TCAGAGCGT
CTCTAAGAG.TTCTCCACA	CTCTAAGAG.TTCTCCACA
CTCTACGCA.CATTCAGTT	CTCTACGCA.CATTCAGTT
CTCTACGCA.CGATTGAAC	CTCTACGCA.CGATTGAAC
CTCTACGCA.GTCTGAGCC	CTCTACGCA.GTCTGAGCC
CTCTACGCA.GTGGTTACC	CTCTACGCA.GTGGTTACC
CTCTACGCA.TCACTCGCT	CTCTACGCA.TCACTCGCT
CTCTACGCA.TGTCACATA	CTCTACGCA.TGTCACATA
CTCTACGCA.TTCAACTAC	CTCTACGCA.TTCAACTAC
CTCTAGTAA.AGCACCGTG	CTCTAGTAA.AGCACCGTG
CTCTAGTAA.GGTCTTGCA	CTCTAGTAA.GGTCTTGCA
CTCTAGTAA.TCGTGACGT	CTCTAGTAA.TCGTGACGT
CTCTAGTAA.TCTATGACA	CTCTAGTAA.TCTATGACA
CTCTAGTAA.TGTCTACAC	CTCTAGTAA.TGTCTACAC
CTCTCAGTC.AACGGTAGC	CTCTCAGTC.AACGGTAGC
CTCTCAGTC.AGATACGTT	CTCTCAGTC.AGATACGTT
CTCTCAGTC.TCAGTGTTC	CTCTCAGTC.TCAGTGTTC
CTCTCAGTC.TGCGCACTG	CTCTCAGTC.TGCGCACTG
CTCTCGATA.AAGAGAACT	CTCTCGATA.AAGAGAACT
CTCTCGATA.CCTGCTCCA	CTCTCGATA.CCTGCTCCA
CTCTCGATA.GACGTCAAT	CTCTCGATA.GACGTCAAT
CTCTGCAAG.CCAACGGAA	CTCTGCAAG.CCAACGGAA
CTCTGCAAG.GATCGCGAA	CTCTGCAAG.GATCGCGAA
CTCTGCAAG.TGCACGATG	CTCTGCAAG.TGCACGATG
CTCTGCGGT.ACTAAGTTC	CTCTGCGGT.ACTAAGTTC
CTCTGCGGT.AGACATCCA	CTCTGCGGT.AGACATCCA
CTCTGCGGT.AGTGAGAGA	CTCTGCGGT.AGTGAGAGA
CTCTGCGGT.AGTTACAAG	CTCTGCGGT.AGTTACAAG
CTCTGCGGT.CAGTGCTGC	CTCTGCGGT.CAGTGCTGC
CTCTGCGGT.GTGTACCGT	CTCTGCGGT.GTGTACCGT
CTCTGCGGT.TCAGAGCGT	CTCTGCGGT.TCAGAGCGT
CTCTGTCAA.GAGACATTG	CTCTGTCAA.GAGACATTG
CTCTGTCAA.GTCAGCGTC	CTCTGTCAA.GTCAGCGTC
CTCTGTCAA.TCTCGATGC	CTCTGTCAA.TCTCGATGC
CTCTGTCAA.TTATGAGGA	CTCTGTCAA.TTATGAGGA
CTCTTCAGC.AAGGATACG	CTCTTCAGC.AAGGATACG
CTCTTCAGC.AGTCATACT	CTCTTCAGC.AGTCATACT
CTCTTCAGC.ATGGTTCGA	CTCTTCAGC.ATGGTTCGA
CTCTTCAGC.CAGCTGGAG	CTCTTCAGC.CAGCTGGAG
CTCTTCAGC.TAGCAGAGT	CTCTTCAGC.TAGCAGAGT
CTCTTCAGC.TCTCGTATC	CTCTTCAGC.TCTCGTATC
CTGACAGCA.ACAGCGTAT	CTGACAGCA.ACAGCGTAT
CTGACAGCA.AGTCGCCGA	CTGACAGCA.AGTCGCCGA
CTGACAGCA.CATTCGAAT	CTGACAGCA.CATTCGAAT
CTGACAGCA.CCGACTTGG	CTGACAGCA.CCGACTTGG
CTGACAGCA.CCTGTTAGC	CTGACAGCA.CCTGTTAGC
CTGACAGCA.CTAGAGGTA	CTGACAGCA.CTAGAGGTA
CTGACAGCA.GCTTGGTTC	CTGACAGCA.GCTTGGTTC
CTGACAGCA.GTAGAAGTT	CTGACAGCA.GTAGAAGTT
CTGACAGCA.GTATGATCT	CTGACAGCA.GTATGATCT
CTGACAGCA.TAGCACACG	CTGACAGCA.TAGCACACG
CTGACGATG.CTGTACGAC	CTGACGATG.CTGTACGAC
CTGACGATG.GTGGATAAG	CTGACGATG.GTGGATAAG
CTGACGATG.TGGATAGGT	CTGACGATG.TGGATAGGT
CTGACGATG.TGTAGCAAG	CTGACGATG.TGTAGCAAG
CTGACGGAT.ACATTCCAC	CTGACGGAT.ACATTCCAC
CTGACGGAT.GATCTTCGC	CTGACGGAT.GATCTTCGC
CTGACGGAT.GGTAACTAC	CTGACGGAT.GGTAACTAC
CTGACGGAT.TAGTGATCC	CTGACGGAT.TAGTGATCC
CTGACGGAT.TGGAAGATT	CTGACGGAT.TGGAAGATT
CTGAGATAG.AAGTTCTCT	CTGAGATAG.AAGTTCTCT
CTGAGATAG.ACACCACAT	CTGAGATAG.ACACCACAT
CTGAGATAG.AGAGGACGT	CTGAGATAG.AGAGGACGT
CTGAGATAG.AGGATTACT	CTGAGATAG.AGGATTACT
CTGAGATAG.CGACGTGAT	CTGAGATAG.CGACGTGAT
CTGAGATAG.CTCTGCGGT	CTGAGATAG.CTCTGCGGT
CTGAGATAG.TGAGGTCTC	CTGAGATAG.TGAGGTCTC
CTGAGGTTA.AAGCTGAGG	CTGAGGTTA.AAGCTGAGG
CTGAGGTTA.ACTGGACCA	CTGAGGTTA.ACTGGACCA
CTGAGGTTA.GCCGCCTAA	CTGAGGTTA.GCCGCCTAA
CTGAGGTTA.GTAGTGGAG	CTGAGGTTA.GTAGTGGAG
CTGAGGTTA.GTTCACTCC	CTGAGGTTA.GTTCACTCC
CTGAGTAGC.ACTACCATC	CTGAGTAGC.ACTACCATC
CTGAGTAGC.ACTCGAGTC	CTGAGTAGC.ACTCGAGTC
CTGAGTAGC.AGTCGCGAC	CTGAGTAGC.AGTCGCGAC
CTGAGTAGC.TCATGCTCA	CTGAGTAGC.TCATGCTCA
CTGAGTAGC.TCCGGAGCT	CTGAGTAGC.TCCGGAGCT
CTGAGTAGC.TCGTACCTT	CTGAGTAGC.TCGTACCTT
CTGAGTAGC.TTGATGCTG	CTGAGTAGC.TTGATGCTG
CTGAGTCCA.AAGCTTGCA	CTGAGTCCA.AAGCTTGCA
CTGAGTCCA.AGGAGGTGA	CTGAGTCCA.AGGAGGTGA
CTGAGTCCA.ATAGACCGA	CTGAGTCCA.ATAGACCGA
CTGAGTCCA.ATATAGCGT	CTGAGTCCA.ATATAGCGT
CTGAGTCCA.CCTCGCGTT	CTGAGTCCA.CCTCGCGTT
CTGAGTCCA.CGCACTGAA	CTGAGTCCA.CGCACTGAA
CTGAGTCCA.GCGCATTAC	CTGAGTCCA.GCGCATTAC
CTGAGTCCA.TGCAGTCGG	CTGAGTCCA.TGCAGTCGG
CTGAGTCCA.TGCGCACTG	CTGAGTCCA.TGCGCACTG
CTGATCAAG.ACCACGCTA	CTGATCAAG.ACCACGCTA
CTGATCAAG.ACCGTCCTA	CTGATCAAG.ACCGTCCTA
CTGATCAAG.ACGAATCGC	CTGATCAAG.ACGAATCGC
CTGATCAAG.CGCGATGTA	CTGATCAAG.CGCGATGTA
CTGATCAAG.GCACGCATT	CTGATCAAG.GCACGCATT
CTGATCAAG.GCAGGAGAA	CTGATCAAG.GCAGGAGAA
CTGATCAAG.GCTTCTACG	CTGATCAAG.GCTTCTACG
CTGATCAAG.TGAGTGACT	CTGATCAAG.TGAGTGACT
CTGATCCGA.CTGAGTCCA	CTGATCCGA.CTGAGTCCA
CTGATCCGA.GACGGTGCT	CTGATCCGA.GACGGTGCT
CTGATCCGA.GCCAATGAA	CTGATCCGA.GCCAATGAA
CTGATCCGA.GTACTCTAC	CTGATCCGA.GTACTCTAC
CTGATCCGA.GTTGCATGG	CTGATCCGA.GTTGCATGG
CTGATCCGA.TCATGCTCA	CTGATCCGA.TCATGCTCA
CTGATCCGA.TTACTAGTC	CTGATCCGA.TTACTAGTC
CTGATCCGA.TTCCTTGAC	CTGATCCGA.TTCCTTGAC
CTGATGCAC.AACAACTGG	CTGATGCAC.AACAACTGG
CTGATGCAC.ACAGGAACT	CTGATGCAC.ACAGGAACT
CTGATGCAC.AGGAAGGTG	CTGATGCAC.AGGAAGGTG
CTGATGCAC.AGTGATGCG	CTGATGCAC.AGTGATGCG
CTGATGCAC.CAATCATAC	CTGATGCAC.CAATCATAC
CTGATGCAC.CATTGTTCA	CTGATGCAC.CATTGTTCA
CTGATGCAC.CGGTTCTAT	CTGATGCAC.CGGTTCTAT
CTGATGCAC.CTACGGTAT	CTGATGCAC.CTACGGTAT
CTGATGCAC.GATCGATAC	CTGATGCAC.GATCGATAC
CTGATGCAC.GGTCTCATG	CTGATGCAC.GGTCTCATG
CTGATGCAC.TCCACCGGT	CTGATGCAC.TCCACCGGT
CTGCAAGCC.AGATGTTGG	CTGCAAGCC.AGATGTTGG
CTGCAGAGC.ACCGGTTAC	CTGCAGAGC.ACCGGTTAC
CTGCAGAGC.ATAGCACGG	CTGCAGAGC.ATAGCACGG
CTGCAGAGC.CAGCTTCGA	CTGCAGAGC.CAGCTTCGA
CTGCAGAGC.CAGTATGAT	CTGCAGAGC.CAGTATGAT
CTGCAGAGC.CCAAGTCGA	CTGCAGAGC.CCAAGTCGA
CTGCAGAGC.GCCGAGTCT	CTGCAGAGC.GCCGAGTCT
CTGCAGAGC.GGAAGGTAT	CTGCAGAGC.GGAAGGTAT
CTGCATGTT.AAGCTGGTC	CTGCATGTT.AAGCTGGTC
CTGCATGTT.CTAGTATAG	CTGCATGTT.CTAGTATAG
CTGCATGTT.GTCGTTAGA	CTGCATGTT.GTCGTTAGA
CTGCATGTT.TACTTCCAG	CTGCATGTT.TACTTCCAG
CTGCATGTT.TTGATGAGT	CTGCATGTT.TTGATGAGT
CTGCGATTC.AACGATGAC	CTGCGATTC.AACGATGAC
CTGCGATTC.ATAACGACA	CTGCGATTC.ATAACGACA
CTGCGATTC.CAGCTGGAG	CTGCGATTC.CAGCTGGAG
CTGCGATTC.CGTGTCCGA	CTGCGATTC.CGTGTCCGA
CTGCGATTC.CTCGTGTCC	CTGCGATTC.CTCGTGTCC
CTGCGATTC.GTCAGCGTC	CTGCGATTC.GTCAGCGTC
CTGCGATTC.TCATCATCT	CTGCGATTC.TCATCATCT
CTGCGATTC.TCCACCTCA	CTGCGATTC.TCCACCTCA
CTGCGTCAC.AGGATGCGT	CTGCGTCAC.AGGATGCGT
CTGCGTCAC.ATAAGTTCG	CTGCGTCAC.ATAAGTTCG
CTGCGTCAC.CCATATCTT	CTGCGTCAC.CCATATCTT
CTGCGTCAC.GACTGCCTG	CTGCGTCAC.GACTGCCTG
CTGCGTCAC.GCACAACTC	CTGCGTCAC.GCACAACTC
CTGCGTCAC.GGAACTGCT	CTGCGTCAC.GGAACTGCT
CTGCGTCAC.TAGGTCAAC	CTGCGTCAC.TAGGTCAAC
CTGCGTCAC.TATACCACT	CTGCGTCAC.TATACCACT
CTGCGTCAC.TGCGATACT	CTGCGTCAC.TGCGATACT
CTGCTGCTT.ACCTTGAAG	CTGCTGCTT.ACCTTGAAG
CTGCTGCTT.CACGATAGA	CTGCTGCTT.CACGATAGA
CTGCTGCTT.CTCTACGCA	CTGCTGCTT.CTCTACGCA
CTGCTGCTT.GCACATGTT	CTGCTGCTT.GCACATGTT
CTGCTGCTT.GCAGCGATA	CTGCTGCTT.GCAGCGATA
CTGCTGCTT.TACCTCACT	CTGCTGCTT.TACCTCACT
CTGCTTAGG.ACGACAGTC	CTGCTTAGG.ACGACAGTC
CTGCTTAGG.ACGACATCT	CTGCTTAGG.ACGACATCT
CTGCTTAGG.CAACCGGTC	CTGCTTAGG.CAACCGGTC
CTGCTTAGG.CACGACTCA	CTGCTTAGG.CACGACTCA
CTGCTTAGG.CTCGTTCAC	CTGCTTAGG.CTCGTTCAC
CTGCTTAGG.GGAGAATGA	CTGCTTAGG.GGAGAATGA
CTGCTTAGG.TACTTCCAG	CTGCTTAGG.TACTTCCAG
CTGCTTAGG.TCAGACAAG	CTGCTTAGG.TCAGACAAG
CTGCTTAGG.TCCATCATT	CTGCTTAGG.TCCATCATT
CTGCTTAGG.TTATCCAAG	CTGCTTAGG.TTATCCAAG
CTGGACACT.AGTGTTCTG	CTGGACACT.AGTGTTCTG
CTGGACACT.CTGCATGTT	CTGGACACT.CTGCATGTT
CTGGACACT.GTAGAAGTT	CTGGACACT.GTAGAAGTT
CTGGACACT.GTATTACTG	CTGGACACT.GTATTACTG
CTGGACACT.TAGTCGCAT	CTGGACACT.TAGTCGCAT
CTGGACACT.TGACCAAGT	CTGGACACT.TGACCAAGT
CTGGACTAA.AGTCGATCA	CTGGACTAA.AGTCGATCA
CTGGACTAA.GTAAGTGAG	CTGGACTAA.GTAAGTGAG
CTGGACTAA.TATCACCTG	CTGGACTAA.TATCACCTG
CTGGACTAA.TTCTGGTGC	CTGGACTAA.TTCTGGTGC
CTGGAGCGA.GCGTATAGG	CTGGAGCGA.GCGTATAGG
CTGGTAATC.CTTATTGAG	CTGGTAATC.CTTATTGAG
CTGGTAATC.TAGCGCAGC	CTGGTAATC.TAGCGCAGC
CTGGTAATC.TCCAGCAGC	CTGGTAATC.TCCAGCAGC
CTGGTAATC.TCGCAAGCA	CTGGTAATC.TCGCAAGCA
CTGGTAATC.TGATCGGAA	CTGGTAATC.TGATCGGAA
CTGGTAATC.TGCTCACAC	CTGGTAATC.TGCTCACAC
CTGGTACAT.ATACCGCTT	CTGGTACAT.ATACCGCTT
CTGGTACAT.ATGCGCCGT	CTGGTACAT.ATGCGCCGT
CTGGTACAT.GCTTACTAG	CTGGTACAT.GCTTACTAG
CTGGTACAT.GGTTCAGAC	CTGGTACAT.GGTTCAGAC
CTGGTACAT.TGCTGCGTC	CTGGTACAT.TGCTGCGTC
CTGGTACAT.TGGTTATAC	CTGGTACAT.TGGTTATAC
CTGGTCGGT.CACATTCTG	CTGGTCGGT.CACATTCTG
CTGGTCGGT.CCGATCAGC	CTGGTCGGT.CCGATCAGC
CTGGTCGGT.CCTATTGGT	CTGGTCGGT.CCTATTGGT
CTGGTCGGT.TTGTCAACC	CTGGTCGGT.TTGTCAACC
CTGGTGACA.AATGCTATC	CTGGTGACA.AATGCTATC
CTGGTGACA.CATCCACCG	CTGGTGACA.CATCCACCG
CTGGTGACA.CCGACTGTT	CTGGTGACA.CCGACTGTT
CTGGTGACA.CGCAGTGTC	CTGGTGACA.CGCAGTGTC
CTGGTGACA.GTAACGCGA	CTGGTGACA.GTAACGCGA
CTGTACGAC.ATGCCTGTC	CTGTACGAC.ATGCCTGTC
CTGTACGAC.CATAAGATC	CTGTACGAC.CATAAGATC
CTGTACGAC.GACTTGATT	CTGTACGAC.GACTTGATT
CTGTAGAAG.CACATGTGC	CTGTAGAAG.CACATGTGC
CTGTAGAAG.CATGGTTAC	CTGTAGAAG.CATGGTTAC
CTGTAGAAG.GATGTCTAG	CTGTAGAAG.GATGTCTAG
CTGTAGAAG.TGCGATACT	CTGTAGAAG.TGCGATACT
CTGTCACTT.GGAATTCAC	CTGTCACTT.GGAATTCAC
CTGTCACTT.GTGCATCAA	CTGTCACTT.GTGCATCAA
CTGTCTAGT.CACTGCTTA	CTGTCTAGT.CACTGCTTA
CTGTCTAGT.CACTGTATC	CTGTCTAGT.CACTGTATC
CTGTCTAGT.CCTATTGGT	CTGTCTAGT.CCTATTGGT
CTGTCTAGT.GAGTCAAGG	CTGTCTAGT.GAGTCAAGG
CTGTCTAGT.TCAAGGAGT	CTGTCTAGT.TCAAGGAGT
CTGTGCTCA.AACTGATTC	CTGTGCTCA.AACTGATTC
CTGTGCTCA.CGTTCGTAC	CTGTGCTCA.CGTTCGTAC
CTGTGCTCA.GCTTAGAAC	CTGTGCTCA.GCTTAGAAC
CTGTGCTCA.TAGTCGCAT	CTGTGCTCA.TAGTCGCAT
CTGTGCTCA.TCGCAAGCA	CTGTGCTCA.TCGCAAGCA
CTGTGGTGG.AGCAAGTCC	CTGTGGTGG.AGCAAGTCC
CTGTGGTGG.AGCAGACAA	CTGTGGTGG.AGCAGACAA
CTGTGGTGG.ATATGTCCA	CTGTGGTGG.ATATGTCCA
CTGTGGTGG.ATGGAGGAA	CTGTGGTGG.ATGGAGGAA
CTGTTACCA.ACGACAGTC	CTGTTACCA.ACGACAGTC
CTGTTACCA.ACGTCTATG	CTGTTACCA.ACGTCTATG
CTGTTACCA.AGCTATATG	CTGTTACCA.AGCTATATG
CTGTTACCA.CTCCGCATT	CTGTTACCA.CTCCGCATT
CTGTTACCA.GCGGTAAGT	CTGTTACCA.GCGGTAAGT
CTTAACAGC.GTTAGTCAA	CTTAACAGC.GTTAGTCAA
CTTAAGTTG.AGCGACACC	CTTAAGTTG.AGCGACACC
CTTAAGTTG.ATCGAATCG	CTTAAGTTG.ATCGAATCG
CTTAAGTTG.CTGCGATTC	CTTAAGTTG.CTGCGATTC
CTTAATCGT.ACATTGACA	CTTAATCGT.ACATTGACA
CTTAATCGT.ACTTGATCT	CTTAATCGT.ACTTGATCT
CTTAATCGT.CGTGAGACT	CTTAATCGT.CGTGAGACT
CTTAATCGT.GTTGCATGG	CTTAATCGT.GTTGCATGG
CTTAATCGT.TCGCATTCG	CTTAATCGT.TCGCATTCG
CTTAATCGT.TGCCAGACG	CTTAATCGT.TGCCAGACG
CTTAATCGT.TGTGAGTAT	CTTAATCGT.TGTGAGTAT
CTTACATGC.AGCTTGGTG	CTTACATGC.AGCTTGGTG
CTTACATGC.CTGACGATG	CTTACATGC.CTGACGATG
CTTACATGC.TGCCGACTA	CTTACATGC.TGCCGACTA
CTTACCTAG.GCAGCTCTT	CTTACCTAG.GCAGCTCTT
CTTACCTAG.GTACCTAAC	CTTACCTAG.GTACCTAAC
CTTACCTAG.GTACGTCTA	CTTACCTAG.GTACGTCTA
CTTACCTAG.TAGACCGCA	CTTACCTAG.TAGACCGCA
CTTAGAAGG.AACACACTC	CTTAGAAGG.AACACACTC
CTTAGAAGG.AATCGTGTT	CTTAGAAGG.AATCGTGTT
CTTAGAAGG.TCAGACAAG	CTTAGAAGG.TCAGACAAG
CTTAGGACT.AACAATGCA	CTTAGGACT.AACAATGCA
CTTAGGACT.ACTTCGCAG	CTTAGGACT.ACTTCGCAG
CTTAGGACT.ACTTCTAAC	CTTAGGACT.ACTTCTAAC
CTTAGGACT.ATCCAGCTG	CTTAGGACT.ATCCAGCTG
CTTAGGACT.CAGCTTCGA	CTTAGGACT.CAGCTTCGA
CTTAGGACT.GCCACGAGT	CTTAGGACT.GCCACGAGT
CTTAGGACT.GGAGACACA	CTTAGGACT.GGAGACACA
CTTAGGACT.GTGTCGAGC	CTTAGGACT.GTGTCGAGC
CTTAGGACT.TGCAGTCGG	CTTAGGACT.TGCAGTCGG
CTTATCTCA.AACGCCTAC	CTTATCTCA.AACGCCTAC
CTTATCTCA.AACGGAGAT	CTTATCTCA.AACGGAGAT
CTTATCTCA.AAGCAGCAT	CTTATCTCA.AAGCAGCAT
CTTATCTCA.AGTCTGGAA	CTTATCTCA.AGTCTGGAA
CTTATCTCA.ATTGCCGAC	CTTATCTCA.ATTGCCGAC
CTTATCTCA.CATCCAGGA	CTTATCTCA.CATCCAGGA
CTTATCTCA.GAACATGAC	CTTATCTCA.GAACATGAC
CTTATCTCA.GCTCCTAGC	CTTATCTCA.GCTCCTAGC
CTTATCTCA.GGATTCGTC	CTTATCTCA.GGATTCGTC
CTTATCTCA.TAGATCTGT	CTTATCTCA.TAGATCTGT
CTTATCTCA.TGCCAGACG	CTTATCTCA.TGCCAGACG
CTTATTGAG.ACCGCTGTG	CTTATTGAG.ACCGCTGTG
CTTATTGAG.CCATCTAGG	CTTATTGAG.CCATCTAGG
CTTATTGAG.CGAGCTTAC	CTTATTGAG.CGAGCTTAC
CTTATTGAG.CTACTGTCA	CTTATTGAG.CTACTGTCA
CTTATTGAG.CTCTGCAAG	CTTATTGAG.CTCTGCAAG
CTTATTGAG.GCGTGATAC	CTTATTGAG.GCGTGATAC
CTTATTGAG.TCATCATCT	CTTATTGAG.TCATCATCT
CTTCACTGT.GCCGCCTAA	CTTCACTGT.GCCGCCTAA
CTTCCGGTA.CAATGCATT	CTTCCGGTA.CAATGCATT
CTTCCGGTA.CATTATGTC	CTTCCGGTA.CATTATGTC
CTTCCGGTA.CCTGTCATT	CTTCCGGTA.CCTGTCATT
CTTCCGGTA.GAAGAGCAC	CTTCCGGTA.GAAGAGCAC
CTTCCGGTA.TAACATTGG	CTTCCGGTA.TAACATTGG
CTTCCGTGG.ATTGGTTCC	CTTCCGTGG.ATTGGTTCC
CTTCCGTGG.CAACTAATC	CTTCCGTGG.CAACTAATC
CTTCCGTGG.CATAATTGG	CTTCCGTGG.CATAATTGG
CTTCCGTGG.CCGACTTGG	CTTCCGTGG.CCGACTTGG
CTTCCGTGG.CGCGATGTA	CTTCCGTGG.CGCGATGTA
CTTCCGTGG.GACAATGTT	CTTCCGTGG.GACAATGTT
CTTCCGTGG.GCTCAGCCA	CTTCCGTGG.GCTCAGCCA
CTTCCGTGG.GTCACAGAG	CTTCCGTGG.GTCACAGAG
CTTCCGTGG.TTGACCTGA	CTTCCGTGG.TTGACCTGA
CTTCCTGAT.ACTGACTAC	CTTCCTGAT.ACTGACTAC
CTTCCTGAT.AGCATATGG	CTTCCTGAT.AGCATATGG
CTTCCTGAT.AGGTGCGAG	CTTCCTGAT.AGGTGCGAG
CTTCCTGAT.CTGCAAGCC	CTTCCTGAT.CTGCAAGCC
CTTCCTGAT.GCCGTGAAC	CTTCCTGAT.GCCGTGAAC
CTTCCTGAT.GCGAACTCG	CTTCCTGAT.GCGAACTCG
CTTCCTGAT.GTAGGACGC	CTTCCTGAT.GTAGGACGC
CTTCCTGAT.TAGTAGTCT	CTTCCTGAT.TAGTAGTCT
CTTCCTGAT.TTCATTCGC	CTTCCTGAT.TTCATTCGC
CTTCGACTG.AAGACTACC	CTTCGACTG.AAGACTACC
CTTCGACTG.AGATGTTGG	CTTCGACTG.AGATGTTGG
CTTCGACTG.AGGATTGAG	CTTCGACTG.AGGATTGAG
CTTCGACTG.CCTCGGTCA	CTTCGACTG.CCTCGGTCA
CTTCGACTG.TGTGGACAA	CTTCGACTG.TGTGGACAA
CTTCGACTG.TTCCAGATT	CTTCGACTG.TTCCAGATT
CTTCGTGCA.ACTACCATC	CTTCGTGCA.ACTACCATC
CTTCGTGCA.AGCCAGGAC	CTTCGTGCA.AGCCAGGAC
CTTCGTGCA.AGCGGTCTA	CTTCGTGCA.AGCGGTCTA
CTTCGTGCA.ATAAGACAG	CTTCGTGCA.ATAAGACAG
CTTCGTGCA.CAATTGTCT	CTTCGTGCA.CAATTGTCT
CTTCGTGCA.CTCTCGATA	CTTCGTGCA.CTCTCGATA
CTTCGTGCA.GCAGCTTGA	CTTCGTGCA.GCAGCTTGA
CTTCGTGCA.TAACACGAG	CTTCGTGCA.TAACACGAG
CTTCGTGCA.TTGCCGTAG	CTTCGTGCA.TTGCCGTAG
CTTCTCATC.AGTAAGCCA	CTTCTCATC.AGTAAGCCA
CTTCTCATC.AGTAATGGT	CTTCTCATC.AGTAATGGT
CTTCTCATC.CTAATACGC	CTTCTCATC.CTAATACGC
CTTCTCATC.CTATTCCGT	CTTCTCATC.CTATTCCGT
CTTCTCATC.CTGTACGAC	CTTCTCATC.CTGTACGAC
CTTCTCATC.TGAACTTGC	CTTCTCATC.TGAACTTGC
CTTCTGAGT.ACCGAGTAG	CTTCTGAGT.ACCGAGTAG
CTTCTGAGT.AGCATATGG	CTTCTGAGT.AGCATATGG
CTTCTGAGT.ATATAGCGT	CTTCTGAGT.ATATAGCGT
CTTCTGAGT.ATTAGCACA	CTTCTGAGT.ATTAGCACA
CTTCTGAGT.CGCACTCTT	CTTCTGAGT.CGCACTCTT
CTTCTGAGT.CTAGAGGTA	CTTCTGAGT.CTAGAGGTA
CTTCTGAGT.CTTCCTGAT	CTTCTGAGT.CTTCCTGAT
CTTCTGAGT.TGCGTCTTA	CTTCTGAGT.TGCGTCTTA
CTTGATCTA.ACGACAGTC	CTTGATCTA.ACGACAGTC
CTTGATCTA.AGCGGAACA	CTTGATCTA.AGCGGAACA
CTTGATCTA.ATTGACACG	CTTGATCTA.ATTGACACG
CTTGATCTA.CCGATCAGC	CTTGATCTA.CCGATCAGC
CTTGATCTA.CTCCTGACG	CTTGATCTA.CTCCTGACG
CTTGATCTA.GGATTACGC	CTTGATCTA.GGATTACGC
CTTGATCTA.GGTTCGCAA	CTTGATCTA.GGTTCGCAA
CTTGATCTA.TACACGGTC	CTTGATCTA.TACACGGTC
CTTGATCTA.TAGTGATCC	CTTGATCTA.TAGTGATCC
CTTGATCTA.TCTAATACC	CTTGATCTA.TCTAATACC
CTTGATCTA.TGCTATGAA	CTTGATCTA.TGCTATGAA
CTTGCACAA.CAAGTCGAA	CTTGCACAA.CAAGTCGAA
CTTGCACAA.CCACAAGGT	CTTGCACAA.CCACAAGGT
CTTGCACAA.GATCTTCGC	CTTGCACAA.GATCTTCGC
CTTGCACAA.GTGTCACAC	CTTGCACAA.GTGTCACAC
CTTGCACAA.TCCAGCAGC	CTTGCACAA.TCCAGCAGC
CTTGCGACC.CGCTTCACG	CTTGCGACC.CGCTTCACG
CTTGCGACC.CTTCCGGTA	CTTGCGACC.CTTCCGGTA
CTTGCGACC.TTCACTGGA	CTTGCGACC.TTCACTGGA
CTTGGATCA.CCGGTTGAG	CTTGGATCA.CCGGTTGAG
CTTGGATCA.GACGTTCAG	CTTGGATCA.GACGTTCAG
CTTGGATCA.GGAGATGAG	CTTGGATCA.GGAGATGAG
CTTGGATCA.TGATGACAG	CTTGGATCA.TGATGACAG
CTTGGATCA.TGGTGGTAA	CTTGGATCA.TGGTGGTAA
CTTGGTCAT.AGAGCGCGA	CTTGGTCAT.AGAGCGCGA
CTTGGTCAT.AGGTATTCC	CTTGGTCAT.AGGTATTCC
CTTGGTCAT.CCGAATATG	CTTGGTCAT.CCGAATATG
CTTGGTCAT.CTGTGGTGG	CTTGGTCAT.CTGTGGTGG
CTTGGTCAT.GTGGTACGG	CTTGGTCAT.GTGGTACGG
CTTGGTCAT.TTCACTCCT	CTTGGTCAT.TTCACTCCT
CTTGTAACG.AGGATTACT	CTTGTAACG.AGGATTACT
CTTGTAACG.ATCTAGGTT	CTTGTAACG.ATCTAGGTT
CTTGTAACG.CACATTCTG	CTTGTAACG.CACATTCTG
CTTGTAACG.CTTGCGACC	CTTGTAACG.CTTGCGACC
CTTGTAACG.GATTAGACA	CTTGTAACG.GATTAGACA
CTTGTAACG.TTCCTCGGT	CTTGTAACG.TTCCTCGGT
GAACAACCA.AAGCTGAGG	GAACAACCA.AAGCTGAGG
GAACAACCA.ACAGCATCA	GAACAACCA.ACAGCATCA
GAACAACCA.ACGATGACC	GAACAACCA.ACGATGACC
GAACAACCA.CATGGACTC	GAACAACCA.CATGGACTC
GAACAACCA.TAACGTGTC	GAACAACCA.TAACGTGTC
GAACAACCA.TTAGGAAGG	GAACAACCA.TTAGGAAGG
GAACATGAC.AAGGAAGTC	GAACATGAC.AAGGAAGTC
GAACATGAC.ACTTCGCAG	GAACATGAC.ACTTCGCAG
GAACATGAC.AGTTACAAG	GAACATGAC.AGTTACAAG
GAACATGAC.TGATGACAG	GAACATGAC.TGATGACAG
GAACATGAC.TGCCAATGG	GAACATGAC.TGCCAATGG
GAACCAGTT.AAGCAATCG	GAACCAGTT.AAGCAATCG
GAACCAGTT.GATCGTTGA	GAACCAGTT.GATCGTTGA
GAACCTTCA.ATTCGAAGA	GAACCTTCA.ATTCGAAGA
GAACCTTCA.CATACAACC	GAACCTTCA.CATACAACC
GAACCTTCA.CTGTCTAGT	GAACCTTCA.CTGTCTAGT
GAACCTTCA.GTCGTGTTA	GAACCTTCA.GTCGTGTTA
GAACGCTGT.ACGTGTAGT	GAACGCTGT.ACGTGTAGT
GAACGCTGT.ATGCTTCAG	GAACGCTGT.ATGCTTCAG
GAACGCTGT.CCAATATAC	GAACGCTGT.CCAATATAC
GAACGCTGT.CCACATTAG	GAACGCTGT.CCACATTAG
GAACGCTGT.CCAGATCAC	GAACGCTGT.CCAGATCAC
GAACGCTGT.CCGCTCATG	GAACGCTGT.CCGCTCATG
GAACGCTGT.CTCCAGCGT	GAACGCTGT.CTCCAGCGT
GAACGCTGT.CTTAGAAGG	GAACGCTGT.CTTAGAAGG
GAACGCTGT.GCTACAATG	GAACGCTGT.GCTACAATG
GAACGCTGT.TAAGTGTAG	GAACGCTGT.TAAGTGTAG
GAACGCTGT.TAGTGATCC	GAACGCTGT.TAGTGATCC
GAACTATGG.ATGCGTGGA	GAACTATGG.ATGCGTGGA
GAACTATGG.CACTGTATC	GAACTATGG.CACTGTATC
GAACTCGTA.ATTAGCCAC	GAACTCGTA.ATTAGCCAC
GAACTCGTA.CACCAAGAT	GAACTCGTA.CACCAAGAT
GAACTCGTA.CCGTTCCAA	GAACTCGTA.CCGTTCCAA
GAACTCGTA.CTCGTCTTG	GAACTCGTA.CTCGTCTTG
GAACTCGTA.GATACACTA	GAACTCGTA.GATACACTA
GAACTCGTA.GCGAAGCTC	GAACTCGTA.GCGAAGCTC
GAACTCGTA.GCTATGTAA	GAACTCGTA.GCTATGTAA
GAACTCGTA.GCTGTTCGG	GAACTCGTA.GCTGTTCGG
GAACTCGTA.GTGATGTGC	GAACTCGTA.GTGATGTGC
GAACTCGTA.TATTGACTG	GAACTCGTA.TATTGACTG
GAACTCGTA.TCGTCATTC	GAACTCGTA.TCGTCATTC
GAACTGCAA.CAGCTTACC	GAACTGCAA.CAGCTTACC
GAACTGCAA.CAGGTTGTC	GAACTGCAA.CAGGTTGTC
GAACTGCAA.CGTCGTCAA	GAACTGCAA.CGTCGTCAA
GAACTGCAA.GACTTCACC	GAACTGCAA.GACTTCACC
GAACTGCAA.GCTCAATGA	GAACTGCAA.GCTCAATGA
GAACTGCAA.TCCAGAACG	GAACTGCAA.TCCAGAACG
GAACTGCAA.TCCAGCTAT	GAACTGCAA.TCCAGCTAT
GAACTGCAA.TGTCATAGC	GAACTGCAA.TGTCATAGC
GAAGAGCAC.ACGGACCAT	GAAGAGCAC.ACGGACCAT
GAAGAGCAC.ATAGAGCAG	GAAGAGCAC.ATAGAGCAG
GAAGAGCAC.ATCCATTAG	GAAGAGCAC.ATCCATTAG
GAAGAGCAC.ATCGCCTCT	GAAGAGCAC.ATCGCCTCT
GAAGAGCAC.CACTGGTCC	GAAGAGCAC.CACTGGTCC
GAAGAGCAC.CCTGTCGAC	GAAGAGCAC.CCTGTCGAC
GAAGAGCAC.GACGGTGCT	GAAGAGCAC.GACGGTGCT
GAAGAGCAC.GCTCCTAGC	GAAGAGCAC.GCTCCTAGC
GAAGGATCA.ACGATGACC	GAAGGATCA.ACGATGACC
GAAGGATCA.ATCTTACAG	GAAGGATCA.ATCTTACAG
GAAGGATCA.TCGCAAGCA	GAAGGATCA.TCGCAAGCA
GAAGTGTGA.ACAATTCGG	GAAGTGTGA.ACAATTCGG
GAAGTGTGA.ACACCGCCA	GAAGTGTGA.ACACCGCCA
GAAGTGTGA.ACAGCATCA	GAAGTGTGA.ACAGCATCA
GAAGTGTGA.CTCAGCTGG	GAAGTGTGA.CTCAGCTGG
GAAGTGTGA.CTGTGGTGG	GAAGTGTGA.CTGTGGTGG
GAAGTGTGA.GTACCTAAC	GAAGTGTGA.GTACCTAAC
GAAGTGTGA.TCTACATCC	GAAGTGTGA.TCTACATCC
GAATAAGAG.CATAAGATC	GAATAAGAG.CATAAGATC
GAATAAGAG.GTATCGTCG	GAATAAGAG.GTATCGTCG
GAATAAGAG.TATTGCTAC	GAATAAGAG.TATTGCTAC
GAATAAGAG.TCACAGGTA	GAATAAGAG.TCACAGGTA
GAATAAGAG.TCACTCGCT	GAATAAGAG.TCACTCGCT
GAATCAACC.ATACCGCTT	GAATCAACC.ATACCGCTT
GAATCAACC.ATGGTTCGA	GAATCAACC.ATGGTTCGA
GAATCAACC.CTGGAGCGA	GAATCAACC.CTGGAGCGA
GAATCAACC.GGTCTTGCA	GAATCAACC.GGTCTTGCA
GAATCAACC.GTGCTCGGA	GAATCAACC.GTGCTCGGA
GAATCACAT.AGATGTTGG	GAATCACAT.AGATGTTGG
GAATCACAT.AGTCTGGAA	GAATCACAT.AGTCTGGAA
GAATCACAT.ATGCTCACC	GAATCACAT.ATGCTCACC
GAATCACAT.GATCTTCGC	GAATCACAT.GATCTTCGC
GAATCACAT.GCTAGTGGA	GAATCACAT.GCTAGTGGA
GAATCACAT.GCTGGTAAC	GAATCACAT.GCTGGTAAC
GAATCACAT.GGATAATAC	GAATCACAT.GGATAATAC
GAATCACAT.TGTTAAGCC	GAATCACAT.TGTTAAGCC
GAATCGAGA.GACCGCTTC	GAATCGAGA.GACCGCTTC
GAATCGAGA.GGAATTGGA	GAATCGAGA.GGAATTGGA
GAATCGAGA.TCACATACT	GAATCGAGA.TCACATACT
GAATTCAGT.AACGCTCAA	GAATTCAGT.AACGCTCAA
GAATTCAGT.CATGGTCGA	GAATTCAGT.CATGGTCGA
GAATTCAGT.CCTGTCGAC	GAATTCAGT.CCTGTCGAC
GAATTCAGT.GGATGCGAA	GAATTCAGT.GGATGCGAA
GAATTCAGT.TTACGGACC	GAATTCAGT.TTACGGACC
GAATTCAGT.TTGCAGTCA	GAATTCAGT.TTGCAGTCA
GAATTGTTG.AGTAATGGT	GAATTGTTG.AGTAATGGT
GAATTGTTG.ATGCCTTCA	GAATTGTTG.ATGCCTTCA
GAATTGTTG.CATGGTCGA	GAATTGTTG.CATGGTCGA
GAATTGTTG.CTCGTGTCC	GAATTGTTG.CTCGTGTCC
GAATTGTTG.GAATAAGAG	GAATTGTTG.GAATAAGAG
GAATTGTTG.GAATTGTTG	GAATTGTTG.GAATTGTTG
GAATTGTTG.GTCCTAGTT	GAATTGTTG.GTCCTAGTT
GAATTGTTG.GTGAACCAC	GAATTGTTG.GTGAACCAC
GAATTGTTG.TAGACCGCA	GAATTGTTG.TAGACCGCA
GAATTGTTG.TATCTGTCA	GAATTGTTG.TATCTGTCA
GAATTGTTG.TCGTCCGAT	GAATTGTTG.TCGTCCGAT
GAATTGTTG.TCTGTGAAG	GAATTGTTG.TCTGTGAAG
GACAATGTT.ATCTTACAG	GACAATGTT.ATCTTACAG
GACAATGTT.CACAACCAG	GACAATGTT.CACAACCAG
GACAATGTT.CGGAACGAG	GACAATGTT.CGGAACGAG
GACAATGTT.GCGTGAGCT	GACAATGTT.GCGTGAGCT
GACAATGTT.TATGATGTG	GACAATGTT.TATGATGTG
GACACCGAT.AACGCCTAC	GACACCGAT.AACGCCTAC
