GTATCCTGC.TTGATGCTG	GTATCCTGC.TTGATGCTG
GTATCGTCG.AACGCTCAA	GTATCGTCG.AACGCTCAA
GTATCGTCG.ATCACTTCC	GTATCGTCG.ATCACTTCC
GTATGATCT.AAGAGAACT	GTATGATCT.AAGAGAACT
GTATGATCT.CATGTCCTG	GTATGATCT.CATGTCCTG
GTATGATCT.CTGATCCGA	GTATGATCT.CTGATCCGA
GTATGATCT.GAGATGTAT	GTATGATCT.GAGATGTAT
GTATGATCT.TCCGATCTG	GTATGATCT.TCCGATCTG
GTATGCCTT.CTGAGATAG	GTATGCCTT.CTGAGATAG
GTATGTATC.AAGGAAGTC	GTATGTATC.AAGGAAGTC
GTATGTATC.ATCATAGAC	GTATGTATC.ATCATAGAC
GTATGTATC.CCGATCAGC	GTATGTATC.CCGATCAGC
GTATGTATC.CTGGACTAA	GTATGTATC.CTGGACTAA
GTATGTATC.GCTAGTGGA	GTATGTATC.GCTAGTGGA
GTATTACTG.ACTACTCAT	GTATTACTG.ACTACTCAT
GTATTACTG.ATCTACATC	GTATTACTG.ATCTACATC
GTATTACTG.CTATAGCTC	GTATTACTG.CTATAGCTC
GTATTACTG.GCCGTGAAC	GTATTACTG.GCCGTGAAC
GTCAACTGA.AGACATATC	GTCAACTGA.AGACATATC
GTCAACTGA.ATTCATGTG	GTCAACTGA.ATTCATGTG
GTCAACTGA.CTCTGCGGT	GTCAACTGA.CTCTGCGGT
GTCAAGATC.ACTTCAGTA	GTCAAGATC.ACTTCAGTA
GTCAAGATC.CCATATGCC	GTCAAGATC.CCATATGCC
GTCAAGATC.CGATTGAAC	GTCAAGATC.CGATTGAAC
GTCAAGATC.GAGCATACA	GTCAAGATC.GAGCATACA
GTCAAGATC.GCGTGAGCT	GTCAAGATC.GCGTGAGCT
GTCAAGATC.TATGTATGC	GTCAAGATC.TATGTATGC
GTCAAGATC.TTGCGAACA	GTCAAGATC.TTGCGAACA
GTCAATACA.AGACGCCTG	GTCAATACA.AGACGCCTG
GTCAATACA.AGTGTCTCT	GTCAATACA.AGTGTCTCT
GTCAATACA.CGGAAGACG	GTCAATACA.CGGAAGACG
GTCAATACA.GTCAGCGTC	GTCAATACA.GTCAGCGTC
GTCAATACA.TGTATCGTG	GTCAATACA.TGTATCGTG
GTCACAGAG.AGTGGAATG	GTCACAGAG.AGTGGAATG
GTCACAGAG.CACCAAGAT	GTCACAGAG.CACCAAGAT
GTCACAGAG.CTCGTTCAC	GTCACAGAG.CTCGTTCAC
GTCACAGAG.GAGTCCAAT	GTCACAGAG.GAGTCCAAT
GTCACAGAG.GCAATGAGA	GTCACAGAG.GCAATGAGA
GTCACAGAG.GGTAACTAC	GTCACAGAG.GGTAACTAC
GTCACTATG.CAGGAGCCT	GTCACTATG.CAGGAGCCT
GTCACTATG.CCTCCAATC	GTCACTATG.CCTCCAATC
GTCACTATG.GTCACAGAG	GTCACTATG.GTCACAGAG
GTCAGACCG.GGTACTTCC	GTCAGACCG.GGTACTTCC
GTCAGACCG.TCCTCTAGT	GTCAGACCG.TCCTCTAGT
GTCAGCGTC.CAAGAACCG	GTCAGCGTC.CAAGAACCG
GTCAGCGTC.CCTCCTTGT	GTCAGCGTC.CCTCCTTGT
GTCAGCGTC.TCTGATGAA	GTCAGCGTC.TCTGATGAA
GTCAGCGTC.TGCGATACT	GTCAGCGTC.TGCGATACT
GTCAGTTGT.AGCGTAGAA	GTCAGTTGT.AGCGTAGAA
GTCATTCTA.ACGTCTATG	GTCATTCTA.ACGTCTATG
GTCATTCTA.ATGAGGTAT	GTCATTCTA.ATGAGGTAT
GTCATTCTA.GGTAATCTA	GTCATTCTA.GGTAATCTA
GTCATTCTA.TCTTAGCGA	GTCATTCTA.TCTTAGCGA
GTCCACAAC.CTAGTCGTC	GTCCACAAC.CTAGTCGTC
GTCCACAAC.CTGGAGCGA	GTCCACAAC.CTGGAGCGA
GTCCACAAC.GCCTTGTGA	GTCCACAAC.GCCTTGTGA
GTCCACAAC.GTCATTCTA	GTCCACAAC.GTCATTCTA
GTCCACAAC.TAGTACGTA	GTCCACAAC.TAGTACGTA
GTCCACAAC.TGGTCCTAG	GTCCACAAC.TGGTCCTAG
GTCCACAAC.TTGATGAGT	GTCCACAAC.TTGATGAGT
GTCCGCTCA.AACGCATTG	GTCCGCTCA.AACGCATTG
GTCCGCTCA.AAGCAATCG	GTCCGCTCA.AAGCAATCG
GTCCGCTCA.TCGCTGATT	GTCCGCTCA.TCGCTGATT
GTCCGCTCA.TCTCGATGC	GTCCGCTCA.TCTCGATGC
GTCCGCTCA.TTAACGGAG	GTCCGCTCA.TTAACGGAG
GTCCGCTCA.TTCCGAGCG	GTCCGCTCA.TTCCGAGCG
GTCCGTAAG.AGGATGCGT	GTCCGTAAG.AGGATGCGT
GTCCGTAAG.ATATCCGAT	GTCCGTAAG.ATATCCGAT
GTCCGTAAG.ATCCTCCGA	GTCCGTAAG.ATCCTCCGA
GTCCGTAAG.CTTAGAAGG	GTCCGTAAG.CTTAGAAGG
GTCCGTAAG.CTTGGTCAT	GTCCGTAAG.CTTGGTCAT
GTCCGTAAG.GCAACCAAC	GTCCGTAAG.GCAACCAAC
GTCCTAGTT.AATGCACTT	GTCCTAGTT.AATGCACTT
GTCCTAGTT.CACAATAAC	GTCCTAGTT.CACAATAAC
GTCCTAGTT.CAGATCGAC	GTCCTAGTT.CAGATCGAC
GTCCTAGTT.CTAACACTG	GTCCTAGTT.CTAACACTG
GTCCTAGTT.CTATACTAG	GTCCTAGTT.CTATACTAG
GTCCTAGTT.GGACTATTC	GTCCTAGTT.GGACTATTC
GTCCTAGTT.TACCAGCCA	GTCCTAGTT.TACCAGCCA
GTCCTAGTT.TAGAGCGTC	GTCCTAGTT.TAGAGCGTC
GTCCTAGTT.TGACGGTTG	GTCCTAGTT.TGACGGTTG
GTCCTTCAT.ACACACGTC	GTCCTTCAT.ACACACGTC
GTCCTTCAT.TAAGGTCCG	GTCCTTCAT.TAAGGTCCG
GTCGACATT.ACCGACGGT	GTCGACATT.ACCGACGGT
GTCGACATT.CGTACACAC	GTCGACATT.CGTACACAC
GTCGACATT.GCTAGCTCC	GTCGACATT.GCTAGCTCC
GTCGACATT.TATTACTCG	GTCGACATT.TATTACTCG
GTCGAGTAC.CACTGGTCC	GTCGAGTAC.CACTGGTCC
GTCGAGTAC.TCACGACAA	GTCGAGTAC.TCACGACAA
GTCGCAGGT.ACAGTATTG	GTCGCAGGT.ACAGTATTG
GTCGCAGGT.ACATTGACA	GTCGCAGGT.ACATTGACA
GTCGCAGGT.ACTCCTGAG	GTCGCAGGT.ACTCCTGAG
GTCGCAGGT.CACAACGCT	GTCGCAGGT.CACAACGCT
GTCGCAGGT.TAGACACGT	GTCGCAGGT.TAGACACGT
GTCGCAGGT.TATGACCGA	GTCGCAGGT.TATGACCGA
GTCGCAGGT.TCACACTGC	GTCGCAGGT.TCACACTGC
GTCGCAGGT.TCTAATACC	GTCGCAGGT.TCTAATACC
GTCGCAGGT.TGAAGACCA	GTCGCAGGT.TGAAGACCA
GTCGCAGGT.TGATTATCG	GTCGCAGGT.TGATTATCG
GTCGCAGGT.TGCTTACGG	GTCGCAGGT.TGCTTACGG
GTCGTCGAC.AGACCAGCT	GTCGTCGAC.AGACCAGCT
GTCGTCGAC.GCTCAGCCA	GTCGTCGAC.GCTCAGCCA
GTCGTCGAC.GGAACCTAG	GTCGTCGAC.GGAACCTAG
GTCGTCGAC.GGAGCATCT	GTCGTCGAC.GGAGCATCT
GTCGTCGAC.GTGACGTAA	GTCGTCGAC.GTGACGTAA
GTCGTCGAC.TATCATGCT	GTCGTCGAC.TATCATGCT
GTCGTCGAC.TCATCATCT	GTCGTCGAC.TCATCATCT
GTCGTGTTA.ACGCTAGTG	GTCGTGTTA.ACGCTAGTG
GTCGTGTTA.ATAGTGGTT	GTCGTGTTA.ATAGTGGTT
GTCGTGTTA.CATACGCAG	GTCGTGTTA.CATACGCAG
GTCGTGTTA.CCAGGAGTT	GTCGTGTTA.CCAGGAGTT
GTCGTGTTA.CTGATGCAC	GTCGTGTTA.CTGATGCAC
GTCGTGTTA.TACTTCCAG	GTCGTGTTA.TACTTCCAG
GTCGTTAGA.AATAGACGC	GTCGTTAGA.AATAGACGC
GTCGTTAGA.CATTATGTC	GTCGTTAGA.CATTATGTC
GTCGTTAGA.CGCTGTAGT	GTCGTTAGA.CGCTGTAGT
GTCGTTAGA.GAGAACAGG	GTCGTTAGA.GAGAACAGG
GTCGTTAGA.TATGACCGA	GTCGTTAGA.TATGACCGA
GTCGTTAGA.TGCTGCGTC	GTCGTTAGA.TGCTGCGTC
GTCGTTAGA.TTATGAGGA	GTCGTTAGA.TTATGAGGA
GTCGTTGCG.AGATCTGAC	GTCGTTGCG.AGATCTGAC
GTCGTTGCG.AGTAATGGT	GTCGTTGCG.AGTAATGGT
GTCGTTGCG.GCGCTACCT	GTCGTTGCG.GCGCTACCT
GTCGTTGCG.GGTCTTGCA	GTCGTTGCG.GGTCTTGCA
GTCGTTGCG.GTCTGACGT	GTCGTTGCG.GTCTGACGT
GTCGTTGCG.TTCATCCAA	GTCGTTGCG.TTCATCCAA
GTCTACCAA.AAGACTACC	GTCTACCAA.AAGACTACC
GTCTACCAA.ACCGTCACG	GTCTACCAA.ACCGTCACG
GTCTACCAA.ATCAAGCAT	GTCTACCAA.ATCAAGCAT
GTCTACCAA.CGCAATCGA	GTCTACCAA.CGCAATCGA
GTCTACCAA.CGGACAAGT	GTCTACCAA.CGGACAAGT
GTCTACCAA.TCAGTAAGC	GTCTACCAA.TCAGTAAGC
GTCTACCAA.TCCTGAGAC	GTCTACCAA.TCCTGAGAC
GTCTACCAA.TCTCGTATC	GTCTACCAA.TCTCGTATC
GTCTACCAA.TGCAGATGC	GTCTACCAA.TGCAGATGC
GTCTACCAA.TTCACTGGA	GTCTACCAA.TTCACTGGA
GTCTCCAGG.ACAGTATTG	GTCTCCAGG.ACAGTATTG
GTCTCCAGG.ACGCTAGTG	GTCTCCAGG.ACGCTAGTG
GTCTCCAGG.AGCTACTCA	GTCTCCAGG.AGCTACTCA
GTCTCCAGG.GCATGTAAG	GTCTCCAGG.GCATGTAAG
GTCTCTTCA.ACGCTCTTA	GTCTCTTCA.ACGCTCTTA
GTCTCTTCA.CTAGTTCCA	GTCTCTTCA.CTAGTTCCA
GTCTCTTCA.GGAGCATCT	GTCTCTTCA.GGAGCATCT
GTCTGACGT.CACGACTCA	GTCTGACGT.CACGACTCA
GTCTGACGT.TACAGGACT	GTCTGACGT.TACAGGACT
GTCTGAGCC.AAGTCATGA	GTCTGAGCC.AAGTCATGA
GTCTGAGCC.CTTAGAAGG	GTCTGAGCC.CTTAGAAGG
GTCTGAGCC.GCCGTCTTC	GTCTGAGCC.GCCGTCTTC
GTCTGAGCC.GGTCGGTCT	GTCTGAGCC.GGTCGGTCT
GTCTGAGCC.GTGCGAGTA	GTCTGAGCC.GTGCGAGTA
GTCTGAGCC.TATGCCTTC	GTCTGAGCC.TATGCCTTC
GTCTGAGCC.TCTAGCTGG	GTCTGAGCC.TCTAGCTGG
GTCTGAGCC.TGCTGCGTC	GTCTGAGCC.TGCTGCGTC
GTCTGAGCC.TTCGCATCC	GTCTGAGCC.TTCGCATCC
GTCTTATGC.AGATATGGA	GTCTTATGC.AGATATGGA
GTCTTATGC.GTTCCAACA	GTCTTATGC.GTTCCAACA
GTCTTATGC.TCAGCGACC	GTCTTATGC.TCAGCGACC
GTCTTATGC.TTCCGAGCG	GTCTTATGC.TTCCGAGCG
GTCTTCATA.ATAGACCGA	GTCTTCATA.ATAGACCGA
GTCTTCATA.CCTCCAATC	GTCTTCATA.CCTCCAATC
GTCTTCATA.CGACAGGAA	GTCTTCATA.CGACAGGAA
GTCTTCATA.GAGAATCAG	GTCTTCATA.GAGAATCAG
GTCTTCTCG.ATCGAATCG	GTCTTCTCG.ATCGAATCG
GTCTTCTCG.CACGTAGAC	GTCTTCTCG.CACGTAGAC
GTCTTCTCG.CTGCAAGCC	GTCTTCTCG.CTGCAAGCC
GTCTTCTCG.GAACAACCA	GTCTTCTCG.GAACAACCA
GTCTTCTCG.GCAATCACG	GTCTTCTCG.GCAATCACG
GTCTTCTCG.GCGGTAGTC	GTCTTCTCG.GCGGTAGTC
GTCTTCTCG.TACCATGTA	GTCTTCTCG.TACCATGTA
GTCTTCTCG.TACTCGCTG	GTCTTCTCG.TACTCGCTG
GTGAACCAC.AACAATGCA	GTGAACCAC.AACAATGCA
GTGAACCAC.ACTCTAGGA	GTGAACCAC.ACTCTAGGA
GTGAACCAC.CCTAGTTAG	GTGAACCAC.CCTAGTTAG
GTGAACCAC.TCCATCATT	GTGAACCAC.TCCATCATT
GTGAATGCC.ACACGTTGC	GTGAATGCC.ACACGTTGC
GTGAATGCC.ACTGTGTCA	GTGAATGCC.ACTGTGTCA
GTGAATGCC.ATCTGCGTA	GTGAATGCC.ATCTGCGTA
GTGAATGCC.CAGTGCTGC	GTGAATGCC.CAGTGCTGC
GTGAATGCC.CCGTCAGGT	GTGAATGCC.CCGTCAGGT
GTGAATGCC.GTAGACTCT	GTGAATGCC.GTAGACTCT
GTGAATGCC.TTCCAATTC	GTGAATGCC.TTCCAATTC
GTGACGTAA.AAGAGAGAG	GTGACGTAA.AAGAGAGAG
GTGACGTAA.CAAGTCGAA	GTGACGTAA.CAAGTCGAA
GTGACGTAA.CACGGATAG	GTGACGTAA.CACGGATAG
GTGACGTAA.CACGTCATA	GTGACGTAA.CACGTCATA
GTGACGTAA.CTATACTAG	GTGACGTAA.CTATACTAG
GTGACGTAA.GATCTTCGC	GTGACGTAA.GATCTTCGC
GTGACGTAA.GCATACTCC	GTGACGTAA.GCATACTCC
GTGACGTAA.GCGTAACAA	GTGACGTAA.GCGTAACAA
GTGACGTAA.GGAATTCAC	GTGACGTAA.GGAATTCAC
GTGACGTAA.TCCAGAACG	GTGACGTAA.TCCAGAACG
GTGACGTAA.TGCATCGGA	GTGACGTAA.TGCATCGGA
GTGACGTAA.TTCTGAATG	GTGACGTAA.TTCTGAATG
GTGACTCTC.ACCACGCTA	GTGACTCTC.ACCACGCTA
GTGACTCTC.AGTGTTCTG	GTGACTCTC.AGTGTTCTG
GTGACTCTC.ATTAAGACC	GTGACTCTC.ATTAAGACC
GTGACTCTC.CAACACCTA	GTGACTCTC.CAACACCTA
GTGACTCTC.CCGATCAGC	GTGACTCTC.CCGATCAGC
GTGACTCTC.CGCGTACTA	GTGACTCTC.CGCGTACTA
GTGACTCTC.GAGCAGGAA	GTGACTCTC.GAGCAGGAA
GTGACTCTC.GCTCTGTGT	GTGACTCTC.GCTCTGTGT
GTGACTCTC.GGACTATTC	GTGACTCTC.GGACTATTC
GTGACTCTC.TACCTCCTC	GTGACTCTC.TACCTCCTC
GTGACTCTC.TGTATCGTG	GTGACTCTC.TGTATCGTG
GTGACTCTC.TGTGTAGAG	GTGACTCTC.TGTGTAGAG
GTGAGGACG.AGTGAGAGA	GTGAGGACG.AGTGAGAGA
GTGAGGACG.GCGAGCAAG	GTGAGGACG.GCGAGCAAG
GTGAGGACG.TGTGCTAAC	GTGAGGACG.TGTGCTAAC
GTGATGTGC.ACTGTAATC	GTGATGTGC.ACTGTAATC
GTGATGTGC.GCGTGAGCT	GTGATGTGC.GCGTGAGCT
GTGATGTGC.GGACACTGG	GTGATGTGC.GGACACTGG
GTGATGTGC.TATGACCGA	GTGATGTGC.TATGACCGA
GTGATGTGC.TCAGTAAGC	GTGATGTGC.TCAGTAAGC
GTGATGTGC.TTCACCTTG	GTGATGTGC.TTCACCTTG
GTGCACGAG.AACCATGGT	GTGCACGAG.AACCATGGT
GTGCACGAG.ACGCTATGT	GTGCACGAG.ACGCTATGT
GTGCACGAG.GCCGAACCA	GTGCACGAG.GCCGAACCA
GTGCACGAG.GGATCAGGT	GTGCACGAG.GGATCAGGT
GTGCACGAG.GTACGCGAT	GTGCACGAG.GTACGCGAT
GTGCACGAG.TCAAGCGTA	GTGCACGAG.TCAAGCGTA
GTGCATCAA.GGAAGGTAT	GTGCATCAA.GGAAGGTAT
GTGCATCAA.TCACATACT	GTGCATCAA.TCACATACT
GTGCCATGA.ACAATTCGG	GTGCCATGA.ACAATTCGG
GTGCCATGA.ATACCGCTT	GTGCCATGA.ATACCGCTT
GTGCCATGA.CAGCTAGTT	GTGCCATGA.CAGCTAGTT
GTGCCATGA.CATACGCAG	GTGCCATGA.CATACGCAG
GTGCCATGA.CATTCAGTT	GTGCCATGA.CATTCAGTT
GTGCCATGA.CGTGTATTC	GTGCCATGA.CGTGTATTC
GTGCCATGA.GAACGCTGT	GTGCCATGA.GAACGCTGT
GTGCCATGA.GAGTTATAG	GTGCCATGA.GAGTTATAG
GTGCCATGA.TCCGATCTG	GTGCCATGA.TCCGATCTG
GTGCCATGA.TTACGGACC	GTGCCATGA.TTACGGACC
GTGCGAGTA.CTGCAAGCC	GTGCGAGTA.CTGCAAGCC
GTGCGAGTA.TAGACACGT	GTGCGAGTA.TAGACACGT
GTGCGAGTA.TCAGAGCGT	GTGCGAGTA.TCAGAGCGT
GTGCGTTCC.AATGCACTT	GTGCGTTCC.AATGCACTT
GTGCGTTCC.CCAGTTACG	GTGCGTTCC.CCAGTTACG
GTGCGTTCC.CTAGTCGTC	GTGCGTTCC.CTAGTCGTC
GTGCTAAGC.ACGAGAGCA	GTGCTAAGC.ACGAGAGCA
GTGCTAAGC.AGCTTGGTG	GTGCTAAGC.AGCTTGGTG
GTGCTAAGC.GACCGTAGT	GTGCTAAGC.GACCGTAGT
GTGCTAAGC.GAGCACATT	GTGCTAAGC.GAGCACATT
GTGCTAAGC.GTTGCTCAG	GTGCTAAGC.GTTGCTCAG
GTGCTCGGA.AAGGATCGT	GTGCTCGGA.AAGGATCGT
GTGCTCGGA.ATCAGGATG	GTGCTCGGA.ATCAGGATG
GTGCTCGGA.ATTCGAAGA	GTGCTCGGA.ATTCGAAGA
GTGCTCGGA.CCTTCCTCA	GTGCTCGGA.CCTTCCTCA
GTGCTCGGA.CGACAGGAA	GTGCTCGGA.CGACAGGAA
GTGCTCGGA.GCGACCTGT	GTGCTCGGA.GCGACCTGT
GTGCTCGGA.TGATCTCGG	GTGCTCGGA.TGATCTCGG
GTGCTCTTG.ACCAGCGTT	GTGCTCTTG.ACCAGCGTT
GTGCTCTTG.CAATCTCCG	GTGCTCTTG.CAATCTCCG
GTGCTCTTG.CTAATACGC	GTGCTCTTG.CTAATACGC
GTGCTCTTG.CTCCTGACG	GTGCTCTTG.CTCCTGACG
GTGCTCTTG.GGTAAGTGA	GTGCTCTTG.GGTAAGTGA
GTGCTGACT.CGTTACACC	GTGCTGACT.CGTTACACC
GTGCTGACT.CTGATGCAC	GTGCTGACT.CTGATGCAC
GTGCTGACT.GGAAGTATG	GTGCTGACT.GGAAGTATG
GTGCTGACT.TGGTCTACG	GTGCTGACT.TGGTCTACG
GTGGACTGG.AGACTAGTA	GTGGACTGG.AGACTAGTA
GTGGACTGG.ATTGATTGG	GTGGACTGG.ATTGATTGG
GTGGACTGG.TCGAACGCT	GTGGACTGG.TCGAACGCT
GTGGACTGG.TGCCAGACG	GTGGACTGG.TGCCAGACG
GTGGACTGG.TTATCGCAC	GTGGACTGG.TTATCGCAC
GTGGAGGTC.CCATTCTGC	GTGGAGGTC.CCATTCTGC
GTGGAGGTC.CCGCAACAC	GTGGAGGTC.CCGCAACAC
GTGGAGGTC.CGATTGAAC	GTGGAGGTC.CGATTGAAC
GTGGAGGTC.TCCAGCAGC	GTGGAGGTC.TCCAGCAGC
GTGGATAAG.AGTATGACG	GTGGATAAG.AGTATGACG
GTGGATAAG.CAACGATCG	GTGGATAAG.CAACGATCG
GTGGATAAG.CCGATACCG	GTGGATAAG.CCGATACCG
GTGGATAAG.GTCCGCTCA	GTGGATAAG.GTCCGCTCA
GTGGTACGG.AACTTGTCG	GTGGTACGG.AACTTGTCG
GTGGTACGG.ACCGGAGTA	GTGGTACGG.ACCGGAGTA
GTGGTTACC.AGAAGTAAC	GTGGTTACC.AGAAGTAAC
GTGGTTACC.ATTCACCTC	GTGGTTACC.ATTCACCTC
GTGGTTACC.CAGCACGTG	GTGGTTACC.CAGCACGTG
GTGGTTACC.CCATCACGA	GTGGTTACC.CCATCACGA
GTGGTTACC.CCGGTTCTA	GTGGTTACC.CCGGTTCTA
GTGGTTACC.GCTGGTAAC	GTGGTTACC.GCTGGTAAC
GTGGTTACC.TTAGTCGGA	GTGGTTACC.TTAGTCGGA
GTGTACCGT.CGGAATGCA	GTGTACCGT.CGGAATGCA
GTGTATCTG.AGTGTGCAC	GTGTATCTG.AGTGTGCAC
GTGTATCTG.CTGGTGACA	GTGTATCTG.CTGGTGACA
GTGTATCTG.GTGCTAAGC	GTGTATCTG.GTGCTAAGC
GTGTATCTG.TCTGATGAA	GTGTATCTG.TCTGATGAA
GTGTCACAC.ACGTATGTC	GTGTCACAC.ACGTATGTC
GTGTCACAC.CGGAAGACG	GTGTCACAC.CGGAAGACG
GTGTCACAC.GACATATGT	GTGTCACAC.GACATATGT
GTGTCACAC.TCAGTAAGC	GTGTCACAC.TCAGTAAGC
GTGTCCGTG.AGCAACATT	GTGTCCGTG.AGCAACATT
GTGTCCGTG.ATTGATTGG	GTGTCCGTG.ATTGATTGG
GTGTCCGTG.CAAGAGGAG	GTGTCCGTG.CAAGAGGAG
GTGTCCGTG.CTGTCTAGT	GTGTCCGTG.CTGTCTAGT
GTGTCCGTG.TAATGTAGC	GTGTCCGTG.TAATGTAGC
GTGTCCGTG.TTGTAATGC	GTGTCCGTG.TTGTAATGC
GTGTCGAGC.GTCAAGATC	GTGTCGAGC.GTCAAGATC
GTGTCGAGC.GTCAGACCG	GTGTCGAGC.GTCAGACCG
GTGTCGAGC.GTCTCTTCA	GTGTCGAGC.GTCTCTTCA
GTGTCGAGC.GTCTTATGC	GTGTCGAGC.GTCTTATGC
GTGTCGAGC.GTGTCTGGA	GTGTCGAGC.GTGTCTGGA
GTGTCGAGC.TGGTAGCAG	GTGTCGAGC.TGGTAGCAG
GTGTCTGGA.ATGCGTGGA	GTGTCTGGA.ATGCGTGGA
GTGTCTGGA.CCGGTGGTT	GTGTCTGGA.CCGGTGGTT
GTGTCTGGA.CTGGACTAA	GTGTCTGGA.CTGGACTAA
GTGTCTGGA.GGAGCATCT	GTGTCTGGA.GGAGCATCT
GTGTCTGGA.TGATGACAG	GTGTCTGGA.TGATGACAG
GTGTCTGGA.TTAGGAAGG	GTGTCTGGA.TTAGGAAGG
GTGTTCCAG.AGAAGTAAC	GTGTTCCAG.AGAAGTAAC
GTGTTCCAG.AGGAGGTGA	GTGTTCCAG.AGGAGGTGA
GTGTTCCAG.AGTCGCCGA	GTGTTCCAG.AGTCGCCGA
GTGTTCCAG.GGACGAGCA	GTGTTCCAG.GGACGAGCA
GTGTTCCAG.GTACGTCTA	GTGTTCCAG.GTACGTCTA
GTGTTCCAG.GTTCCAACA	GTGTTCCAG.GTTCCAACA
GTGTTCCAG.TCGCAAGCA	GTGTTCCAG.TCGCAAGCA
GTGTTCCAG.TGACCTCCT	GTGTTCCAG.TGACCTCCT
GTGTTGGAA.ACGAGAGCA	GTGTTGGAA.ACGAGAGCA
GTGTTGGAA.GATCTTCGC	GTGTTGGAA.GATCTTCGC
GTGTTGGAA.GCGAAGCTC	GTGTTGGAA.GCGAAGCTC
GTGTTGGAA.TATTGCTAC	GTGTTGGAA.TATTGCTAC
GTGTTGGAA.TCAGTGCAA	GTGTTGGAA.TCAGTGCAA
GTTAATTCG.CCTCGAGAG	GTTAATTCG.CCTCGAGAG
GTTAATTCG.CGCGCACAT	GTTAATTCG.CGCGCACAT
GTTAATTCG.GACCAACAG	GTTAATTCG.GACCAACAG
GTTAATTCG.GAGCGACTC	GTTAATTCG.GAGCGACTC
GTTAATTCG.GCCTTCCAT	GTTAATTCG.GCCTTCCAT
GTTAATTCG.GCTACAATG	GTTAATTCG.GCTACAATG
GTTACTACT.AATATCAGC	GTTACTACT.AATATCAGC
GTTACTACT.TAGGATGCC	GTTACTACT.TAGGATGCC
GTTAGAGAC.AGGAGGTGA	GTTAGAGAC.AGGAGGTGA
GTTAGAGAC.CACGGATAG	GTTAGAGAC.CACGGATAG
GTTAGAGAC.CAGTATGAT	GTTAGAGAC.CAGTATGAT
GTTAGAGAC.CATACGCAG	GTTAGAGAC.CATACGCAG
GTTAGAGAC.CCTTAACAT	GTTAGAGAC.CCTTAACAT
GTTAGATTG.ACAAGGTAC	GTTAGATTG.ACAAGGTAC
GTTAGATTG.ACCTAGCAC	GTTAGATTG.ACCTAGCAC
GTTAGATTG.TCAGAGTCA	GTTAGATTG.TCAGAGTCA
GTTAGTCAA.AAGAGAACT	GTTAGTCAA.AAGAGAACT
GTTAGTCAA.ACAGCATCA	GTTAGTCAA.ACAGCATCA
GTTAGTCAA.AGATATGGA	GTTAGTCAA.AGATATGGA
GTTAGTCAA.AGTCGATCA	GTTAGTCAA.AGTCGATCA
GTTAGTCAA.CCAGTACTC	GTTAGTCAA.CCAGTACTC
GTTAGTCAA.CCTCGCGTT	GTTAGTCAA.CCTCGCGTT
GTTAGTCAA.GGAGATGAG	GTTAGTCAA.GGAGATGAG
GTTAGTCAA.GGTGTGACC	GTTAGTCAA.GGTGTGACC
GTTAGTCAA.TACCTCCTC	GTTAGTCAA.TACCTCCTC
GTTAGTCAA.TCCGATAAC	GTTAGTCAA.TCCGATAAC
GTTAGTCAA.TGATGACAG	GTTAGTCAA.TGATGACAG
GTTAGTCAA.TGCGCACTG	GTTAGTCAA.TGCGCACTG
GTTATCGAT.AGTCTAAGC	GTTATCGAT.AGTCTAAGC
GTTATCGAT.ATCATTACG	GTTATCGAT.ATCATTACG
GTTATCGAT.CAGTTGAGT	GTTATCGAT.CAGTTGAGT
GTTATCGAT.CATCTCGAT	GTTATCGAT.CATCTCGAT
GTTATCGAT.GACATATGT	GTTATCGAT.GACATATGT
GTTATCGAT.GCTACCTTA	GTTATCGAT.GCTACCTTA
GTTATCGAT.TATGCCTTC	GTTATCGAT.TATGCCTTC
GTTATCGAT.TCGCTGTAA	GTTATCGAT.TCGCTGTAA
GTTCACTCC.CCGAGCTGA	GTTCACTCC.CCGAGCTGA
GTTCACTCC.GAACTGCAA	GTTCACTCC.GAACTGCAA
GTTCACTCC.GAGGTCACG	GTTCACTCC.GAGGTCACG
GTTCACTCC.GTGTCGAGC	GTTCACTCC.GTGTCGAGC
GTTCACTCC.TTGGAGAAC	GTTCACTCC.TTGGAGAAC
GTTCAGAAG.AAGCTGAGG	GTTCAGAAG.AAGCTGAGG
GTTCAGAAG.ACAGAAGAG	GTTCAGAAG.ACAGAAGAG
GTTCAGAAG.ACTCGTAGG	GTTCAGAAG.ACTCGTAGG
GTTCAGAAG.AGTCCGTGT	GTTCAGAAG.AGTCCGTGT
GTTCAGAAG.CATGTGAAC	GTTCAGAAG.CATGTGAAC
GTTCAGAAG.CGTCGTCAA	GTTCAGAAG.CGTCGTCAA
GTTCAGAAG.CTGTACGAC	GTTCAGAAG.CTGTACGAC
GTTCAGAAG.GATCTGTTC	GTTCAGAAG.GATCTGTTC
GTTCAGAAG.GGTGTGACC	GTTCAGAAG.GGTGTGACC
GTTCAGAAG.TCATGCAGG	GTTCAGAAG.TCATGCAGG
GTTCCAACA.AACTCCATG	GTTCCAACA.AACTCCATG
GTTCCAACA.ATCTAGGTT	GTTCCAACA.ATCTAGGTT
GTTGACCAT.ACTCGAGTC	GTTGACCAT.ACTCGAGTC
GTTGACCAT.ATAATGTGG	GTTGACCAT.ATAATGTGG
GTTGACCAT.CGACCTGTA	GTTGACCAT.CGACCTGTA
GTTGACCAT.CGCAATCGA	GTTGACCAT.CGCAATCGA
GTTGACCAT.CGCTTGTAG	GTTGACCAT.CGCTTGTAG
GTTGACCAT.CTTAGAAGG	GTTGACCAT.CTTAGAAGG
GTTGACCAT.GTAACAGTC	GTTGACCAT.GTAACAGTC
GTTGACCAT.GTAAGGTCC	GTTGACCAT.GTAAGGTCC
GTTGACCAT.TCAAGGAGT	GTTGACCAT.TCAAGGAGT
GTTGACCAT.TCGCATTCG	GTTGACCAT.TCGCATTCG
GTTGACGTG.AATGCCTCA	GTTGACGTG.AATGCCTCA
GTTGACGTG.CGGAAGACG	GTTGACGTG.CGGAAGACG
GTTGACGTG.TAGGAGCTA	GTTGACGTG.TAGGAGCTA
GTTGATGCA.AACTTAGCT	GTTGATGCA.AACTTAGCT
GTTGATGCA.AAGCAACTA	GTTGATGCA.AAGCAACTA
GTTGATGCA.AGACATCCA	GTTGATGCA.AGACATCCA
GTTGATGCA.AGTCGCCGA	GTTGATGCA.AGTCGCCGA
GTTGATGCA.CAGATCATT	GTTGATGCA.CAGATCATT
GTTGATGCA.CCAGGAGTT	GTTGATGCA.CCAGGAGTT
GTTGATGCA.CCATAGCCA	GTTGATGCA.CCATAGCCA
GTTGATGCA.CGGTGTTAC	GTTGATGCA.CGGTGTTAC
GTTGATGCA.CTGACGATG	GTTGATGCA.CTGACGATG
GTTGATGCA.GATCTTCGC	GTTGATGCA.GATCTTCGC
GTTGATGCA.TAGGAGCTA	GTTGATGCA.TAGGAGCTA
GTTGATGCA.TATACGTGG	GTTGATGCA.TATACGTGG
GTTGATGCA.TCGTGACGT	GTTGATGCA.TCGTGACGT
GTTGATGCA.TGTCAACCT	GTTGATGCA.TGTCAACCT
GTTGCATGG.CGACGTACG	GTTGCATGG.CGACGTACG
GTTGCATGG.GTATCCTGC	GTTGCATGG.GTATCCTGC
GTTGCATGG.TCTCGTATC	GTTGCATGG.TCTCGTATC
GTTGCTCAG.AATGCCTCA	GTTGCTCAG.AATGCCTCA
GTTGCTCAG.CCATAATCG	GTTGCTCAG.CCATAATCG
GTTGCTCAG.CTTGTAACG	GTTGCTCAG.CTTGTAACG
GTTGCTCAG.GCAGATCCG	GTTGCTCAG.GCAGATCCG
GTTGCTCAG.GCGCTACCT	GTTGCTCAG.GCGCTACCT
GTTGCTCAG.GGAAGAAGC	GTTGCTCAG.GGAAGAAGC
GTTGCTCAG.TCCAGCTAT	GTTGCTCAG.TCCAGCTAT
GTTGCTCAG.TCCTTCAAC	GTTGCTCAG.TCCTTCAAC
TAACACATC.ATTGACACG	TAACACATC.ATTGACACG
TAACACATC.CGGAATGCA	TAACACATC.CGGAATGCA
TAACACATC.GCCTTAGAG	TAACACATC.GCCTTAGAG
TAACACATC.GCGGAGATT	TAACACATC.GCGGAGATT
TAACACATC.GTTGACGTG	TAACACATC.GTTGACGTG
TAACACATC.TAGCCAGTG	TAACACATC.TAGCCAGTG
TAACACATC.TGGAATCGT	TAACACATC.TGGAATCGT
TAACACATC.TGGTGCCTG	TAACACATC.TGGTGCCTG
TAACACGAG.ATGAGGTAT	TAACACGAG.ATGAGGTAT
TAACACGAG.CCTCATAAC	TAACACGAG.CCTCATAAC
TAACACGAG.TAACGGATA	TAACACGAG.TAACGGATA
TAACACGAG.TCGTGCCAC	TAACACGAG.TCGTGCCAC
TAACATTGG.ACTTGATCT	TAACATTGG.ACTTGATCT
TAACATTGG.GTGCCATGA	TAACATTGG.GTGCCATGA
TAACATTGG.GTGTCTGGA	TAACATTGG.GTGTCTGGA
TAACATTGG.TAGTTGACG	TAACATTGG.TAGTTGACG
TAACATTGG.TGATGTGTG	TAACATTGG.TGATGTGTG
TAACCGTGA.CAAGGTGTG	TAACCGTGA.CAAGGTGTG
TAACCGTGA.GTGCACGAG	TAACCGTGA.GTGCACGAG
TAACCGTGA.GTTGCATGG	TAACCGTGA.GTTGCATGG
TAACCGTGA.TCGCCAAGC	TAACCGTGA.TCGCCAAGC
TAACCGTGA.TGGTAGCAG	TAACCGTGA.TGGTAGCAG
TAACGGATA.CCTGCAGAT	TAACGGATA.CCTGCAGAT
TAACGGATA.CGACGTACG	TAACGGATA.CGACGTACG
TAACGTGTC.TGAACGTCA	TAACGTGTC.TGAACGTCA
TAACTCCGA.AGCTTGGTG	TAACTCCGA.AGCTTGGTG
TAACTCCGA.GTTGACGTG	TAACTCCGA.GTTGACGTG
TAACTCCGA.TATTACTCG	TAACTCCGA.TATTACTCG
TAAGCACTA.ATACCGCTT	TAAGCACTA.ATACCGCTT
TAAGCACTA.CTAGTGCTG	TAAGCACTA.CTAGTGCTG
TAAGCACTA.CTAGTTCCA	TAAGCACTA.CTAGTTCCA
TAAGCACTA.TACAACACC	TAAGCACTA.TACAACACC
TAAGCACTA.TCAGTGTTC	TAAGCACTA.TCAGTGTTC
TAAGCACTA.TCCACCGGT	TAAGCACTA.TCCACCGGT
TAAGCACTA.TGAGATCAT	TAAGCACTA.TGAGATCAT
TAAGCCATT.AGTAAGCCA	TAAGCCATT.AGTAAGCCA
TAAGCCATT.ATCTTACAG	TAAGCCATT.ATCTTACAG
TAAGCCATT.CTGTGGTGG	TAAGCCATT.CTGTGGTGG
TAAGCCATT.GATCTAGAG	TAAGCCATT.GATCTAGAG
TAAGCCATT.TCCTATTCC	TAAGCCATT.TCCTATTCC
TAAGCCATT.TCGAACGCT	TAAGCCATT.TCGAACGCT
TAAGGTCCG.ACCTGTACC	TAAGGTCCG.ACCTGTACC
TAAGGTCCG.ACTTCGCAG	TAAGGTCCG.ACTTCGCAG
TAAGGTCCG.CCTTAACAT	TAAGGTCCG.CCTTAACAT
TAAGGTCCG.GTAAGGTCC	TAAGGTCCG.GTAAGGTCC
TAAGGTCCG.TAGAGACTA	TAAGGTCCG.TAGAGACTA
TAAGGTCCG.TCCTCTAGT	TAAGGTCCG.TCCTCTAGT
TAAGGTCCG.TGATAGAGG	TAAGGTCCG.TGATAGAGG
TAAGGTGAT.AGTGATGCG	TAAGGTGAT.AGTGATGCG
TAAGGTGAT.TAATTCGTG	TAAGGTGAT.TAATTCGTG
TAAGGTGAT.TATACGTGG	TAAGGTGAT.TATACGTGG
TAAGTACAC.CACGTAGAC	TAAGTACAC.CACGTAGAC
TAAGTACAC.CGACGTACG	TAAGTACAC.CGACGTACG
TAAGTACAC.GCTAGTGGA	TAAGTACAC.GCTAGTGGA
TAAGTACAC.TGAACTTGC	TAAGTACAC.TGAACTTGC
TAAGTACAC.TTGCGAACA	TAAGTACAC.TTGCGAACA
TAAGTGTAG.ACATGGATT	TAAGTGTAG.ACATGGATT
TAAGTGTAG.CCTGACCTC	TAAGTGTAG.CCTGACCTC
TAAGTGTAG.GCTGATGTC	TAAGTGTAG.GCTGATGTC
TAAGTGTAG.GTTCCAACA	TAAGTGTAG.GTTCCAACA
TAATCACGC.AATACTCCG	TAATCACGC.AATACTCCG
TAATCACGC.ATTCGAAGA	TAATCACGC.ATTCGAAGA
TAATCACGC.CGACCTGTA	TAATCACGC.CGACCTGTA
TAATCACGC.CTTATCTCA	TAATCACGC.CTTATCTCA
TAATCACGC.GATTAGACA	TAATCACGC.GATTAGACA
TAATCACGC.TACATGCAC	TAATCACGC.TACATGCAC
TAATCACGC.TTAAGTGGT	TAATCACGC.TTAAGTGGT
TAATCTGGA.ACCGTACGC	TAATCTGGA.ACCGTACGC
TAATCTGGA.AGGTATTCC	TAATCTGGA.AGGTATTCC
TAATCTGGA.ATGTGACGA	TAATCTGGA.ATGTGACGA
TAATCTGGA.CAGCCGCAA	TAATCTGGA.CAGCCGCAA
TAATCTGGA.CTCATTAGT	TAATCTGGA.CTCATTAGT
TAATCTGGA.GCCACGAGT	TAATCTGGA.GCCACGAGT
TAATCTGGA.GTGTCACAC	TAATCTGGA.GTGTCACAC
TAATCTGGA.TCCTGAGAC	TAATCTGGA.TCCTGAGAC
TAATCTGGA.TGCCAATGG	TAATCTGGA.TGCCAATGG
TAATCTGGA.TTCCATACC	TAATCTGGA.TTCCATACC
TAATGTAGC.ACTCCAACT	TAATGTAGC.ACTCCAACT
TAATGTAGC.GAACTGCAA	TAATGTAGC.GAACTGCAA
TAATGTAGC.GGTGATAGG	TAATGTAGC.GGTGATAGG
TAATGTAGC.TAGGAGGAT	TAATGTAGC.TAGGAGGAT
TAATTCGTG.AGAGCGGAG	TAATTCGTG.AGAGCGGAG
TAATTCGTG.GACTAGCAT	TAATTCGTG.GACTAGCAT
TAATTCGTG.GATTCCTCT	TAATTCGTG.GATTCCTCT
TAATTCGTG.GCGTATAGG	TAATTCGTG.GCGTATAGG
TAATTCGTG.TACAGGACT	TAATTCGTG.TACAGGACT
TAATTCGTG.TGCTCAGCG	TAATTCGTG.TGCTCAGCG
TACAACACC.ACAACGAGC	TACAACACC.ACAACGAGC
