ACTTCGCAG.TTAACGTTC	ACTTCGCAG.TTAACGTTC
ACTTCTAAC.ACGCTAGTG	ACTTCTAAC.ACGCTAGTG
ACTTCTAAC.ATGTCGCCT	ACTTCTAAC.ATGTCGCCT
ACTTCTAAC.CACGGAAGT	ACTTCTAAC.CACGGAAGT
ACTTCTAAC.CCGATGTTC	ACTTCTAAC.CCGATGTTC
ACTTCTAAC.CGGATTCTC	ACTTCTAAC.CGGATTCTC
ACTTCTAAC.GGTTGAAGG	ACTTCTAAC.GGTTGAAGG
ACTTCTAAC.GTACGCGAT	ACTTCTAAC.GTACGCGAT
ACTTCTAAC.GTCGTGTTA	ACTTCTAAC.GTCGTGTTA
ACTTCTAAC.GTGACTCTC	ACTTCTAAC.GTGACTCTC
ACTTCTTGG.AAGCCAAGT	ACTTCTTGG.AAGCCAAGT
ACTTCTTGG.ACACGTTGC	ACTTCTTGG.ACACGTTGC
ACTTCTTGG.ATCCACAGT	ACTTCTTGG.ATCCACAGT
ACTTCTTGG.CGCTTGTAG	ACTTCTTGG.CGCTTGTAG
ACTTGATCT.CATTATGTC	ACTTGATCT.CATTATGTC
ACTTGATCT.TATTACAGC	ACTTGATCT.TATTACAGC
ACTTGATCT.TGTGCCATG	ACTTGATCT.TGTGCCATG
AGAAGAGTC.ACGCTATGT	AGAAGAGTC.ACGCTATGT
AGAAGAGTC.CTGAGATAG	AGAAGAGTC.CTGAGATAG
AGAAGAGTC.GCAATCACG	AGAAGAGTC.GCAATCACG
AGAAGAGTC.TCGGACAGT	AGAAGAGTC.TCGGACAGT
AGAAGAGTC.TGCAACTCT	AGAAGAGTC.TGCAACTCT
AGAAGCTGC.CATCGAAGC	AGAAGCTGC.CATCGAAGC
AGAAGCTGC.GGTCTTGCA	AGAAGCTGC.GGTCTTGCA
AGAAGTAAC.ACCTGCAGA	AGAAGTAAC.ACCTGCAGA
AGAAGTAAC.AGGTCCGTC	AGAAGTAAC.AGGTCCGTC
AGAAGTAAC.CACACCACA	AGAAGTAAC.CACACCACA
AGAAGTAAC.CCGATGTTC	AGAAGTAAC.CCGATGTTC
AGAAGTAAC.TCAATCTAG	AGAAGTAAC.TCAATCTAG
AGAAGTAAC.TGATGGACA	AGAAGTAAC.TGATGGACA
AGAAGTCCT.CACAACCAG	AGAAGTCCT.CACAACCAG
AGAAGTCCT.GGTGAGTTC	AGAAGTCCT.GGTGAGTTC
AGAAGTCCT.TATACGTGG	AGAAGTCCT.TATACGTGG
AGAAGTCCT.TGTAGGTTA	AGAAGTCCT.TGTAGGTTA
AGAATCAGA.ACAACCGGA	AGAATCAGA.ACAACCGGA
AGAATCAGA.TCTACATCC	AGAATCAGA.TCTACATCC
AGACATATC.ACGACGATT	AGACATATC.ACGACGATT
AGACATATC.CGCGATGTA	AGACATATC.CGCGATGTA
AGACATATC.CTACGGTAT	AGACATATC.CTACGGTAT
AGACATATC.CTGTGCTCA	AGACATATC.CTGTGCTCA
AGACATATC.GAGATTCCT	AGACATATC.GAGATTCCT
AGACATATC.GGTCTTGCA	AGACATATC.GGTCTTGCA
AGACATATC.GTAGAGAGC	AGACATATC.GTAGAGAGC
AGACATATC.GTAGTGGAG	AGACATATC.GTAGTGGAG
AGACATATC.TGACCAAGT	AGACATATC.TGACCAAGT
AGACATATC.TGCAGCCTT	AGACATATC.TGCAGCCTT
AGACATCCA.ACGAGAGCA	AGACATCCA.ACGAGAGCA
AGACATCCA.AGCACCGTG	AGACATCCA.AGCACCGTG
AGACATCCA.AGTTAGGTC	AGACATCCA.AGTTAGGTC
AGACATCCA.CCTCAGGTG	AGACATCCA.CCTCAGGTG
AGACATCCA.GATGCGACG	AGACATCCA.GATGCGACG
AGACATCCA.GGAGAATGA	AGACATCCA.GGAGAATGA
AGACATCCA.TAGAGCCAG	AGACATCCA.TAGAGCCAG
AGACATCCA.TTGGAGAAC	AGACATCCA.TTGGAGAAC
AGACCACGC.GCCACGAGT	AGACCACGC.GCCACGAGT
AGACCACGC.GCCATTAAG	AGACCACGC.GCCATTAAG
AGACCACGC.GTATGTATC	AGACCACGC.GTATGTATC
AGACCAGCT.CATGTCCTG	AGACCAGCT.CATGTCCTG
AGACCAGCT.GTCTCTTCA	AGACCAGCT.GTCTCTTCA
AGACCAGCT.TGCGACGTT	AGACCAGCT.TGCGACGTT
AGACGCCTG.AATCTCCTA	AGACGCCTG.AATCTCCTA
AGACGCCTG.ACTTCTTGG	AGACGCCTG.ACTTCTTGG
AGACGCCTG.AGGTCACGT	AGACGCCTG.AGGTCACGT
AGACGCCTG.ATATCCGAT	AGACGCCTG.ATATCCGAT
AGACGCCTG.ATGAGATCC	AGACGCCTG.ATGAGATCC
AGACGCCTG.ATGCGCCGT	AGACGCCTG.ATGCGCCGT
AGACGCCTG.CAGATCGAC	AGACGCCTG.CAGATCGAC
AGACGCCTG.CTATCCATC	AGACGCCTG.CTATCCATC
AGACGCCTG.TGGAACTAA	AGACGCCTG.TGGAACTAA
AGACGCTAT.AGACTTCGT	AGACGCTAT.AGACTTCGT
AGACGCTAT.ATCCGGTCC	AGACGCTAT.ATCCGGTCC
AGACGCTAT.CCTCGGTCA	AGACGCTAT.CCTCGGTCA
AGACGCTAT.CTTCTCATC	AGACGCTAT.CTTCTCATC
AGACGCTAT.GTCCTTCAT	AGACGCTAT.GTCCTTCAT
AGACGCTAT.GTGCTAAGC	AGACGCTAT.GTGCTAAGC
AGACGCTAT.TCACGACAA	AGACGCTAT.TCACGACAA
AGACGCTAT.TGCGATACT	AGACGCTAT.TGCGATACT
AGACGCTAT.TTCGTGATG	AGACGCTAT.TTCGTGATG
AGACGGAGG.CTGTCTAGT	AGACGGAGG.CTGTCTAGT
AGACGGAGG.CTTAAGTTG	AGACGGAGG.CTTAAGTTG
AGACTAGTA.CCGAGTACT	AGACTAGTA.CCGAGTACT
AGACTAGTA.CCTGTTAGC	AGACTAGTA.CCTGTTAGC
AGACTAGTA.GACCGTAGT	AGACTAGTA.GACCGTAGT
AGACTAGTA.GTAGTGGAG	AGACTAGTA.GTAGTGGAG
AGACTAGTA.GTTGCATGG	AGACTAGTA.GTTGCATGG
AGACTAGTA.TCGTGACGT	AGACTAGTA.TCGTGACGT
AGACTAGTA.TGATGGACA	AGACTAGTA.TGATGGACA
AGACTAGTA.TTCCAGGAG	AGACTAGTA.TTCCAGGAG
AGACTAGTA.TTCCGAGCG	AGACTAGTA.TTCCGAGCG
AGACTTCGT.ACCGTACGC	AGACTTCGT.ACCGTACGC
AGACTTCGT.AGTGTTCTG	AGACTTCGT.AGTGTTCTG
AGACTTCGT.ATGATAGCT	AGACTTCGT.ATGATAGCT
AGACTTCGT.TGTCAACCT	AGACTTCGT.TGTCAACCT
AGAGCCGCA.AGATGTTGG	AGAGCCGCA.AGATGTTGG
AGAGCCGCA.AGCACCGTG	AGAGCCGCA.AGCACCGTG
AGAGCCGCA.AGCGGAACA	AGAGCCGCA.AGCGGAACA
AGAGCCGCA.CAAGTCGAA	AGAGCCGCA.CAAGTCGAA
AGAGCCGCA.CACGATAGA	AGAGCCGCA.CACGATAGA
AGAGCCGCA.CACTGTATC	AGAGCCGCA.CACTGTATC
AGAGCCGCA.CCGACTGTT	AGAGCCGCA.CCGACTGTT
AGAGCCGCA.CTACGAGAA	AGAGCCGCA.CTACGAGAA
AGAGCCGCA.GCTCAGCCA	AGAGCCGCA.GCTCAGCCA
AGAGCCGCA.TAACTCCGA	AGAGCCGCA.TAACTCCGA
AGAGCCGCA.TACGGTCGT	AGAGCCGCA.TACGGTCGT
AGAGCCGCA.TCTCGTATC	AGAGCCGCA.TCTCGTATC
AGAGCCGCA.TGGAGAACC	AGAGCCGCA.TGGAGAACC
AGAGCCGCA.TTAACGTTC	AGAGCCGCA.TTAACGTTC
AGAGCGCGA.AATGTGCGT	AGAGCGCGA.AATGTGCGT
AGAGCGCGA.ACTCATTCA	AGAGCGCGA.ACTCATTCA
AGAGCGCGA.GTAGGACGC	AGAGCGCGA.GTAGGACGC
AGAGCGCGA.TCCTCGTCG	AGAGCGCGA.TCCTCGTCG
AGAGCGCGA.TCCTTAGGT	AGAGCGCGA.TCCTTAGGT
AGAGCGCGA.TGTCGTACA	AGAGCGCGA.TGTCGTACA
AGAGCGGAG.AGCATTCCA	AGAGCGGAG.AGCATTCCA
AGAGCGGAG.AGCCACTTC	AGAGCGGAG.AGCCACTTC
AGAGCGGAG.CCTTGTTGC	AGAGCGGAG.CCTTGTTGC
AGAGCGGAG.GCAGATCCG	AGAGCGGAG.GCAGATCCG
AGAGCGGAG.GCTCAATGA	AGAGCGGAG.GCTCAATGA
AGAGCGGAG.TCGCATTCG	AGAGCGGAG.TCGCATTCG
AGAGCGGAG.TTCTCCACA	AGAGCGGAG.TTCTCCACA
AGAGGACGT.ACCATACTT	AGAGGACGT.ACCATACTT
AGAGGACGT.ATAACGACA	AGAGGACGT.ATAACGACA
AGAGGACGT.ATCTACATC	AGAGGACGT.ATCTACATC
AGAGGACGT.CATAAGATC	AGAGGACGT.CATAAGATC
AGAGGACGT.CCTCAGGTG	AGAGGACGT.CCTCAGGTG
AGAGGACGT.GTTAATTCG	AGAGGACGT.GTTAATTCG
AGAGGACGT.TAGCACTAT	AGAGGACGT.TAGCACTAT
AGAGGACGT.TAGTGCACT	AGAGGACGT.TAGTGCACT
AGAGGTGAA.ACACACCGT	AGAGGTGAA.ACACACCGT
AGAGGTGAA.ACAGAAGAG	AGAGGTGAA.ACAGAAGAG
AGAGGTGAA.CCGTTAGAC	AGAGGTGAA.CCGTTAGAC
AGAGGTGAA.CGACAGACC	AGAGGTGAA.CGACAGACC
AGAGGTGAA.CGGACAAGT	AGAGGTGAA.CGGACAAGT
AGAGGTGAA.GGTCGGTCT	AGAGGTGAA.GGTCGGTCT
AGAGGTGAA.GTAGCATAC	AGAGGTGAA.GTAGCATAC
AGATACGTT.ACCATACTT	AGATACGTT.ACCATACTT
AGATACGTT.ATCTCGAAC	AGATACGTT.ATCTCGAAC
AGATACGTT.CAGAGCACC	AGATACGTT.CAGAGCACC
AGATACGTT.CAGCACGTG	AGATACGTT.CAGCACGTG
AGATACGTT.CGGATTCTC	AGATACGTT.CGGATTCTC
AGATACGTT.GTAGAGAGC	AGATACGTT.GTAGAGAGC
AGATACGTT.GTGTCCGTG	AGATACGTT.GTGTCCGTG
AGATACGTT.TATACCACT	AGATACGTT.TATACCACT
AGATACGTT.TATACGTGG	AGATACGTT.TATACGTGG
AGATACGTT.TATCAGTGC	AGATACGTT.TATCAGTGC
AGATACGTT.TATTACAGC	AGATACGTT.TATTACAGC
AGATACGTT.TCCTTAGGT	AGATACGTT.TCCTTAGGT
AGATACGTT.TCGATTCAG	AGATACGTT.TCGATTCAG
AGATACGTT.TGTCGTACA	AGATACGTT.TGTCGTACA
AGATACGTT.TGTGCCATG	AGATACGTT.TGTGCCATG
AGATATGGA.AAGCTGGTC	AGATATGGA.AAGCTGGTC
AGATATGGA.AGTGTCTCT	AGATATGGA.AGTGTCTCT
AGATATGGA.CAACGATCG	AGATATGGA.CAACGATCG
AGATATGGA.CCAGTTACG	AGATATGGA.CCAGTTACG
AGATCGAGT.ACCGGAGTA	AGATCGAGT.ACCGGAGTA
AGATCGAGT.CAAGTACGA	AGATCGAGT.CAAGTACGA
AGATCGAGT.CTATACTAG	AGATCGAGT.CTATACTAG
AGATCGAGT.GAACTCGTA	AGATCGAGT.GAACTCGTA
AGATCGAGT.TCGAATAGA	AGATCGAGT.TCGAATAGA
AGATCTGAC.ACCATTCAC	AGATCTGAC.ACCATTCAC
AGATCTGAC.AGCATTGTT	AGATCTGAC.AGCATTGTT
AGATCTGAC.ATAATGTGG	AGATCTGAC.ATAATGTGG
AGATCTGAC.ATGAGATCC	AGATCTGAC.ATGAGATCC
AGATCTGAC.CGCATAACT	AGATCTGAC.CGCATAACT
AGATCTGAC.GTAACCATA	AGATCTGAC.GTAACCATA
AGATCTGAC.TATTCAACG	AGATCTGAC.TATTCAACG
AGATCTGAC.TTACTAGTC	AGATCTGAC.TTACTAGTC
AGATCTTCA.CAGCCGCAA	AGATCTTCA.CAGCCGCAA
AGATCTTCA.CATCGAAGC	AGATCTTCA.CATCGAAGC
AGATCTTCA.CGTATTCCT	AGATCTTCA.CGTATTCCT
AGATCTTCA.GTGGAGGTC	AGATCTTCA.GTGGAGGTC
AGATCTTCA.GTGTACCGT	AGATCTTCA.GTGTACCGT
AGATCTTCA.TAGCGAGAA	AGATCTTCA.TAGCGAGAA
AGATGAAGA.AGAAGAGTC	AGATGAAGA.AGAAGAGTC
AGATGAAGA.CAGGAGCCT	AGATGAAGA.CAGGAGCCT
AGATGAAGA.TGAACTTGC	AGATGAAGA.TGAACTTGC
AGATGAGAT.ACGCGTGAC	AGATGAGAT.ACGCGTGAC
AGATGAGAT.CCTGCGTTA	AGATGAGAT.CCTGCGTTA
AGATGAGAT.CTGCGTCAC	AGATGAGAT.CTGCGTCAC
AGATGAGAT.GCGACCTGT	AGATGAGAT.GCGACCTGT
AGATGAGAT.GCTGTTCGG	AGATGAGAT.GCTGTTCGG
AGATGAGAT.TAGTAACGG	AGATGAGAT.TAGTAACGG
AGATGAGAT.TATGACCGA	AGATGAGAT.TATGACCGA
AGATGAGAT.TCTAGGATG	AGATGAGAT.TCTAGGATG
AGATGAGAT.TGGTGGATC	AGATGAGAT.TGGTGGATC
AGATGAGAT.TTCTGAATG	AGATGAGAT.TTCTGAATG
AGATGTTGG.ACCGGAGTA	AGATGTTGG.ACCGGAGTA
AGATGTTGG.AGATGAGAT	AGATGTTGG.AGATGAGAT
AGATGTTGG.CCACATTAG	AGATGTTGG.CCACATTAG
AGATGTTGG.GAACGCTGT	AGATGTTGG.GAACGCTGT
AGATGTTGG.GCAGCAGTG	AGATGTTGG.GCAGCAGTG
AGATGTTGG.TGGAACTAA	AGATGTTGG.TGGAACTAA
AGCAACATT.AATCAGGAG	AGCAACATT.AATCAGGAG
AGCAACATT.AGCCGGATC	AGCAACATT.AGCCGGATC
AGCAACATT.CTGGACTAA	AGCAACATT.CTGGACTAA
AGCAACATT.TCCACCTCA	AGCAACATT.TCCACCTCA
AGCAAGTCC.AAGCCACAC	AGCAAGTCC.AAGCCACAC
AGCAAGTCC.AATGCCTCA	AGCAAGTCC.AATGCCTCA
AGCAAGTCC.TCCAGAACG	AGCAAGTCC.TCCAGAACG
AGCAAGTCC.TGACCAAGT	AGCAAGTCC.TGACCAAGT
AGCAAGTCC.TTCCGCCAG	AGCAAGTCC.TTCCGCCAG
AGCACACCT.AACTAACTG	AGCACACCT.AACTAACTG
AGCACACCT.ACAAGTACA	AGCACACCT.ACAAGTACA
AGCACACCT.GACTTGATT	AGCACACCT.GACTTGATT
AGCACACCT.GTATGCCTT	AGCACACCT.GTATGCCTT
AGCACACCT.TAAGGTCCG	AGCACACCT.TAAGGTCCG
AGCACACCT.TCTAGTGAC	AGCACACCT.TCTAGTGAC
AGCACCAGC.ACTGCTAGT	AGCACCAGC.ACTGCTAGT
AGCACCAGC.CCGCAGCTA	AGCACCAGC.CCGCAGCTA
AGCACCAGC.CCGGTTCTA	AGCACCAGC.CCGGTTCTA
AGCACCAGC.CGCATCTAC	AGCACCAGC.CGCATCTAC
AGCACCAGC.CTTATTGAG	AGCACCAGC.CTTATTGAG
AGCACCAGC.GCATTGATC	AGCACCAGC.GCATTGATC
AGCACCAGC.GTCTTATGC	AGCACCAGC.GTCTTATGC
AGCACCAGC.TAACACGAG	AGCACCAGC.TAACACGAG
AGCACCAGC.TGTTACTGA	AGCACCAGC.TGTTACTGA
AGCACCGTG.CAGATCGAC	AGCACCGTG.CAGATCGAC
AGCACCGTG.CTAGAGTCG	AGCACCGTG.CTAGAGTCG
AGCACCGTG.CTCTACGCA	AGCACCGTG.CTCTACGCA
AGCACCGTG.CTTCCGGTA	AGCACCGTG.CTTCCGGTA
AGCACCGTG.GGTCGGTCT	AGCACCGTG.GGTCGGTCT
AGCAGACAA.AGATCTTCA	AGCAGACAA.AGATCTTCA
AGCAGACAA.AGTCTAAGC	AGCAGACAA.AGTCTAAGC
AGCAGACAA.CGACCTGTA	AGCAGACAA.CGACCTGTA
AGCAGACAA.CTAGACATG	AGCAGACAA.CTAGACATG
AGCAGACAA.CTGTAGAAG	AGCAGACAA.CTGTAGAAG
AGCAGACAA.GTGTTCCAG	AGCAGACAA.GTGTTCCAG
AGCAGACAA.TACAGGACT	AGCAGACAA.TACAGGACT
AGCAGACAA.TATGGTTGG	AGCAGACAA.TATGGTTGG
AGCAGACAA.TTAACGGAG	AGCAGACAA.TTAACGGAG
AGCAGACAA.TTACGCTCG	AGCAGACAA.TTACGCTCG
AGCAGACAA.TTGTATCAC	AGCAGACAA.TTGTATCAC
AGCATATGG.GGACACTGG	AGCATATGG.GGACACTGG
AGCATATGG.TGGAGTGGA	AGCATATGG.TGGAGTGGA
AGCATTCCA.ATCAGTCGA	AGCATTCCA.ATCAGTCGA
AGCATTCCA.CCTGTTAGC	AGCATTCCA.CCTGTTAGC
AGCATTCCA.CTCGCTACG	AGCATTCCA.CTCGCTACG
AGCATTCCA.CTCTAAGAG	AGCATTCCA.CTCTAAGAG
AGCATTCCA.CTGCTGCTT	AGCATTCCA.CTGCTGCTT
AGCATTGTT.AACTCCATG	AGCATTGTT.AACTCCATG
AGCATTGTT.ACCATGTCT	AGCATTGTT.ACCATGTCT
AGCATTGTT.CTAGAGGTA	AGCATTGTT.CTAGAGGTA
AGCATTGTT.CTCGAACTG	AGCATTGTT.CTCGAACTG
AGCATTGTT.CTGTACGAC	AGCATTGTT.CTGTACGAC
AGCATTGTT.GACACCGAT	AGCATTGTT.GACACCGAT
AGCATTGTT.TGATGTGTG	AGCATTGTT.TGATGTGTG
AGCCACTTC.ACGTACTGC	AGCCACTTC.ACGTACTGC
AGCCACTTC.TACAACACC	AGCCACTTC.TACAACACC
AGCCACTTC.TCGTAGGAA	AGCCACTTC.TCGTAGGAA
AGCCAGGAC.ACTCTCACA	AGCCAGGAC.ACTCTCACA
AGCCAGGAC.AGCACCGTG	AGCCAGGAC.AGCACCGTG
AGCCAGGAC.ATCCGGTCC	AGCCAGGAC.ATCCGGTCC
AGCCAGGAC.CAATCAAGT	AGCCAGGAC.CAATCAAGT
AGCCAGGAC.CATCCACCG	AGCCAGGAC.CATCCACCG
AGCCAGGAC.GCACGCATT	AGCCAGGAC.GCACGCATT
AGCCAGGAC.GGTTGCTAT	AGCCAGGAC.GGTTGCTAT
AGCCAGGAC.GTCGTCGAC	AGCCAGGAC.GTCGTCGAC
AGCCGGATC.CATAGTATG	AGCCGGATC.CATAGTATG
AGCCGTTCT.ACCGACGGT	AGCCGTTCT.ACCGACGGT
AGCCGTTCT.CAAGTCACT	AGCCGTTCT.CAAGTCACT
AGCCGTTCT.GCTATGTAA	AGCCGTTCT.GCTATGTAA
AGCCGTTCT.GTTAGTCAA	AGCCGTTCT.GTTAGTCAA
AGCCGTTCT.TTGCTCTGC	AGCCGTTCT.TTGCTCTGC
AGCCTCGCA.ATCAGTCGA	AGCCTCGCA.ATCAGTCGA
AGCCTCGCA.CGTCTGTCC	AGCCTCGCA.CGTCTGTCC
AGCCTCGCA.GTAACCATA	AGCCTCGCA.GTAACCATA
AGCCTCTAG.AGATGTTGG	AGCCTCTAG.AGATGTTGG
AGCCTCTAG.CATAATTGG	AGCCTCTAG.CATAATTGG
AGCCTCTAG.GCGCTCTAT	AGCCTCTAG.GCGCTCTAT
AGCCTCTAG.GGATAATAC	AGCCTCTAG.GGATAATAC
AGCCTCTAG.TATCATGCT	AGCCTCTAG.TATCATGCT
AGCCTCTAG.TTGGACTTC	AGCCTCTAG.TTGGACTTC
AGCGACACC.CGCATCTAC	AGCGACACC.CGCATCTAC
AGCGACACC.GAATCGAGA	AGCGACACC.GAATCGAGA
AGCGACACC.TCTACGCAA	AGCGACACC.TCTACGCAA
AGCGACACC.TGGTAGCAG	AGCGACACC.TGGTAGCAG
AGCGCATGA.AGTACTCTC	AGCGCATGA.AGTACTCTC
AGCGCATGA.ATACCGAAG	AGCGCATGA.ATACCGAAG
AGCGGAACA.AAGTTCTCT	AGCGGAACA.AAGTTCTCT
AGCGGAACA.ATCATAGAC	AGCGGAACA.ATCATAGAC
AGCGGAACA.ATCTGGTAG	AGCGGAACA.ATCTGGTAG
AGCGGAACA.CACATTCTG	AGCGGAACA.CACATTCTG
AGCGGAACA.CACGATAGA	AGCGGAACA.CACGATAGA
AGCGGAACA.CTTCCGTGG	AGCGGAACA.CTTCCGTGG
AGCGGAACA.GAGACTCGA	AGCGGAACA.GAGACTCGA
AGCGGAACA.TGAACGGTT	AGCGGAACA.TGAACGGTT
AGCGGAACA.TGCCATCTC	AGCGGAACA.TGCCATCTC
AGCGGAACA.TGCGCACTG	AGCGGAACA.TGCGCACTG
AGCGGAACA.TTAACGGAG	AGCGGAACA.TTAACGGAG
AGCGGTAAG.AGACGGAGG	AGCGGTAAG.AGACGGAGG
AGCGGTAAG.GGTAGCATC	AGCGGTAAG.GGTAGCATC
AGCGGTAAG.TCCTATTCC	AGCGGTAAG.TCCTATTCC
AGCGGTCTA.CAGCCGCAA	AGCGGTCTA.CAGCCGCAA
AGCGGTCTA.CCACCATGC	AGCGGTCTA.CCACCATGC
AGCGGTCTA.CCTGTCATT	AGCGGTCTA.CCTGTCATT
AGCGGTCTA.GTTGCTCAG	AGCGGTCTA.GTTGCTCAG
AGCGTAGAA.AACAACCTA	AGCGTAGAA.AACAACCTA
AGCGTAGAA.AGTAATCAG	AGCGTAGAA.AGTAATCAG
AGCGTCGTC.ACCTGTACC	AGCGTCGTC.ACCTGTACC
AGCGTCGTC.ACGCGTGAC	AGCGTCGTC.ACGCGTGAC
AGCGTCGTC.CATCCGACA	AGCGTCGTC.CATCCGACA
AGCGTCGTC.CCGTCCACT	AGCGTCGTC.CCGTCCACT
AGCGTCGTC.TTACGCTCG	AGCGTCGTC.TTACGCTCG
AGCTACTCA.ATTCGCTTA	AGCTACTCA.ATTCGCTTA
AGCTACTCA.CTGATCAAG	AGCTACTCA.CTGATCAAG
AGCTACTCA.CTGGAGCGA	AGCTACTCA.CTGGAGCGA
AGCTACTCA.GGACACTGG	AGCTACTCA.GGACACTGG
AGCTACTCA.GTGAACCAC	AGCTACTCA.GTGAACCAC
AGCTACTCA.TATGCCTTC	AGCTACTCA.TATGCCTTC
AGCTACTCA.TGGTCTACG	AGCTACTCA.TGGTCTACG
AGCTATATG.AGTTAGGTC	AGCTATATG.AGTTAGGTC
AGCTATATG.ATCTCTGCT	AGCTATATG.ATCTCTGCT
AGCTATATG.CCATTACAG	AGCTATATG.CCATTACAG
AGCTATATG.CTGGTGACA	AGCTATATG.CTGGTGACA
AGCTCGTCT.ACAGCGTAT	AGCTCGTCT.ACAGCGTAT
AGCTCGTCT.CATCCGACA	AGCTCGTCT.CATCCGACA
AGCTCGTCT.CATCGAAGC	AGCTCGTCT.CATCGAAGC
AGCTCGTCT.CTGCTTAGG	AGCTCGTCT.CTGCTTAGG
AGCTCGTCT.CTTACCTAG	AGCTCGTCT.CTTACCTAG
AGCTCGTCT.TAGTCAGAC	AGCTCGTCT.TAGTCAGAC
AGCTCTCCG.ACCGTACGC	AGCTCTCCG.ACCGTACGC
AGCTCTCCG.CATGGTTAC	AGCTCTCCG.CATGGTTAC
AGCTCTCCG.GAGCAGGAA	AGCTCTCCG.GAGCAGGAA
AGCTCTCCG.TACCAGCCA	AGCTCTCCG.TACCAGCCA
AGCTCTCCG.TCAGGTGCA	AGCTCTCCG.TCAGGTGCA
AGCTCTCCG.TGTGGTCCT	AGCTCTCCG.TGTGGTCCT
AGCTGCACT.AACAACCTA	AGCTGCACT.AACAACCTA
AGCTGCACT.ACAAGAATG	AGCTGCACT.ACAAGAATG
AGCTGCACT.ACACAGAAC	AGCTGCACT.ACACAGAAC
AGCTGCACT.CCGAGCTGA	AGCTGCACT.CCGAGCTGA
AGCTGCACT.CCGATCTCT	AGCTGCACT.CCGATCTCT
AGCTGCACT.CTGAGTCCA	AGCTGCACT.CTGAGTCCA
AGCTTCGAT.ATGGATATC	AGCTTCGAT.ATGGATATC
AGCTTCGAT.CAGGTTGTC	AGCTTCGAT.CAGGTTGTC
AGCTTCGAT.CGTGAGACT	AGCTTCGAT.CGTGAGACT
AGCTTCGAT.CTACGTTGG	AGCTTCGAT.CTACGTTGG
AGCTTCGAT.GATACACTA	AGCTTCGAT.GATACACTA
AGCTTCGAT.TTCATCCAA	AGCTTCGAT.TTCATCCAA
AGCTTGGTG.ACGCAAGAT	AGCTTGGTG.ACGCAAGAT
AGCTTGGTG.ACTACCATC	AGCTTGGTG.ACTACCATC
AGCTTGGTG.AGACGCTAT	AGCTTGGTG.AGACGCTAT
AGCTTGGTG.CAAGTCACT	AGCTTGGTG.CAAGTCACT
AGCTTGGTG.CTAGACATG	AGCTTGGTG.CTAGACATG
AGCTTGGTG.GAATCAACC	AGCTTGGTG.GAATCAACC
AGCTTGGTG.GCCGTGAAC	AGCTTGGTG.GCCGTGAAC
AGCTTGGTG.GTCCTAGTT	AGCTTGGTG.GTCCTAGTT
AGCTTGGTG.TTACAGTGT	AGCTTGGTG.TTACAGTGT
AGCTTGGTG.TTAGATCGG	AGCTTGGTG.TTAGATCGG
AGGAAGGTG.AGGAATTGG	AGGAAGGTG.AGGAATTGG
AGGAAGGTG.AGGTATTCC	AGGAAGGTG.AGGTATTCC
AGGAAGGTG.CAGCTAGTT	AGGAAGGTG.CAGCTAGTT
AGGAAGGTG.GTTCACTCC	AGGAAGGTG.GTTCACTCC
AGGAATTGG.AGGAATTGG	AGGAATTGG.AGGAATTGG
AGGAATTGG.AGGATTGAG	AGGAATTGG.AGGATTGAG
AGGAATTGG.ATCTCGAAC	AGGAATTGG.ATCTCGAAC
AGGAATTGG.GATCTGTTC	AGGAATTGG.GATCTGTTC
AGGAATTGG.GCTGACAGA	AGGAATTGG.GCTGACAGA
AGGAATTGG.GCTGATGTC	AGGAATTGG.GCTGATGTC
AGGAATTGG.GCTTACGTT	AGGAATTGG.GCTTACGTT
AGGAATTGG.GTCAAGATC	AGGAATTGG.GTCAAGATC
AGGAGCAAT.ACCACTAGG	AGGAGCAAT.ACCACTAGG
AGGAGCAAT.CAGAGCACC	AGGAGCAAT.CAGAGCACC
AGGAGCAAT.CGCGTACTA	AGGAGCAAT.CGCGTACTA
AGGAGCAAT.CGGAGACTT	AGGAGCAAT.CGGAGACTT
AGGAGCAAT.CTGTTACCA	AGGAGCAAT.CTGTTACCA
AGGAGCAAT.TAGTCAGAC	AGGAGCAAT.TAGTCAGAC
AGGAGCAAT.TTCCATACC	AGGAGCAAT.TTCCATACC
AGGAGGTGA.AGTTAGGTC	AGGAGGTGA.AGTTAGGTC
AGGAGGTGA.CAAGTCACT	AGGAGGTGA.CAAGTCACT
AGGAGGTGA.CGTATAGCG	AGGAGGTGA.CGTATAGCG
AGGAGGTGA.GTGCCATGA	AGGAGGTGA.GTGCCATGA
AGGAGGTGA.TACAAGAGG	AGGAGGTGA.TACAAGAGG
AGGATCATG.CAAGCCTCG	AGGATCATG.CAAGCCTCG
AGGATCATG.CGCAACCTC	AGGATCATG.CGCAACCTC
AGGATCATG.CTAGTTCCA	AGGATCATG.CTAGTTCCA
AGGATCATG.GCATTGATC	AGGATCATG.GCATTGATC
AGGATCTCA.AACTTCTGC	AGGATCTCA.AACTTCTGC
AGGATCTCA.AGGATGCGT	AGGATCTCA.AGGATGCGT
AGGATCTCA.GCTACAATG	AGGATCTCA.GCTACAATG
AGGATCTCA.TAGCGAGAA	AGGATCTCA.TAGCGAGAA
AGGATCTCA.TGTCAACCT	AGGATCTCA.TGTCAACCT
AGGATGCGT.ACGGTGTAC	AGGATGCGT.ACGGTGTAC
AGGATGCGT.ACTATTGTC	AGGATGCGT.ACTATTGTC
AGGATGCGT.GAACGCTGT	AGGATGCGT.GAACGCTGT
AGGATGCGT.GGTAACTAC	AGGATGCGT.GGTAACTAC
AGGATGCGT.TGCGTGCCA	AGGATGCGT.TGCGTGCCA
AGGATGCGT.TGTGGTCCT	AGGATGCGT.TGTGGTCCT
AGGATTACT.AGCCTCGCA	AGGATTACT.AGCCTCGCA
AGGATTACT.AGTGAACGG	AGGATTACT.AGTGAACGG
AGGATTACT.CACACCACA	AGGATTACT.CACACCACA
AGGATTACT.CATGTGAAC	AGGATTACT.CATGTGAAC
AGGATTACT.CTCGCAAGA	AGGATTACT.CTCGCAAGA
AGGATTACT.TAGTAGTCT	AGGATTACT.TAGTAGTCT
AGGATTGAG.AAGCCAAGT	AGGATTGAG.AAGCCAAGT
AGGATTGAG.ACCATTCAC	AGGATTGAG.ACCATTCAC
AGGATTGAG.AGTACTACA	AGGATTGAG.AGTACTACA
AGGATTGAG.CTGATGCAC	AGGATTGAG.CTGATGCAC
AGGATTGAG.GGTCGGTCT	AGGATTGAG.GGTCGGTCT
AGGTACCAA.ACAAGGTAC	AGGTACCAA.ACAAGGTAC
AGGTACCAA.ACTAACCGA	AGGTACCAA.ACTAACCGA
AGGTACCAA.AGCAGACAA	AGGTACCAA.AGCAGACAA
AGGTACCAA.AGGTGTACA	AGGTACCAA.AGGTGTACA
AGGTACCAA.TCGGATGTT	AGGTACCAA.TCGGATGTT
AGGTATTCC.ACAACGAGC	AGGTATTCC.ACAACGAGC
AGGTATTCC.ACTATCCTG	AGGTATTCC.ACTATCCTG
AGGTATTCC.ACTCTAGGA	AGGTATTCC.ACTCTAGGA
AGGTATTCC.ATCCATTAG	AGGTATTCC.ATCCATTAG
AGGTATTCC.CACGTAGAC	AGGTATTCC.CACGTAGAC
AGGTATTCC.CCTCGAGAG	AGGTATTCC.CCTCGAGAG
AGGTATTCC.GATTGGAAG	AGGTATTCC.GATTGGAAG
AGGTATTCC.GCGCTCTAT	AGGTATTCC.GCGCTCTAT
AGGTATTCC.GGTTCTATC	AGGTATTCC.GGTTCTATC
AGGTATTCC.TGACGGTTG	AGGTATTCC.TGACGGTTG
AGGTATTCC.TGTATCGTG	AGGTATTCC.TGTATCGTG
AGGTCACGT.CAGCTCTTC	AGGTCACGT.CAGCTCTTC
AGGTCACGT.TTAACGTTC	AGGTCACGT.TTAACGTTC
AGGTCAGCA.AATACGTCT	AGGTCAGCA.AATACGTCT
AGGTCAGCA.ACTCGTCTA	AGGTCAGCA.ACTCGTCTA
AGGTCAGCA.CACTACAGG	AGGTCAGCA.CACTACAGG
AGGTCAGCA.CCGACTGTT	AGGTCAGCA.CCGACTGTT
AGGTCAGCA.TCAGTGCAA	AGGTCAGCA.TCAGTGCAA
AGGTCAGCA.TGGAAGATT	AGGTCAGCA.TGGAAGATT
AGGTCCGTC.ACGAATCGC	AGGTCCGTC.ACGAATCGC
AGGTCCGTC.AGGATCATG	AGGTCCGTC.AGGATCATG
AGGTCCGTC.ATAGAGCAG	AGGTCCGTC.ATAGAGCAG
AGGTCCGTC.CAGCTCTTC	AGGTCCGTC.CAGCTCTTC
AGGTCCGTC.CCAATGCCT	AGGTCCGTC.CCAATGCCT
AGGTCCGTC.CCGTAGTTG	AGGTCCGTC.CCGTAGTTG
AGGTCCGTC.CCGTTAGAC	AGGTCCGTC.CCGTTAGAC
AGGTCCGTC.CCTTCGAGC	AGGTCCGTC.CCTTCGAGC
AGGTCCGTC.GCTTGTCCT	AGGTCCGTC.GCTTGTCCT
AGGTCCGTC.TGCGCACTG	AGGTCCGTC.TGCGCACTG
AGGTGCGAG.AATCTGACC	AGGTGCGAG.AATCTGACC
AGGTGCGAG.ACCGGTTAC	AGGTGCGAG.ACCGGTTAC
AGGTGCGAG.CATAGAGAT	AGGTGCGAG.CATAGAGAT
AGGTGCGAG.CCAGGAGTT	AGGTGCGAG.CCAGGAGTT
AGGTGCGAG.CGCTGTAGT	AGGTGCGAG.CGCTGTAGT
AGGTGTACA.ATGGAGGAA	AGGTGTACA.ATGGAGGAA
AGGTGTACA.CCAAGTCGA	AGGTGTACA.CCAAGTCGA
AGGTGTACA.TACCTCCTC	AGGTGTACA.TACCTCCTC
AGGTGTACA.TATAGTGCG	AGGTGTACA.TATAGTGCG
AGGTGTACA.TTGCCGTAG	AGGTGTACA.TTGCCGTAG
AGTAACGTA.AGATGTTGG	AGTAACGTA.AGATGTTGG
AGTAACGTA.CATCCACCG	AGTAACGTA.CATCCACCG
AGTAACGTA.CTAGGTACT	AGTAACGTA.CTAGGTACT
AGTAACGTA.CTGACGATG	AGTAACGTA.CTGACGATG
AGTAACGTA.GAGGTGAGC	AGTAACGTA.GAGGTGAGC
AGTAACGTA.GATCCGCAC	AGTAACGTA.GATCCGCAC
AGTAACGTA.GCTTGGTTC	AGTAACGTA.GCTTGGTTC
AGTAACGTA.GGAGAATGA	AGTAACGTA.GGAGAATGA
AGTAACGTA.GGATAATAC	AGTAACGTA.GGATAATAC
AGTAAGCCA.TGACCTATG	AGTAAGCCA.TGACCTATG
AGTAATCAG.AGCGTAGAA	AGTAATCAG.AGCGTAGAA
AGTAATCAG.CCATATCTT	AGTAATCAG.CCATATCTT
AGTAATCAG.CTAGAGTCG	AGTAATCAG.CTAGAGTCG
AGTAATCAG.GGACGAGCA	AGTAATCAG.GGACGAGCA
AGTAATCAG.TGTTGTCGA	AGTAATCAG.TGTTGTCGA
AGTAATGGT.CAAGAGAGT	AGTAATGGT.CAAGAGAGT
AGTAATGGT.TAGGAGGAT	AGTAATGGT.TAGGAGGAT
AGTAATGGT.TAGTCGCAT	AGTAATGGT.TAGTCGCAT
AGTAATGGT.TGCATCGGA	AGTAATGGT.TGCATCGGA
AGTACGAAT.AATGCAGCG	AGTACGAAT.AATGCAGCG
AGTACGAAT.AGCTCGTCT	AGTACGAAT.AGCTCGTCT
AGTACGAAT.ATACGAGGT	AGTACGAAT.ATACGAGGT
AGTACGAAT.ATCTCGAAC	AGTACGAAT.ATCTCGAAC
AGTACGAAT.GCGGTAGTC	AGTACGAAT.GCGGTAGTC
AGTACGAAT.GGTCCTAAG	AGTACGAAT.GGTCCTAAG
AGTACGAAT.GTCTTCATA	AGTACGAAT.GTCTTCATA
AGTACGAAT.TCAGGTGCA	AGTACGAAT.TCAGGTGCA
AGTACGAAT.TCGGTATCA	AGTACGAAT.TCGGTATCA
AGTACGAAT.TGAGTGACT	AGTACGAAT.TGAGTGACT
AGTACTACA.ACGCTATGT	AGTACTACA.ACGCTATGT
AGTACTACA.AGTAAGCCA	AGTACTACA.AGTAAGCCA
AGTACTACA.TCAGTAAGC	AGTACTACA.TCAGTAAGC
AGTACTCTC.ACGACATCT	AGTACTCTC.ACGACATCT
AGTACTCTC.ACGATGACC	AGTACTCTC.ACGATGACC
AGTACTCTC.ATCTTACAG	AGTACTCTC.ATCTTACAG
AGTACTCTC.GATATGGAC	AGTACTCTC.GATATGGAC
AGTACTCTC.GCCATACAA	AGTACTCTC.GCCATACAA
AGTACTCTC.GGTTGAAGG	AGTACTCTC.GGTTGAAGG
AGTACTCTC.GTCTCCAGG	AGTACTCTC.GTCTCCAGG
AGTACTCTC.TCCATCATT	AGTACTCTC.TCCATCATT
AGTACTCTC.TCGATTCAG	AGTACTCTC.TCGATTCAG
AGTAGAGGA.AGTACTCTC	AGTAGAGGA.AGTACTCTC
AGTAGAGGA.GGAGTTAGC	AGTAGAGGA.GGAGTTAGC
AGTAGAGGA.GGTTCTATC	AGTAGAGGA.GGTTCTATC
AGTATGACG.GATTATGCG	AGTATGACG.GATTATGCG
AGTATGACG.GTTGACCAT	AGTATGACG.GTTGACCAT
AGTATGACG.TCCAACGTG	AGTATGACG.TCCAACGTG
AGTCAGTTG.ATGAGTGTG	AGTCAGTTG.ATGAGTGTG
AGTCAGTTG.CCGCACTCA	AGTCAGTTG.CCGCACTCA
AGTCAGTTG.CGAAGAGGT	AGTCAGTTG.CGAAGAGGT
AGTCAGTTG.TATGGTTGG	AGTCAGTTG.TATGGTTGG
AGTCAGTTG.TCTATGACA	AGTCAGTTG.TCTATGACA
AGTCAGTTG.TTCCAGGAG	AGTCAGTTG.TTCCAGGAG
AGTCAGTTG.TTCCATACC	AGTCAGTTG.TTCCATACC
AGTCATACT.ACCTTGAAG	AGTCATACT.ACCTTGAAG
AGTCATACT.ATCAAGCAT	AGTCATACT.ATCAAGCAT
AGTCATACT.CAAGCTGCA	AGTCATACT.CAAGCTGCA
AGTCATACT.CCATTACAG	AGTCATACT.CCATTACAG
