GATTCTCGG.AGTTGCCTT	GATTCTCGG.AGTTGCCTT
GATTCTCGG.CCAGGAGTT	GATTCTCGG.CCAGGAGTT
GATTCTCGG.CGGTCGACA	GATTCTCGG.CGGTCGACA
GATTGAGTA.ATATAGCGT	GATTGAGTA.ATATAGCGT
GATTGAGTA.ATATCCGAT	GATTGAGTA.ATATCCGAT
GATTGAGTA.ATGCGTGGA	GATTGAGTA.ATGCGTGGA
GATTGAGTA.CAACTCCAG	GATTGAGTA.CAACTCCAG
GATTGAGTA.CAAGTCGAA	GATTGAGTA.CAAGTCGAA
GATTGAGTA.CATATGCGA	GATTGAGTA.CATATGCGA
GATTGAGTA.CATTCGAAT	GATTGAGTA.CATTCGAAT
GATTGAGTA.CTATTCCGT	GATTGAGTA.CTATTCCGT
GATTGAGTA.GCCGCCTAA	GATTGAGTA.GCCGCCTAA
GATTGAGTA.GCGCATTAC	GATTGAGTA.GCGCATTAC
GATTGAGTA.GGTAGTGTT	GATTGAGTA.GGTAGTGTT
GATTGAGTA.GGTGTGACC	GATTGAGTA.GGTGTGACC
GATTGGAAG.ACAGGTATC	GATTGGAAG.ACAGGTATC
GATTGGAAG.CCAGTTACG	GATTGGAAG.CCAGTTACG
GATTGGAAG.GGACAGATT	GATTGGAAG.GGACAGATT
GATTGGAAG.GTTACTACT	GATTGGAAG.GTTACTACT
GCAACACCT.AGTGATGCG	GCAACACCT.AGTGATGCG
GCAACCAAC.ATGCTCACC	GCAACCAAC.ATGCTCACC
GCAACCAAC.CACGCGTAA	GCAACCAAC.CACGCGTAA
GCAACCAAC.CGAATGAGT	GCAACCAAC.CGAATGAGT
GCAACCAAC.CTCGAACTG	GCAACCAAC.CTCGAACTG
GCAACCAAC.GGATTACGC	GCAACCAAC.GGATTACGC
GCAACTCGC.CATCAATAG	GCAACTCGC.CATCAATAG
GCAACTCGC.CCATCACGA	GCAACTCGC.CCATCACGA
GCAACTCGC.GACGTCAAT	GCAACTCGC.GACGTCAAT
GCAACTCGC.TAGCTGTTG	GCAACTCGC.TAGCTGTTG
GCAACTCGC.TGAACGGTT	GCAACTCGC.TGAACGGTT
GCAATCACG.AAGCACAAC	GCAATCACG.AAGCACAAC
GCAATCACG.ACCATACTT	GCAATCACG.ACCATACTT
GCAATCACG.ACGTCTATG	GCAATCACG.ACGTCTATG
GCAATCACG.CATACGCAG	GCAATCACG.CATACGCAG
GCAATCACG.CTAGTCGTC	GCAATCACG.CTAGTCGTC
GCAATCACG.GAGATGTAT	GCAATCACG.GAGATGTAT
GCAATCACG.GTGCATCAA	GCAATCACG.GTGCATCAA
GCAATCACG.TAGACCATG	GCAATCACG.TAGACCATG
GCAATCACG.TGACGGTTG	GCAATCACG.TGACGGTTG
GCAATCACG.TGCCTGGTT	GCAATCACG.TGCCTGGTT
GCAATCACG.TTGGACTTC	GCAATCACG.TTGGACTTC
GCAATGAGA.ACTCTCACA	GCAATGAGA.ACTCTCACA
GCACAACTC.ACGCAAGAT	GCACAACTC.ACGCAAGAT
GCACAACTC.CTGACGATG	GCACAACTC.CTGACGATG
GCACAACTC.CTGGTGACA	GCACAACTC.CTGGTGACA
GCACAACTC.GTAGACTCT	GCACAACTC.GTAGACTCT
GCACAACTC.GTCTCCAGG	GCACAACTC.GTCTCCAGG
GCACAACTC.TAACCGTGA	GCACAACTC.TAACCGTGA
GCACAGTAA.ACGGACCAT	GCACAGTAA.ACGGACCAT
GCACAGTAA.ACTCGTAGG	GCACAGTAA.ACTCGTAGG
GCACAGTAA.CGCATAACT	GCACAGTAA.CGCATAACT
GCACATGTT.GTATGATCT	GCACATGTT.GTATGATCT
GCACATGTT.GTGCCATGA	GCACATGTT.GTGCCATGA
GCACCATCG.CACGACTCA	GCACCATCG.CACGACTCA
GCACCATCG.CAGGAGCCT	GCACCATCG.CAGGAGCCT
GCACCATCG.CCGATCTCT	GCACCATCG.CCGATCTCT
GCACCATCG.GCAGCTTGA	GCACCATCG.GCAGCTTGA
GCACCATCG.TGGAGTGGA	GCACCATCG.TGGAGTGGA
GCACGCATT.CCACTTCGC	GCACGCATT.CCACTTCGC
GCACGCATT.CGCAATCGA	GCACGCATT.CGCAATCGA
GCACGCATT.TAGCTAAGA	GCACGCATT.TAGCTAAGA
GCACGCATT.TCACGACAA	GCACGCATT.TCACGACAA
GCACGCATT.TGGAATCGT	GCACGCATT.TGGAATCGT
GCACGCATT.TGTCGTACA	GCACGCATT.TGTCGTACA
GCACGTAGA.AATTGGATC	GCACGTAGA.AATTGGATC
GCACGTAGA.CAATCATAC	GCACGTAGA.CAATCATAC
GCACGTAGA.CACCTCGGA	GCACGTAGA.CACCTCGGA
GCACGTAGA.CTGGTACAT	GCACGTAGA.CTGGTACAT
GCACGTAGA.GCACAACTC	GCACGTAGA.GCACAACTC
GCACGTAGA.GCCAACAAT	GCACGTAGA.GCCAACAAT
GCACGTAGA.TCGTAATAG	GCACGTAGA.TCGTAATAG
GCACGTAGA.TGACAAGTT	GCACGTAGA.TGACAAGTT
GCACGTAGA.TTCCTGCTA	GCACGTAGA.TTCCTGCTA
GCACTGGAT.AAGCAATCG	GCACTGGAT.AAGCAATCG
GCACTGGAT.ACAATAGGT	GCACTGGAT.ACAATAGGT
GCACTGGAT.ACGTATGTC	GCACTGGAT.ACGTATGTC
GCACTGGAT.CTCCACGTC	GCACTGGAT.CTCCACGTC
GCACTGGAT.GTATTACTG	GCACTGGAT.GTATTACTG
GCAGATCCG.CACTAGACT	GCAGATCCG.CACTAGACT
GCAGATCCG.TAGGTTAGT	GCAGATCCG.TAGGTTAGT
GCAGCAGTG.ACGTGCTCG	GCAGCAGTG.ACGTGCTCG
GCAGCAGTG.ATGAGATCC	GCAGCAGTG.ATGAGATCC
GCAGCAGTG.TATCAGTGC	GCAGCAGTG.TATCAGTGC
GCAGCAGTG.TGATCTCGG	GCAGCAGTG.TGATCTCGG
GCAGCAGTG.TGCCGAACT	GCAGCAGTG.TGCCGAACT
GCAGCGATA.ACACGTTGC	GCAGCGATA.ACACGTTGC
GCAGCGATA.CAGCTTACC	GCAGCGATA.CAGCTTACC
GCAGCGATA.GACCGTAGT	GCAGCGATA.GACCGTAGT
GCAGCGATA.GCAATCACG	GCAGCGATA.GCAATCACG
GCAGCGATA.GCATACTCC	GCAGCGATA.GCATACTCC
GCAGCGATA.GTGTTCCAG	GCAGCGATA.GTGTTCCAG
GCAGCGATA.TCCAATCAT	GCAGCGATA.TCCAATCAT
GCAGCTCTT.AGAAGAGTC	GCAGCTCTT.AGAAGAGTC
GCAGCTCTT.AGACTTCGT	GCAGCTCTT.AGACTTCGT
GCAGCTCTT.AGTTGCCTT	GCAGCTCTT.AGTTGCCTT
GCAGCTCTT.GCGTGATAC	GCAGCTCTT.GCGTGATAC
GCAGCTCTT.GGACAGATT	GCAGCTCTT.GGACAGATT
GCAGCTTGA.GAACCAGTT	GCAGCTTGA.GAACCAGTT
GCAGCTTGA.GATATGGAC	GCAGCTTGA.GATATGGAC
GCAGCTTGA.GCACAACTC	GCAGCTTGA.GCACAACTC
GCAGCTTGA.GGAGCATCT	GCAGCTTGA.GGAGCATCT
GCAGCTTGA.GTACAATGC	GCAGCTTGA.GTACAATGC
GCAGGAGAA.AATACCTTG	GCAGGAGAA.AATACCTTG
GCAGGAGAA.AGGATCTCA	GCAGGAGAA.AGGATCTCA
GCAGGAGAA.GTGCTCGGA	GCAGGAGAA.GTGCTCGGA
GCAGGAGAA.TCTTAAGTG	GCAGGAGAA.TCTTAAGTG
GCATACATG.AATACCTTG	GCATACATG.AATACCTTG
GCATACATG.AGCGGTCTA	GCATACATG.AGCGGTCTA
GCATACATG.AGTAATGGT	GCATACATG.AGTAATGGT
GCATACATG.CGATAGGTG	GCATACATG.CGATAGGTG
GCATACATG.GCTACCTTA	GCATACATG.GCTACCTTA
GCATACATG.GGTAATCTA	GCATACATG.GGTAATCTA
GCATACATG.TAAGTGTAG	GCATACATG.TAAGTGTAG
GCATACATG.TCCTTCAAC	GCATACATG.TCCTTCAAC
GCATACTCC.AGCTTGGTG	GCATACTCC.AGCTTGGTG
GCATACTCC.CCGCATCCT	GCATACTCC.CCGCATCCT
GCATACTCC.CTCGAACTG	GCATACTCC.CTCGAACTG
GCATACTCC.GGACGAGCA	GCATACTCC.GGACGAGCA
GCATACTCC.GTATACAGA	GCATACTCC.GTATACAGA
GCATACTCC.TCCACCGGT	GCATACTCC.TCCACCGGT
GCATGTAAG.CCACGAAGG	GCATGTAAG.CCACGAAGG
GCATGTAAG.CCGACTGTT	GCATGTAAG.CCGACTGTT
GCATGTAAG.CTTCTCATC	GCATGTAAG.CTTCTCATC
GCATGTAAG.TGCGACGTT	GCATGTAAG.TGCGACGTT
GCATGTGGT.AGTCGCCGA	GCATGTGGT.AGTCGCCGA
GCATGTGGT.AGTTGTGTA	GCATGTGGT.AGTTGTGTA
GCATGTGGT.GCTTAGAAC	GCATGTGGT.GCTTAGAAC
GCATGTGGT.TGGTGGATC	GCATGTGGT.TGGTGGATC
GCATTGATC.ATCAAGAGA	GCATTGATC.ATCAAGAGA
GCATTGATC.TGCGTATCT	GCATTGATC.TGCGTATCT
GCATTGATC.TGGAAGATT	GCATTGATC.TGGAAGATT
GCCAACAAT.ACATTCCAC	GCCAACAAT.ACATTCCAC
GCCAACAAT.CCTCCTTGT	GCCAACAAT.CCTCCTTGT
GCCAACAAT.GACTAGCAT	GCCAACAAT.GACTAGCAT
GCCAACAAT.TATTGCTAC	GCCAACAAT.TATTGCTAC
GCCAACAAT.TGGTCTACG	GCCAACAAT.TGGTCTACG
GCCAATGAA.ACAAGAATG	GCCAATGAA.ACAAGAATG
GCCAATGAA.ATCAGGATG	GCCAATGAA.ATCAGGATG
GCCAATGAA.ATCGAATCG	GCCAATGAA.ATCGAATCG
GCCAATGAA.CGTATAGCG	GCCAATGAA.CGTATAGCG
GCCAATGAA.GTTGACCAT	GCCAATGAA.GTTGACCAT
GCCAATGAA.TGCCGACTA	GCCAATGAA.TGCCGACTA
GCCACATGG.AAGCTGAGG	GCCACATGG.AAGCTGAGG
GCCACATGG.CATATGCGA	GCCACATGG.CATATGCGA
GCCACATGG.GTCTGAGCC	GCCACATGG.GTCTGAGCC
GCCACATGG.GTGCACGAG	GCCACATGG.GTGCACGAG
GCCACATGG.TCGATTCAG	GCCACATGG.TCGATTCAG
GCCACATGG.TGGAATCGT	GCCACATGG.TGGAATCGT
GCCACGAGT.ACGGTGTAC	GCCACGAGT.ACGGTGTAC
GCCACGAGT.AGTTAGGTC	GCCACGAGT.AGTTAGGTC
GCCACGAGT.CCTAAGTCT	GCCACGAGT.CCTAAGTCT
GCCACGAGT.CGCAGTGTC	GCCACGAGT.CGCAGTGTC
GCCACGAGT.GCGTGATAC	GCCACGAGT.GCGTGATAC
GCCACGAGT.TCAGTGCAA	GCCACGAGT.TCAGTGCAA
GCCATACAA.ATCCGGTCC	GCCATACAA.ATCCGGTCC
GCCATACAA.CTCGTGTCC	GCCATACAA.CTCGTGTCC
GCCATACAA.TCCAGCTAT	GCCATACAA.TCCAGCTAT
GCCATACAA.TGCCGAACT	GCCATACAA.TGCCGAACT
GCCATCGCT.AGAGGACGT	GCCATCGCT.AGAGGACGT
GCCATCGCT.AGTCCAGTG	GCCATCGCT.AGTCCAGTG
GCCATCGCT.ATAACGACA	GCCATCGCT.ATAACGACA
GCCATCGCT.ATCAAGCAT	GCCATCGCT.ATCAAGCAT
GCCATCGCT.CCATAAGTA	GCCATCGCT.CCATAAGTA
GCCATCGCT.GAACAACCA	GCCATCGCT.GAACAACCA
GCCATCGCT.GTGGACTGG	GCCATCGCT.GTGGACTGG
GCCATCGCT.TGCCACCGA	GCCATCGCT.TGCCACCGA
GCCATCGCT.TGGTGGATC	GCCATCGCT.TGGTGGATC
GCCATTAAG.GAATAAGAG	GCCATTAAG.GAATAAGAG
GCCGAACCA.ATTCATGTG	GCCGAACCA.ATTCATGTG
GCCGAACCA.CCTGTCATT	GCCGAACCA.CCTGTCATT
GCCGAACCA.TAGGTCAAC	GCCGAACCA.TAGGTCAAC
GCCGAACCA.TGTTAAGCC	GCCGAACCA.TGTTAAGCC
GCCGAGTCT.TTGCCGTAG	GCCGAGTCT.TTGCCGTAG
GCCGCCTAA.ACGTGTAGT	GCCGCCTAA.ACGTGTAGT
GCCGCCTAA.ATGAACTAG	GCCGCCTAA.ATGAACTAG
GCCGCCTAA.CACACTGCC	GCCGCCTAA.CACACTGCC
GCCGCCTAA.CACTCACTA	GCCGCCTAA.CACTCACTA
GCCGCCTAA.TCAGACAAG	GCCGCCTAA.TCAGACAAG
GCCGCCTAA.TGTGCCATG	GCCGCCTAA.TGTGCCATG
GCCGCTATC.TCCGGAGCT	GCCGCTATC.TCCGGAGCT
GCCGCTATC.TCGGACAGT	GCCGCTATC.TCGGACAGT
GCCGTCTTC.AGCGGTCTA	GCCGTCTTC.AGCGGTCTA
GCCGTCTTC.CATAGTATG	GCCGTCTTC.CATAGTATG
GCCGTCTTC.CTCTGCGGT	GCCGTCTTC.CTCTGCGGT
GCCGTCTTC.GAACATGAC	GCCGTCTTC.GAACATGAC
GCCGTCTTC.GCCGCCTAA	GCCGTCTTC.GCCGCCTAA
GCCGTCTTC.GGTAAGTGA	GCCGTCTTC.GGTAAGTGA
GCCGTCTTC.TATTGACTG	GCCGTCTTC.TATTGACTG
GCCGTCTTC.TGTATCGTG	GCCGTCTTC.TGTATCGTG
GCCGTGAAC.AACGATGAC	GCCGTGAAC.AACGATGAC
GCCGTGAAC.ACTATCCTG	GCCGTGAAC.ACTATCCTG
GCCGTGAAC.ATTGCCGAC	GCCGTGAAC.ATTGCCGAC
GCCGTGAAC.CCACGAAGG	GCCGTGAAC.CCACGAAGG
GCCGTGAAC.GGAAGAAGC	GCCGTGAAC.GGAAGAAGC
GCCGTGAAC.TGGAACTAA	GCCGTGAAC.TGGAACTAA
GCCGTGAAC.TGGAAGATT	GCCGTGAAC.TGGAAGATT
GCCGTTGTT.AATGCGTGC	GCCGTTGTT.AATGCGTGC
GCCGTTGTT.AGGATTACT	GCCGTTGTT.AGGATTACT
GCCGTTGTT.AGTCGCGAC	GCCGTTGTT.AGTCGCGAC
GCCGTTGTT.CAATCAAGT	GCCGTTGTT.CAATCAAGT
GCCGTTGTT.CATTCAGTT	GCCGTTGTT.CATTCAGTT
GCCGTTGTT.GAGAATCAG	GCCGTTGTT.GAGAATCAG
GCCGTTGTT.GCGATATGA	GCCGTTGTT.GCGATATGA
GCCGTTGTT.TCCTCGTCG	GCCGTTGTT.TCCTCGTCG
GCCTAACGG.CTGATCAAG	GCCTAACGG.CTGATCAAG
GCCTAACGG.TTCACTGGA	GCCTAACGG.TTCACTGGA
GCCTGCATC.AGCCGGATC	GCCTGCATC.AGCCGGATC
GCCTGCATC.ATCAGAAGC	GCCTGCATC.ATCAGAAGC
GCCTGCATC.ATGGAGGAA	GCCTGCATC.ATGGAGGAA
GCCTGCATC.CAAGCGCAT	GCCTGCATC.CAAGCGCAT
GCCTGCATC.CATTCAGTT	GCCTGCATC.CATTCAGTT
GCCTGCATC.CCACTTCGC	GCCTGCATC.CCACTTCGC
GCCTGCATC.CTCGTGTCC	GCCTGCATC.CTCGTGTCC
GCCTGCATC.GACGGACTA	GCCTGCATC.GACGGACTA
GCCTGCATC.GTGGTTACC	GCCTGCATC.GTGGTTACC
GCCTGGAAT.AACGGTAGC	GCCTGGAAT.AACGGTAGC
GCCTGGAAT.ACACATCTG	GCCTGGAAT.ACACATCTG
GCCTGGAAT.AGTCATACT	GCCTGGAAT.AGTCATACT
GCCTGGAAT.ATTAGCGGT	GCCTGGAAT.ATTAGCGGT
GCCTGGAAT.CCACACAGA	GCCTGGAAT.CCACACAGA
GCCTGGAAT.CGAGCTTAC	GCCTGGAAT.CGAGCTTAC
GCCTGGAAT.GATTGGAAG	GCCTGGAAT.GATTGGAAG
GCCTGGAAT.TCAAGGTCG	GCCTGGAAT.TCAAGGTCG
GCCTTAGAG.AATGCTATC	GCCTTAGAG.AATGCTATC
GCCTTAGAG.ACGATGGAA	GCCTTAGAG.ACGATGGAA
GCCTTAGAG.AGACGGAGG	GCCTTAGAG.AGACGGAGG
GCCTTAGAG.AGCTATATG	GCCTTAGAG.AGCTATATG
GCCTTAGAG.CCAAGTCGA	GCCTTAGAG.CCAAGTCGA
GCCTTAGAG.GCGATGGTG	GCCTTAGAG.GCGATGGTG
GCCTTAGAG.TAGTGATCC	GCCTTAGAG.TAGTGATCC
GCCTTATCT.ACGCGTGAC	GCCTTATCT.ACGCGTGAC
GCCTTATCT.GAACAACCA	GCCTTATCT.GAACAACCA
GCCTTCCAT.AAGCTGAGG	GCCTTCCAT.AAGCTGAGG
GCCTTCCAT.ATGTCCTCC	GCCTTCCAT.ATGTCCTCC
GCCTTCCAT.CCAGTCTCA	GCCTTCCAT.CCAGTCTCA
GCCTTCCAT.CTCTACGCA	GCCTTCCAT.CTCTACGCA
GCCTTCCAT.GATTGGAAG	GCCTTCCAT.GATTGGAAG
GCCTTCCAT.TAGTTGACG	GCCTTCCAT.TAGTTGACG
GCCTTGTGA.AATTCGGAA	GCCTTGTGA.AATTCGGAA
GCCTTGTGA.GTTGCATGG	GCCTTGTGA.GTTGCATGG
GCGAACTCG.ACACATCTG	GCGAACTCG.ACACATCTG
GCGAACTCG.AGAGCCGCA	GCGAACTCG.AGAGCCGCA
GCGAACTCG.ATGATAGCT	GCGAACTCG.ATGATAGCT
GCGAACTCG.GCTGAGCAG	GCGAACTCG.GCTGAGCAG
GCGAACTCG.GCTTACGTT	GCGAACTCG.GCTTACGTT
GCGAACTCG.GGTACTTCC	GCGAACTCG.GGTACTTCC
GCGAACTCG.GGTTGAAGG	GCGAACTCG.GGTTGAAGG
GCGAACTCG.TACAAGAGG	GCGAACTCG.TACAAGAGG
GCGAAGACA.AAGTTGCCA	GCGAAGACA.AAGTTGCCA
GCGAAGACA.ACTTCAGTA	GCGAAGACA.ACTTCAGTA
GCGAAGACA.ATATTCGCA	GCGAAGACA.ATATTCGCA
GCGAAGACA.CACACCTGT	GCGAAGACA.CACACCTGT
GCGAAGACA.CGGTTGCGA	GCGAAGACA.CGGTTGCGA
GCGAAGACA.CTGTTACCA	GCGAAGACA.CTGTTACCA
GCGAAGACA.GTGCGTTCC	GCGAAGACA.GTGCGTTCC
GCGAAGACA.TAGCTAAGA	GCGAAGACA.TAGCTAAGA
GCGAAGACA.TCCTGTGGA	GCGAAGACA.TCCTGTGGA
GCGAAGACA.TTGCCGTAG	GCGAAGACA.TTGCCGTAG
GCGAAGCTC.ACTCCGGTT	GCGAAGCTC.ACTCCGGTT
GCGAAGCTC.ATCACTTCC	GCGAAGCTC.ATCACTTCC
GCGAAGCTC.CCTTATCCG	GCGAAGCTC.CCTTATCCG
GCGAAGCTC.GATCTGAAT	GCGAAGCTC.GATCTGAAT
GCGAAGCTC.GTAACGCGA	GCGAAGCTC.GTAACGCGA
GCGAAGCTC.TGAAGACCA	GCGAAGCTC.TGAAGACCA
GCGAAGCTC.TGATTATCG	GCGAAGCTC.TGATTATCG
GCGAAGCTC.TGCAGTTCA	GCGAAGCTC.TGCAGTTCA
GCGACAACC.ACTGCTAGT	GCGACAACC.ACTGCTAGT
GCGACAACC.CACTGGTCC	GCGACAACC.CACTGGTCC
GCGACAACC.CACTTCCTT	GCGACAACC.CACTTCCTT
GCGACAACC.CTTGCACAA	GCGACAACC.CTTGCACAA
GCGACAACC.TACGAGTGA	GCGACAACC.TACGAGTGA
GCGACACAG.CAATCATAC	GCGACACAG.CAATCATAC
GCGACACAG.CATTCAGTT	GCGACACAG.CATTCAGTT
GCGACACAG.CTCGCTACG	GCGACACAG.CTCGCTACG
GCGACACAG.GCATACATG	GCGACACAG.GCATACATG
GCGACACAG.GCTACAATG	GCGACACAG.GCTACAATG
GCGACACAG.GCTTCTACG	GCGACACAG.GCTTCTACG
GCGACACAG.GTGAATGCC	GCGACACAG.GTGAATGCC
GCGACACAG.GTTGACGTG	GCGACACAG.GTTGACGTG
GCGACACAG.TCTAGGATG	GCGACACAG.TCTAGGATG
GCGACACAG.TTGTAATGC	GCGACACAG.TTGTAATGC
GCGACCTGT.CCAAGTCGA	GCGACCTGT.CCAAGTCGA
GCGACCTGT.CTCGACTGC	GCGACCTGT.CTCGACTGC
GCGACCTGT.GCCATTAAG	GCGACCTGT.GCCATTAAG
GCGACCTGT.TCCTATTCC	GCGACCTGT.TCCTATTCC
GCGAGCAAG.AAGTCATGA	GCGAGCAAG.AAGTCATGA
GCGAGCAAG.AGAATCAGA	GCGAGCAAG.AGAATCAGA
GCGAGCAAG.AGGTATTCC	GCGAGCAAG.AGGTATTCC
GCGAGCAAG.CACCTCAAC	GCGAGCAAG.CACCTCAAC
GCGAGCAAG.CGTACACAC	GCGAGCAAG.CGTACACAC
GCGAGCAAG.CTCGTGTCC	GCGAGCAAG.CTCGTGTCC
GCGAGCAAG.CTGCAAGCC	GCGAGCAAG.CTGCAAGCC
GCGAGCAAG.GACGCCGTA	GCGAGCAAG.GACGCCGTA
GCGAGCAAG.TGAACTTGC	GCGAGCAAG.TGAACTTGC
GCGAGTCTA.AATACTCCG	GCGAGTCTA.AATACTCCG
GCGAGTCTA.AGTATGACG	GCGAGTCTA.AGTATGACG
GCGAGTCTA.CGCCATTAC	GCGAGTCTA.CGCCATTAC
GCGAGTCTA.CTCTTCAGC	GCGAGTCTA.CTCTTCAGC
GCGAGTCTA.GGTCGGATA	GCGAGTCTA.GGTCGGATA
GCGAGTCTA.TCCTGAGAC	GCGAGTCTA.TCCTGAGAC
GCGAGTCTA.TCTAGGATG	GCGAGTCTA.TCTAGGATG
GCGATATGA.AAGCCACAC	GCGATATGA.AAGCCACAC
GCGATATGA.CTATCTTGA	GCGATATGA.CTATCTTGA
GCGATATGA.GGAATTCAC	GCGATATGA.GGAATTCAC
GCGATATGA.TATCTAGGT	GCGATATGA.TATCTAGGT
GCGATATGA.TGTCCATAG	GCGATATGA.TGTCCATAG
GCGATGGTG.AAGCATTGC	GCGATGGTG.AAGCATTGC
GCGATGGTG.CACATGTGC	GCGATGGTG.CACATGTGC
GCGATGGTG.CCGCAGCTA	GCGATGGTG.CCGCAGCTA
GCGATGGTG.GTGAGGACG	GCGATGGTG.GTGAGGACG
GCGATGGTG.TAGGAGCTA	GCGATGGTG.TAGGAGCTA
GCGATGGTG.TATCGAGCC	GCGATGGTG.TATCGAGCC
GCGCATTAC.ACCGTACGC	GCGCATTAC.ACCGTACGC
GCGCATTAC.CAAGTCGAA	GCGCATTAC.CAAGTCGAA
GCGCATTAC.CCACGAAGG	GCGCATTAC.CCACGAAGG
GCGCATTAC.CCATTACAG	GCGCATTAC.CCATTACAG
GCGCATTAC.GTCGACATT	GCGCATTAC.GTCGACATT
GCGCTACCT.AACGCCTAC	GCGCTACCT.AACGCCTAC
GCGCTACCT.AGCTCGTCT	GCGCTACCT.AGCTCGTCT
GCGCTACCT.GCCGAGTCT	GCGCTACCT.GCCGAGTCT
GCGCTACCT.GGTTACGCA	GCGCTACCT.GGTTACGCA
GCGCTACCT.TACCTCACT	GCGCTACCT.TACCTCACT
GCGCTACCT.TAGGAGGAT	GCGCTACCT.TAGGAGGAT
GCGCTACCT.TAGTTGACG	GCGCTACCT.TAGTTGACG
GCGCTAGAA.AGCACCGTG	GCGCTAGAA.AGCACCGTG
GCGCTAGAA.CAGATCGAC	GCGCTAGAA.CAGATCGAC
GCGCTAGAA.CTATTAAGG	GCGCTAGAA.CTATTAAGG
GCGCTAGAA.CTCGTTCAC	GCGCTAGAA.CTCGTTCAC
GCGCTAGAA.TGGATTAGC	GCGCTAGAA.TGGATTAGC
GCGCTAGAA.TTACACCTT	GCGCTAGAA.TTACACCTT
GCGCTCTAT.ACGCGTGAC	GCGCTCTAT.ACGCGTGAC
GCGCTCTAT.AGGATCATG	GCGCTCTAT.AGGATCATG
GCGCTTCTC.ACAGGTATC	GCGCTTCTC.ACAGGTATC
GCGCTTCTC.ATATAGCGT	GCGCTTCTC.ATATAGCGT
GCGCTTCTC.ATCTCGAAC	GCGCTTCTC.ATCTCGAAC
GCGCTTCTC.ATTCTCTGG	GCGCTTCTC.ATTCTCTGG
GCGCTTCTC.CGCGTACTA	GCGCTTCTC.CGCGTACTA
GCGGACGAA.ACAAGAATG	GCGGACGAA.ACAAGAATG
GCGGACGAA.CTGAGTCCA	GCGGACGAA.CTGAGTCCA
GCGGACGAA.GAACTATGG	GCGGACGAA.GAACTATGG
GCGGACGAA.TGCTATGAA	GCGGACGAA.TGCTATGAA
GCGGACGAA.TTGCCGTAG	GCGGACGAA.TTGCCGTAG
GCGGAGATT.ACAGTATTG	GCGGAGATT.ACAGTATTG
GCGGAGATT.ACTATCCTG	GCGGAGATT.ACTATCCTG
GCGGAGATT.CAGATCGAC	GCGGAGATT.CAGATCGAC
GCGGAGATT.TATGATGTG	GCGGAGATT.TATGATGTG
GCGGTAAGT.CAATCAAGT	GCGGTAAGT.CAATCAAGT
GCGGTAAGT.CCTGCGTTA	GCGGTAAGT.CCTGCGTTA
GCGGTAAGT.TACAAGAGG	GCGGTAAGT.TACAAGAGG
GCGGTAAGT.TGAACTTGC	GCGGTAAGT.TGAACTTGC
GCGGTAAGT.TGAGAGGAC	GCGGTAAGT.TGAGAGGAC
GCGGTAAGT.TTGCCGTAG	GCGGTAAGT.TTGCCGTAG
GCGGTAGTC.AGGAGGTGA	GCGGTAGTC.AGGAGGTGA
GCGGTAGTC.AGTCGTCCG	GCGGTAGTC.AGTCGTCCG
GCGGTAGTC.CAGTCGGTA	GCGGTAGTC.CAGTCGGTA
GCGGTAGTC.CCAATATAC	GCGGTAGTC.CCAATATAC
GCGGTAGTC.TAACACGAG	GCGGTAGTC.TAACACGAG
GCGGTAGTC.TTCGTGATG	GCGGTAGTC.TTCGTGATG
GCGTAACAA.AACAGCAGT	GCGTAACAA.AACAGCAGT
GCGTAACAA.AACGGAGAT	GCGTAACAA.AACGGAGAT
GCGTAACAA.GAACCAGTT	GCGTAACAA.GAACCAGTT
GCGTAACAA.TAAGTGTAG	GCGTAACAA.TAAGTGTAG
GCGTATAGG.ACCAGCGTT	GCGTATAGG.ACCAGCGTT
GCGTATAGG.ACTCACGAA	GCGTATAGG.ACTCACGAA
GCGTATAGG.ATAAGTTCG	GCGTATAGG.ATAAGTTCG
GCGTATAGG.ATCTGGTAG	GCGTATAGG.ATCTGGTAG
GCGTATAGG.CAGAGCACC	GCGTATAGG.CAGAGCACC
GCGTATAGG.CATGACGTT	GCGTATAGG.CATGACGTT
GCGTATAGG.CCGGATTGC	GCGTATAGG.CCGGATTGC
GCGTATAGG.CTATTAAGG	GCGTATAGG.CTATTAAGG
GCGTATAGG.GTAACAGTC	GCGTATAGG.GTAACAGTC
GCGTATAGG.TAGTGCACT	GCGTATAGG.TAGTGCACT
GCGTATAGG.TCCTTAGGT	GCGTATAGG.TCCTTAGGT
GCGTCGTCT.AGCTTCGAT	GCGTCGTCT.AGCTTCGAT
GCGTCGTCT.CAAGAGGAG	GCGTCGTCT.CAAGAGGAG
GCGTCGTCT.CCACGAAGG	GCGTCGTCT.CCACGAAGG
GCGTCGTCT.CTCATGCCA	GCGTCGTCT.CTCATGCCA
GCGTCGTCT.TATAGTGCG	GCGTCGTCT.TATAGTGCG
GCGTCGTCT.TCAACACTC	GCGTCGTCT.TCAACACTC
GCGTGAGCT.AGCCGTTCT	GCGTGAGCT.AGCCGTTCT
GCGTGAGCT.CGCAATCGA	GCGTGAGCT.CGCAATCGA
GCGTGAGCT.GAACAACCA	GCGTGAGCT.GAACAACCA
GCGTGAGCT.GATAGTTCT	GCGTGAGCT.GATAGTTCT
GCGTGAGCT.GCCATTAAG	GCGTGAGCT.GCCATTAAG
GCGTGAGCT.GGAGTTAGC	GCGTGAGCT.GGAGTTAGC
GCGTGAGCT.GGTACTTCC	GCGTGAGCT.GGTACTTCC
GCGTGAGCT.TCATCATCT	GCGTGAGCT.TCATCATCT
GCGTGAGCT.TGGAGAACC	GCGTGAGCT.TGGAGAACC
GCGTGAGCT.TTCCGAGCG	GCGTGAGCT.TTCCGAGCG
GCGTGATAC.GTGAATGCC	GCGTGATAC.GTGAATGCC
GCGTTCAGA.GAGCAGGAA	GCGTTCAGA.GAGCAGGAA
GCGTTCAGA.GGACGAGCA	GCGTTCAGA.GGACGAGCA
GCGTTCAGA.GTGCATCAA	GCGTTCAGA.GTGCATCAA
GCGTTCAGA.TAGCCAGTG	GCGTTCAGA.TAGCCAGTG
GCTACAATG.GAATTGTTG	GCTACAATG.GAATTGTTG
GCTACAATG.GATCGCACT	GCTACAATG.GATCGCACT
GCTACAATG.GCGACCTGT	GCTACAATG.GCGACCTGT
GCTACAATG.GCGATATGA	GCTACAATG.GCGATATGA
GCTACAATG.TAGCTAAGA	GCTACAATG.TAGCTAAGA
GCTACCGAG.AAGAGAGAG	GCTACCGAG.AAGAGAGAG
GCTACCGAG.ATAATGTGG	GCTACCGAG.ATAATGTGG
GCTACCGAG.CCTCGCGTT	GCTACCGAG.CCTCGCGTT
GCTACCGAG.GCCACATGG	GCTACCGAG.GCCACATGG
GCTACCGAG.GTATCGTCG	GCTACCGAG.GTATCGTCG
GCTACCGAG.TGTAACAGT	GCTACCGAG.TGTAACAGT
GCTACCGAG.TTGGTAACT	GCTACCGAG.TTGGTAACT
GCTACCTTA.CATATGCGA	GCTACCTTA.CATATGCGA
GCTACCTTA.CCACGAAGG	GCTACCTTA.CCACGAAGG
GCTACCTTA.CCATAGCCA	GCTACCTTA.CCATAGCCA
GCTACCTTA.GAAGTGTGA	GCTACCTTA.GAAGTGTGA
GCTACCTTA.GGAAGAAGC	GCTACCTTA.GGAAGAAGC
GCTACCTTA.GTGGACTGG	GCTACCTTA.GTGGACTGG
GCTACCTTA.TGTACACGA	GCTACCTTA.TGTACACGA
GCTAGCTCC.AGCCGGATC	GCTAGCTCC.AGCCGGATC
GCTAGCTCC.ATGAGCAGG	GCTAGCTCC.ATGAGCAGG
GCTAGCTCC.CGCCTGCAA	GCTAGCTCC.CGCCTGCAA
GCTAGCTCC.CGTCTGCTG	GCTAGCTCC.CGTCTGCTG
GCTAGCTCC.TTCCAATTC	GCTAGCTCC.TTCCAATTC
GCTAGTGGA.CCACTACCA	GCTAGTGGA.CCACTACCA
GCTAGTGGA.GATCTACTT	GCTAGTGGA.GATCTACTT
GCTAGTGGA.GTTGCTCAG	GCTAGTGGA.GTTGCTCAG
GCTAGTGGA.TCCAACGTG	GCTAGTGGA.TCCAACGTG
GCTAGTGGA.TTCTGGTGC	GCTAGTGGA.TTCTGGTGC
GCTATGTAA.ATCTACATC	GCTATGTAA.ATCTACATC
GCTATGTAA.CATAAGATC	GCTATGTAA.CATAAGATC
GCTATGTAA.CTGCTGCTT	GCTATGTAA.CTGCTGCTT
GCTATGTAA.TACCTATCC	GCTATGTAA.TACCTATCC
GCTATGTAA.TCATATCGC	GCTATGTAA.TCATATCGC
GCTATGTAA.TTGAGACGG	GCTATGTAA.TTGAGACGG
GCTCAATGA.AGTGAGAGA	GCTCAATGA.AGTGAGAGA
GCTCAATGA.ATCCTCCGA	GCTCAATGA.ATCCTCCGA
GCTCAATGA.TCTGTGAAG	GCTCAATGA.TCTGTGAAG
GCTCAGCCA.ATCAGTCGA	GCTCAGCCA.ATCAGTCGA
GCTCAGCCA.GAACTCGTA	GCTCAGCCA.GAACTCGTA
GCTCAGCCA.GATACACTA	GCTCAGCCA.GATACACTA
GCTCAGCCA.TGACCTATG	GCTCAGCCA.TGACCTATG
GCTCAGCCA.TTCCATACC	GCTCAGCCA.TTCCATACC
GCTCCTAGC.AATAGACGC	GCTCCTAGC.AATAGACGC
GCTCCTAGC.ACATTCCAC	GCTCCTAGC.ACATTCCAC
GCTCCTAGC.AGTGTTCTG	GCTCCTAGC.AGTGTTCTG
GCTCCTAGC.CAATACCAC	GCTCCTAGC.CAATACCAC
GCTCCTAGC.GGTTCAGAC	GCTCCTAGC.GGTTCAGAC
GCTCCTAGC.TCGTAATAG	GCTCCTAGC.TCGTAATAG
GCTCCTAGC.TGGAGAACC	GCTCCTAGC.TGGAGAACC
GCTCTCCAA.GAACTGCAA	GCTCTCCAA.GAACTGCAA
GCTCTCCAA.GTATGTATC	GCTCTCCAA.GTATGTATC
GCTCTCCAA.GTCAGTTGT	GCTCTCCAA.GTCAGTTGT
GCTCTGTGT.ATGAGCAGG	GCTCTGTGT.ATGAGCAGG
GCTCTGTGT.CGTCTGCTG	GCTCTGTGT.CGTCTGCTG
GCTCTGTGT.GCATACTCC	GCTCTGTGT.GCATACTCC
GCTCTGTGT.TAACGTGTC	GCTCTGTGT.TAACGTGTC
GCTCTGTGT.TCTGCAACA	GCTCTGTGT.TCTGCAACA
GCTCTGTGT.TGGATTAGC	GCTCTGTGT.TGGATTAGC
GCTGACAGA.ACCAGCGTT	GCTGACAGA.ACCAGCGTT
GCTGACAGA.CGAACAATC	GCTGACAGA.CGAACAATC
GCTGACAGA.CGCGTACTA	GCTGACAGA.CGCGTACTA
GCTGACAGA.CTTCTATGA	GCTGACAGA.CTTCTATGA
GCTGACAGA.GGTTCTATC	GCTGACAGA.GGTTCTATC
GCTGACAGA.TAAGGTCCG	GCTGACAGA.TAAGGTCCG
GCTGAGCAG.TTGCGAACA	GCTGAGCAG.TTGCGAACA
GCTGATGTC.ACTCTCACA	GCTGATGTC.ACTCTCACA
GCTGATGTC.AGATCTGAC	GCTGATGTC.AGATCTGAC
GCTGATGTC.ATTAGCACA	GCTGATGTC.ATTAGCACA
GCTGATGTC.ATTGCCGAC	GCTGATGTC.ATTGCCGAC
GCTGATGTC.GAATAAGAG	GCTGATGTC.GAATAAGAG
GCTGATGTC.TGTAGGTTA	GCTGATGTC.TGTAGGTTA
GCTGGTAAC.CAAGCTGCA	GCTGGTAAC.CAAGCTGCA
GCTGGTAAC.CCAGTTACG	GCTGGTAAC.CCAGTTACG
GCTGGTAAC.CCATGCGTC	GCTGGTAAC.CCATGCGTC
GCTGGTAAC.CGCACTCTT	GCTGGTAAC.CGCACTCTT
GCTGGTAAC.CTCGACGAT	GCTGGTAAC.CTCGACGAT
GCTGGTAAC.CTCTGTCAA	GCTGGTAAC.CTCTGTCAA
GCTGGTTCG.ACGCGTGAC	GCTGGTTCG.ACGCGTGAC
GCTGGTTCG.ATATCCGAT	GCTGGTTCG.ATATCCGAT
GCTGGTTCG.ATCGGTGGT	GCTGGTTCG.ATCGGTGGT
GCTGGTTCG.CCGGTTGAG	GCTGGTTCG.CCGGTTGAG
GCTGGTTCG.GCCATTAAG	GCTGGTTCG.GCCATTAAG
GCTGGTTCG.GCCTGCATC	GCTGGTTCG.GCCTGCATC
GCTGGTTCG.GTTAATTCG	GCTGGTTCG.GTTAATTCG
GCTGGTTCG.TAACATTGG	GCTGGTTCG.TAACATTGG
GCTGTTCGG.AACTCCATG	GCTGTTCGG.AACTCCATG
GCTGTTCGG.AGTACTCTC	GCTGTTCGG.AGTACTCTC
GCTGTTCGG.AGTCGTCCG	GCTGTTCGG.AGTCGTCCG
GCTGTTCGG.CAATCAAGT	GCTGTTCGG.CAATCAAGT
GCTGTTCGG.CAATCTCCG	GCTGTTCGG.CAATCTCCG
GCTGTTCGG.GATCGATAC	GCTGTTCGG.GATCGATAC
GCTGTTCGG.GCCGAGTCT	GCTGTTCGG.GCCGAGTCT
GCTGTTCGG.GGAAGTATG	GCTGTTCGG.GGAAGTATG
GCTGTTCGG.GTATGCCTT	GCTGTTCGG.GTATGCCTT
GCTGTTCGG.TTACAGTGT	GCTGTTCGG.TTACAGTGT
GCTTACGTT.ATGGATATC	GCTTACGTT.ATGGATATC
GCTTACGTT.GAACGCTGT	GCTTACGTT.GAACGCTGT
GCTTACGTT.TATTACTCG	GCTTACGTT.TATTACTCG
GCTTACGTT.TGTATGTAG	GCTTACGTT.TGTATGTAG
GCTTACGTT.TTGACCTGA	GCTTACGTT.TTGACCTGA
GCTTACTAG.ATTCACCTC	GCTTACTAG.ATTCACCTC
GCTTACTAG.GATTGAGTA	GCTTACTAG.GATTGAGTA
GCTTACTAG.GCCATCGCT	GCTTACTAG.GCCATCGCT
GCTTACTAG.GTGACGTAA	GCTTACTAG.GTGACGTAA
GCTTACTAG.TAATCACGC	GCTTACTAG.TAATCACGC
