AACAACCTA.ATAGTCTCC	AACAACCTA.ATAGTCTCC
AACAACCTA.CAACGTCTT	AACAACCTA.CAACGTCTT
AACAACCTA.GCTTCACTC	AACAACCTA.GCTTCACTC
AACAACCTA.GTGATGTGC	AACAACCTA.GTGATGTGC
AACAACCTA.TCTGCGCTG	AACAACCTA.TCTGCGCTG
AACAACTGG.ACGTCGCTC	AACAACTGG.ACGTCGCTC
AACAACTGG.CACCAGAAG	AACAACTGG.CACCAGAAG
AACAACTGG.GTAACCATA	AACAACTGG.GTAACCATA
AACAACTGG.GTCAGCGTC	AACAACTGG.GTCAGCGTC
AACAATGCA.ACACTGTGA	AACAATGCA.ACACTGTGA
AACAATGCA.CCGGTTCTA	AACAATGCA.CCGGTTCTA
AACAATGCA.CGAGCCGTT	AACAATGCA.CGAGCCGTT
AACAATGCA.TAGCCTTGT	AACAATGCA.TAGCCTTGT
AACAATGCA.TATTCAACG	AACAATGCA.TATTCAACG
AACAATGCA.TTCCGCCAG	AACAATGCA.TTCCGCCAG
AACACACTC.AGGATCATG	AACACACTC.AGGATCATG
AACACACTC.CAAGTCACT	AACACACTC.CAAGTCACT
AACACACTC.CATTCCGAG	AACACACTC.CATTCCGAG
AACACACTC.CCTCAGGTG	AACACACTC.CCTCAGGTG
AACACACTC.CTATAGCTC	AACACACTC.CTATAGCTC
AACACACTC.CTCATGCCA	AACACACTC.CTCATGCCA
AACACACTC.GAGATACAC	AACACACTC.GAGATACAC
AACAGATCG.AATTGGTGA	AACAGATCG.AATTGGTGA
AACAGATCG.CCATCACGA	AACAGATCG.CCATCACGA
AACAGATCG.CTAACTAAG	AACAGATCG.CTAACTAAG
AACAGATCG.GAGCCATCC	AACAGATCG.GAGCCATCC
AACAGCAGT.ATTCCTACG	AACAGCAGT.ATTCCTACG
AACAGCAGT.CGCAATCGA	AACAGCAGT.CGCAATCGA
AACAGCAGT.CGGTTCGTA	AACAGCAGT.CGGTTCGTA
AACAGCAGT.TCACCGAGG	AACAGCAGT.TCACCGAGG
AACAGCAGT.TCTGAGATA	AACAGCAGT.TCTGAGATA
AACCATGGT.GACTGCCTG	AACCATGGT.GACTGCCTG
AACCATGGT.GCCGCCTAA	AACCATGGT.GCCGCCTAA
AACCGCTGA.AATACCTTG	AACCGCTGA.AATACCTTG
AACCGCTGA.AATGCCTCA	AACCGCTGA.AATGCCTCA
AACCGCTGA.ACCGGAAGG	AACCGCTGA.ACCGGAAGG
AACCGCTGA.AGTTCGATA	AACCGCTGA.AGTTCGATA
AACCGCTGA.CTTAGGACT	AACCGCTGA.CTTAGGACT
AACCGCTGA.GGAGATGAG	AACCGCTGA.GGAGATGAG
AACCGCTGA.TACCATGTA	AACCGCTGA.TACCATGTA
AACCGCTGA.TGAGCTAGA	AACCGCTGA.TGAGCTAGA
AACCGCTGA.TTCTCCACA	AACCGCTGA.TTCTCCACA
AACCGCTGA.TTGTTAGAG	AACCGCTGA.TTGTTAGAG
AACCGTGAG.GTGTTCCAG	AACCGTGAG.GTGTTCCAG
AACCGTGAG.TCACAGGTA	AACCGTGAG.TCACAGGTA
AACCGTGAG.TGTCACATA	AACCGTGAG.TGTCACATA
AACGAGAAT.TACTCGCTG	AACGAGAAT.TACTCGCTG
AACGAGGTG.ACCTCCTAG	AACGAGGTG.ACCTCCTAG
AACGAGGTG.AGTCAGTTG	AACGAGGTG.AGTCAGTTG
AACGAGGTG.ATTCACCTC	AACGAGGTG.ATTCACCTC
AACGAGGTG.CCATCTAGG	AACGAGGTG.CCATCTAGG
AACGAGGTG.GCGTCGTCT	AACGAGGTG.GCGTCGTCT
AACGAGGTG.GTAGAAGTT	AACGAGGTG.GTAGAAGTT
AACGAGGTG.TATCGGAAC	AACGAGGTG.TATCGGAAC
AACGATGAC.GACGTAGCA	AACGATGAC.GACGTAGCA
AACGATGAC.TGTGTAGAG	AACGATGAC.TGTGTAGAG
AACGCATTG.AAGACTACC	AACGCATTG.AAGACTACC
AACGCATTG.AGTGACGAT	AACGCATTG.AGTGACGAT
AACGCATTG.ATGCGTGGA	AACGCATTG.ATGCGTGGA
AACGCATTG.GGTTCGCAA	AACGCATTG.GGTTCGCAA
AACGCCTAC.AACGTTCTT	AACGCCTAC.AACGTTCTT
AACGCCTAC.AGGAGCAAT	AACGCCTAC.AGGAGCAAT
AACGCCTAC.CATTCAGTT	AACGCCTAC.CATTCAGTT
AACGCCTAC.CCTAAGAAG	AACGCCTAC.CCTAAGAAG
AACGCCTAC.GAAGTGTGA	AACGCCTAC.GAAGTGTGA
AACGCCTAC.GGTAAGGAT	AACGCCTAC.GGTAAGGAT
AACGCCTAC.GTACCTAAC	AACGCCTAC.GTACCTAAC
AACGCCTAC.GTGGAGGTC	AACGCCTAC.GTGGAGGTC
AACGCCTAC.TATGAAGAC	AACGCCTAC.TATGAAGAC
AACGCCTAC.TCGTAATAG	AACGCCTAC.TCGTAATAG
AACGCTCAA.AGTGGAATG	AACGCTCAA.AGTGGAATG
AACGCTCAA.ATACCGCTT	AACGCTCAA.ATACCGCTT
AACGCTCAA.ATAGCACGG	AACGCTCAA.ATAGCACGG
AACGCTCAA.ATCGAATCG	AACGCTCAA.ATCGAATCG
AACGCTCAA.CCTAGTTAG	AACGCTCAA.CCTAGTTAG
AACGCTCAA.GGAGTACAG	AACGCTCAA.GGAGTACAG
AACGCTCAA.TGCTCACAC	AACGCTCAA.TGCTCACAC
AACGGAGAT.CCACATTAG	AACGGAGAT.CCACATTAG
AACGGAGAT.TATGGTTGG	AACGGAGAT.TATGGTTGG
AACGGTAGC.CCACTTCGC	AACGGTAGC.CCACTTCGC
AACGGTAGC.CCATCTAGG	AACGGTAGC.CCATCTAGG
AACGGTAGC.CCGTTCCAA	AACGGTAGC.CCGTTCCAA
AACGGTAGC.CGTTAATGG	AACGGTAGC.CGTTAATGG
AACGGTAGC.GAACATGAC	AACGGTAGC.GAACATGAC
AACGGTAGC.GCACGTAGA	AACGGTAGC.GCACGTAGA
AACGGTAGC.TATACGGAT	AACGGTAGC.TATACGGAT
AACGTCGAG.AAGAGAGAG	AACGTCGAG.AAGAGAGAG
AACGTCGAG.ACCATGTCT	AACGTCGAG.ACCATGTCT
AACGTCGAG.ATCAAGCAT	AACGTCGAG.ATCAAGCAT
AACGTCGAG.CACACTGCC	AACGTCGAG.CACACTGCC
AACGTCGAG.CGCGTACTA	AACGTCGAG.CGCGTACTA
AACGTCGAG.GTAGGACGC	AACGTCGAG.GTAGGACGC
AACGTCGAG.GTGCATCAA	AACGTCGAG.GTGCATCAA
AACGTCGAG.TAGTAACGG	AACGTCGAG.TAGTAACGG
AACGTCGAG.TCGTGCCAC	AACGTCGAG.TCGTGCCAC
AACGTCGAG.TGCGCTGCA	AACGTCGAG.TGCGCTGCA
AACGTTCTT.ACGCTAGTG	AACGTTCTT.ACGCTAGTG
AACGTTCTT.GGTGATAGG	AACGTTCTT.GGTGATAGG
AACGTTCTT.TGCATACAT	AACGTTCTT.TGCATACAT
AACTAACTG.AGCGGTAAG	AACTAACTG.AGCGGTAAG
AACTAACTG.CACCTTCCT	AACTAACTG.CACCTTCCT
AACTAACTG.CATACAACC	AACTAACTG.CATACAACC
AACTAACTG.CCAGTTACG	AACTAACTG.CCAGTTACG
AACTAACTG.TATTCAACG	AACTAACTG.TATTCAACG
AACTAACTG.TCACGACAA	AACTAACTG.TCACGACAA
AACTCCATG.CCTGTATCT	AACTCCATG.CCTGTATCT
AACTCCATG.CGACGTACG	AACTCCATG.CGACGTACG
AACTCCATG.GATCGATAC	AACTCCATG.GATCGATAC
AACTCCATG.GCGACACAG	AACTCCATG.GCGACACAG
AACTGATTC.AACAACCTA	AACTGATTC.AACAACCTA
AACTGATTC.ATCATGTTC	AACTGATTC.ATCATGTTC
AACTGATTC.CCGATACCG	AACTGATTC.CCGATACCG
AACTGATTC.CCTCTCTAG	AACTGATTC.CCTCTCTAG
AACTGATTC.TCAGCGACC	AACTGATTC.TCAGCGACC
AACTGCGAC.ATGAGCAGG	AACTGCGAC.ATGAGCAGG
AACTGCGAC.CAACGTCTT	AACTGCGAC.CAACGTCTT
AACTGCGAC.CGGAACGAG	AACTGCGAC.CGGAACGAG
AACTGCGAC.GAGTCTTCG	AACTGCGAC.GAGTCTTCG
AACTGCGAC.GCTTACGTT	AACTGCGAC.GCTTACGTT
AACTTAGCT.ACAGGTATC	AACTTAGCT.ACAGGTATC
AACTTAGCT.ATACAACCG	AACTTAGCT.ATACAACCG
AACTTAGCT.CAGCTGGAG	AACTTAGCT.CAGCTGGAG
AACTTAGCT.CCTAGTTAG	AACTTAGCT.CCTAGTTAG
AACTTAGCT.GATTGAGTA	AACTTAGCT.GATTGAGTA
AACTTAGCT.TACCGCGTT	AACTTAGCT.TACCGCGTT
AACTTCTGC.ACTCCAACT	AACTTCTGC.ACTCCAACT
AACTTCTGC.ATAAGACAG	AACTTCTGC.ATAAGACAG
AACTTCTGC.CCAGTCTCA	AACTTCTGC.CCAGTCTCA
AACTTCTGC.GTTCACTCC	AACTTCTGC.GTTCACTCC
AACTTGTCG.AAGTTGCCA	AACTTGTCG.AAGTTGCCA
AACTTGTCG.ACCTGTACC	AACTTGTCG.ACCTGTACC
AACTTGTCG.CGTCAGCAC	AACTTGTCG.CGTCAGCAC
AACTTGTCG.GGAGTACAG	AACTTGTCG.GGAGTACAG
AACTTGTCG.GTCAACTGA	AACTTGTCG.GTCAACTGA
AACTTGTCG.TCTACGCAA	AACTTGTCG.TCTACGCAA
AACTTGTCG.TGCAGTTCA	AACTTGTCG.TGCAGTTCA
AAGACGAAG.AAGGTGCTG	AAGACGAAG.AAGGTGCTG
AAGACGAAG.ACAGAGATG	AAGACGAAG.ACAGAGATG
AAGACGAAG.ACCATTCAC	AAGACGAAG.ACCATTCAC
AAGACGAAG.ACTCCGGTT	AAGACGAAG.ACTCCGGTT
AAGACGAAG.GTTGCATGG	AAGACGAAG.GTTGCATGG
AAGACGAAG.TGACCTATG	AAGACGAAG.TGACCTATG
AAGACGAAG.TTCCGCCAG	AAGACGAAG.TTCCGCCAG
AAGACTACC.TACCGCGTT	AAGACTACC.TACCGCGTT
AAGACTACC.TCGGATGTT	AAGACTACC.TCGGATGTT
AAGACTGGT.CTATTCCGT	AAGACTGGT.CTATTCCGT
AAGACTGGT.GTCAGACCG	AAGACTGGT.GTCAGACCG
AAGACTGGT.GTCGCAGGT	AAGACTGGT.GTCGCAGGT
AAGACTGGT.TCAAGGTCG	AAGACTGGT.TCAAGGTCG
AAGACTGGT.TGCTCACAC	AAGACTGGT.TGCTCACAC
AAGAGAACT.AACGGTAGC	AAGAGAACT.AACGGTAGC
AAGAGAACT.AAGCATTGC	AAGAGAACT.AAGCATTGC
AAGAGAACT.CTTATCTCA	AAGAGAACT.CTTATCTCA
AAGAGAACT.TCACACTGC	AAGAGAACT.TCACACTGC
AAGAGAACT.TCCGATCTG	AAGAGAACT.TCCGATCTG
AAGAGAACT.TCGTCCGAT	AAGAGAACT.TCGTCCGAT
AAGAGAGAG.ACGAGCTTC	AAGAGAGAG.ACGAGCTTC
AAGAGAGAG.ATCAGAAGC	AAGAGAGAG.ATCAGAAGC
AAGAGAGAG.CGGTGTTAC	AAGAGAGAG.CGGTGTTAC
AAGAGAGAG.GGACACTGG	AAGAGAGAG.GGACACTGG
AAGCAACTA.ACTAACCGA	AAGCAACTA.ACTAACCGA
AAGCAACTA.CTACGAGAA	AAGCAACTA.CTACGAGAA
AAGCAACTA.GAACGCTGT	AAGCAACTA.GAACGCTGT
AAGCAACTA.GATGTCTAG	AAGCAACTA.GATGTCTAG
AAGCAACTA.GATTAGTGT	AAGCAACTA.GATTAGTGT
AAGCAACTA.GTAGAAGTT	AAGCAACTA.GTAGAAGTT
AAGCAACTA.GTTAGTCAA	AAGCAACTA.GTTAGTCAA
AAGCAACTA.TCATATCGC	AAGCAACTA.TCATATCGC
AAGCAACTA.TCTCAGGAT	AAGCAACTA.TCTCAGGAT
AAGCAATCG.AATGCAGCG	AAGCAATCG.AATGCAGCG
AAGCAATCG.AGCGACACC	AAGCAATCG.AGCGACACC
AAGCAATCG.CCGCAACAC	AAGCAATCG.CCGCAACAC
AAGCAATCG.CTGAGGTTA	AAGCAATCG.CTGAGGTTA
AAGCAATCG.GAGCACATT	AAGCAATCG.GAGCACATT
AAGCAATCG.GCTCCTAGC	AAGCAATCG.GCTCCTAGC
AAGCAATCG.GCTTACTAG	AAGCAATCG.GCTTACTAG
AAGCAATCG.TCCAATCAT	AAGCAATCG.TCCAATCAT
AAGCAATCG.TTAACGGAG	AAGCAATCG.TTAACGGAG
AAGCACAAC.TCGGTATCA	AAGCACAAC.TCGGTATCA
AAGCACAAC.TCTAGGATG	AAGCACAAC.TCTAGGATG
AAGCACAAC.TCTATTAGG	AAGCACAAC.TCTATTAGG
AAGCACAAC.TGCAGTCGG	AAGCACAAC.TGCAGTCGG
AAGCAGCAT.ATAATGTGG	AAGCAGCAT.ATAATGTGG
AAGCAGCAT.CAAGTCGAA	AAGCAGCAT.CAAGTCGAA
AAGCAGCAT.CCGATACCG	AAGCAGCAT.CCGATACCG
AAGCAGCAT.GCCATACAA	AAGCAGCAT.GCCATACAA
AAGCAGCAT.TACCAGCCA	AAGCAGCAT.TACCAGCCA
AAGCAGCAT.TCCAACGTG	AAGCAGCAT.TCCAACGTG
AAGCAGCAT.TGCTCCTCC	AAGCAGCAT.TGCTCCTCC
AAGCAGCAT.TGGTGGTAA	AAGCAGCAT.TGGTGGTAA
AAGCATTGC.CCACTACCA	AAGCATTGC.CCACTACCA
AAGCATTGC.CGTTGATCC	AAGCATTGC.CGTTGATCC
AAGCATTGC.CTCTCAGTC	AAGCATTGC.CTCTCAGTC
AAGCATTGC.GGAGCATCT	AAGCATTGC.GGAGCATCT
AAGCCAAGT.ACCGGAAGG	AAGCCAAGT.ACCGGAAGG
AAGCCAAGT.ATAGAGCAG	AAGCCAAGT.ATAGAGCAG
AAGCCAAGT.ATGCGCCGT	AAGCCAAGT.ATGCGCCGT
AAGCCAAGT.CCTGTCATT	AAGCCAAGT.CCTGTCATT
AAGCCAAGT.CGGTAGCTT	AAGCCAAGT.CGGTAGCTT
AAGCCAAGT.GCACGCATT	AAGCCAAGT.GCACGCATT
AAGCCAAGT.GTAAGTGAG	AAGCCAAGT.GTAAGTGAG
AAGCCAAGT.TGGAGTGGA	AAGCCAAGT.TGGAGTGGA
AAGCCACAC.ACCACGGAT	AAGCCACAC.ACCACGGAT
AAGCCACAC.CGCCACCAT	AAGCCACAC.CGCCACCAT
AAGCCACAC.CTTGGATCA	AAGCCACAC.CTTGGATCA
AAGCCACAC.TCCATCATT	AAGCCACAC.TCCATCATT
AAGCCACAC.TCTCGTATC	AAGCCACAC.TCTCGTATC
AAGCCACAC.TTCTCCACA	AAGCCACAC.TTCTCCACA
AAGCTGAGG.GAGCGACTC	AAGCTGAGG.GAGCGACTC
AAGCTGAGG.TGGACGAGA	AAGCTGAGG.TGGACGAGA
AAGCTGGTC.AACACACTC	AAGCTGGTC.AACACACTC
AAGCTGGTC.ATTGCGCTA	AAGCTGGTC.ATTGCGCTA
AAGCTGGTC.CCAGTCTCA	AAGCTGGTC.CCAGTCTCA
AAGCTGGTC.GGTACTTCC	AAGCTGGTC.GGTACTTCC
AAGCTGGTC.TGTCACATA	AAGCTGGTC.TGTCACATA
AAGCTTGCA.ACACTAACG	AAGCTTGCA.ACACTAACG
AAGCTTGCA.AGGAAGGTG	AAGCTTGCA.AGGAAGGTG
AAGCTTGCA.ATATCCGAT	AAGCTTGCA.ATATCCGAT
AAGCTTGCA.CGTGTCCGA	AAGCTTGCA.CGTGTCCGA
AAGCTTGCA.GAACAACCA	AAGCTTGCA.GAACAACCA
AAGCTTGCA.TAATGTAGC	AAGCTTGCA.TAATGTAGC
AAGCTTGCA.TAGTACGTA	AAGCTTGCA.TAGTACGTA
AAGCTTGCA.TAGTTGACG	AAGCTTGCA.TAGTTGACG
AAGCTTGCA.TCGATTCAG	AAGCTTGCA.TCGATTCAG
AAGGAACAG.ACCGATCGA	AAGGAACAG.ACCGATCGA
AAGGAACAG.GGTGAGCGT	AAGGAACAG.GGTGAGCGT
AAGGAACAG.GTAGTTGGT	AAGGAACAG.GTAGTTGGT
AAGGAACAG.TCTGAGATA	AAGGAACAG.TCTGAGATA
AAGGAAGTC.CAAGTCGAA	AAGGAAGTC.CAAGTCGAA
AAGGAAGTC.GCATACATG	AAGGAAGTC.GCATACATG
AAGGAAGTC.GTCCTTCAT	AAGGAAGTC.GTCCTTCAT
AAGGAAGTC.TCCTGTCCG	AAGGAAGTC.TCCTGTCCG
AAGGAAGTC.TCTAGTGAC	AAGGAAGTC.TCTAGTGAC
AAGGATACG.AATCTCCTA	AAGGATACG.AATCTCCTA
AAGGATACG.AGTCGCCGA	AAGGATACG.AGTCGCCGA
AAGGATACG.ATGCTTCAG	AAGGATACG.ATGCTTCAG
AAGGATACG.CCAATATAC	AAGGATACG.CCAATATAC
AAGGATACG.TACCAGCCA	AAGGATACG.TACCAGCCA
AAGGATCGT.AGGATTGAG	AAGGATCGT.AGGATTGAG
AAGGATCGT.CATGGACTC	AAGGATCGT.CATGGACTC
AAGGATCGT.CGCACTGAA	AAGGATCGT.CGCACTGAA
AAGGATCGT.GGAATTCAC	AAGGATCGT.GGAATTCAC
AAGGATCGT.TGGTAGCAG	AAGGATCGT.TGGTAGCAG
AAGGTCTGA.ACTATCCTG	AAGGTCTGA.ACTATCCTG
AAGGTCTGA.AGGATCATG	AAGGTCTGA.AGGATCATG
AAGGTCTGA.CCATCTAGG	AAGGTCTGA.CCATCTAGG
AAGGTCTGA.CCGCAACAC	AAGGTCTGA.CCGCAACAC
AAGGTCTGA.CTCGACGAT	AAGGTCTGA.CTCGACGAT
AAGGTCTGA.GCGAGCAAG	AAGGTCTGA.GCGAGCAAG
AAGGTCTGA.TACAACACC	AAGGTCTGA.TACAACACC
AAGGTGCTG.ACTGTGTCA	AAGGTGCTG.ACTGTGTCA
AAGGTGCTG.ATCCAATGA	AAGGTGCTG.ATCCAATGA
AAGGTGCTG.CACACCTGT	AAGGTGCTG.CACACCTGT
AAGGTGCTG.TGCTCCTCC	AAGGTGCTG.TGCTCCTCC
AAGGTGCTG.TGCTGCGTC	AAGGTGCTG.TGCTGCGTC
AAGGTGCTG.TTCCTGCTA	AAGGTGCTG.TTCCTGCTA
AAGTACAGA.AAGCAACTA	AAGTACAGA.AAGCAACTA
AAGTACAGA.ACAGCGTAT	AAGTACAGA.ACAGCGTAT
AAGTACAGA.AGACTTCGT	AAGTACAGA.AGACTTCGT
AAGTACAGA.CGCGAGTGT	AAGTACAGA.CGCGAGTGT
AAGTACAGA.CGGTTGCGA	AAGTACAGA.CGGTTGCGA
AAGTACAGA.GATTATGCG	AAGTACAGA.GATTATGCG
AAGTACAGA.GGAACTGCT	AAGTACAGA.GGAACTGCT
AAGTACAGA.TATACGTGG	AAGTACAGA.TATACGTGG
AAGTAGGAC.AGTCGATCA	AAGTAGGAC.AGTCGATCA
AAGTAGGAC.ATATAGCGT	AAGTAGGAC.ATATAGCGT
AAGTAGGAC.CCACACAGA	AAGTAGGAC.CCACACAGA
AAGTAGGAC.CCTATTGGT	AAGTAGGAC.CCTATTGGT
AAGTAGGAC.CTGGACACT	AAGTAGGAC.CTGGACACT
AAGTAGGAC.GTTGACCAT	AAGTAGGAC.GTTGACCAT
AAGTAGGAC.TATTGCTAC	AAGTAGGAC.TATTGCTAC
AAGTAGGAC.TGCGTCTTA	AAGTAGGAC.TGCGTCTTA
AAGTAGGAC.TTCCTCGGT	AAGTAGGAC.TTCCTCGGT
AAGTCATGA.ATGAACTAG	AAGTCATGA.ATGAACTAG
AAGTCATGA.TCAAGCGTA	AAGTCATGA.TCAAGCGTA
AAGTCATGA.TGCCAATGG	AAGTCATGA.TGCCAATGG
AAGTTCTCT.AATACCTTG	AAGTTCTCT.AATACCTTG
AAGTTCTCT.ACAGGAACT	AAGTTCTCT.ACAGGAACT
AAGTTCTCT.ACTCGTCTA	AAGTTCTCT.ACTCGTCTA
AAGTTCTCT.CACCTACGC	AAGTTCTCT.CACCTACGC
AAGTTCTCT.CACGCGTAA	AAGTTCTCT.CACGCGTAA
AAGTTCTCT.CCGTTAGAC	AAGTTCTCT.CCGTTAGAC
AAGTTCTCT.TAAGCCATT	AAGTTCTCT.TAAGCCATT
AAGTTCTCT.TCAGTAAGC	AAGTTCTCT.TCAGTAAGC
AAGTTCTCT.TGAGTGACT	AAGTTCTCT.TGAGTGACT
AAGTTCTCT.TGATACCGT	AAGTTCTCT.TGATACCGT
AAGTTCTCT.TGTAACAGT	AAGTTCTCT.TGTAACAGT
AAGTTGCCA.CGAACAATC	AAGTTGCCA.CGAACAATC
AAGTTGCCA.CGTACACAC	AAGTTGCCA.CGTACACAC
AAGTTGCCA.TATGTACCT	AAGTTGCCA.TATGTACCT
AAGTTGCCA.TCACCGAGG	AAGTTGCCA.TCACCGAGG
AATAACTCC.CCGTAGTTG	AATAACTCC.CCGTAGTTG
AATAACTCC.CGCTTCACG	AATAACTCC.CGCTTCACG
AATAACTCC.GGAATTGGA	AATAACTCC.GGAATTGGA
AATAACTCC.GGTCCTGGT	AATAACTCC.GGTCCTGGT
AATAACTCC.TACAACACC	AATAACTCC.TACAACACC
AATACCTTG.ACGTTCAAT	AATACCTTG.ACGTTCAAT
AATACCTTG.CCGTTAGAC	AATACCTTG.CCGTTAGAC
AATACCTTG.CTGACGATG	AATACCTTG.CTGACGATG
AATACCTTG.GTAGCCTTG	AATACCTTG.GTAGCCTTG
AATACCTTG.TGTCACATA	AATACCTTG.TGTCACATA
AATACCTTG.TGTTGTCGA	AATACCTTG.TGTTGTCGA
AATACGTCT.AGTGGAATG	AATACGTCT.AGTGGAATG
AATACGTCT.AGTTGCCTT	AATACGTCT.AGTTGCCTT
AATACGTCT.CCGTTAGAC	AATACGTCT.CCGTTAGAC
AATACGTCT.CTTAGAAGG	AATACGTCT.CTTAGAAGG
AATACGTCT.GTCAACTGA	AATACGTCT.GTCAACTGA
AATACGTCT.GTCCGCTCA	AATACGTCT.GTCCGCTCA
AATACGTCT.GTTATCGAT	AATACGTCT.GTTATCGAT
AATACGTCT.TGCATACAT	AATACGTCT.TGCATACAT
AATACGTCT.TGCTATGAA	AATACGTCT.TGCTATGAA
AATACGTCT.TTGACCTGA	AATACGTCT.TTGACCTGA
AATACTCCG.AGTGAACGG	AATACTCCG.AGTGAACGG
AATACTCCG.CCGTCCACT	AATACTCCG.CCGTCCACT
AATACTCCG.CGATCCAGA	AATACTCCG.CGATCCAGA
AATAGACGC.AAGCTGGTC	AATAGACGC.AAGCTGGTC
AATAGACGC.ACCGTCACG	AATAGACGC.ACCGTCACG
AATAGACGC.CCACTACCA	AATAGACGC.CCACTACCA
AATAGACGC.GTCTTCATA	AATAGACGC.GTCTTCATA
AATAGACGC.TCATATCGC	AATAGACGC.TCATATCGC
AATATCAGC.ACGTATGTC	AATATCAGC.ACGTATGTC
AATATCAGC.GAATTGTTG	AATATCAGC.GAATTGTTG
AATATCAGC.GCTAGCTCC	AATATCAGC.GCTAGCTCC
AATATCGCT.GACATAACG	AATATCGCT.GACATAACG
AATATCGCT.GGATCAGGT	AATATCGCT.GGATCAGGT
AATATCGCT.GTGGAGGTC	AATATCGCT.GTGGAGGTC
AATCAGGAG.ATCCTCCGA	AATCAGGAG.ATCCTCCGA
AATCAGGAG.CAGCACGTG	AATCAGGAG.CAGCACGTG
AATCAGGAG.CCACGTTCT	AATCAGGAG.CCACGTTCT
AATCAGGAG.CCGTCCACT	AATCAGGAG.CCGTCCACT
AATCAGGAG.GGACACTGG	AATCAGGAG.GGACACTGG
AATCAGGAG.TCGTGCCAC	AATCAGGAG.TCGTGCCAC
AATCCGCTG.AACGCCTAC	AATCCGCTG.AACGCCTAC
AATCCGCTG.CAGTAATGT	AATCCGCTG.CAGTAATGT
AATCCGCTG.CGCTTATGA	AATCCGCTG.CGCTTATGA
AATCCGCTG.GAACCAGTT	AATCCGCTG.GAACCAGTT
AATCCGCTG.TACAAGAGG	AATCCGCTG.TACAAGAGG
AATCCGCTG.TTCCGCCAG	AATCCGCTG.TTCCGCCAG
AATCCTCGT.AATGCCTCA	AATCCTCGT.AATGCCTCA
AATCCTCGT.ACCGATCGA	AATCCTCGT.ACCGATCGA
AATCCTCGT.ACGAATCGC	AATCCTCGT.ACGAATCGC
AATCCTCGT.CAGTTGAGT	AATCCTCGT.CAGTTGAGT
AATCCTCGT.CCTGCGTTA	AATCCTCGT.CCTGCGTTA
AATCCTCGT.CGCTGTAGT	AATCCTCGT.CGCTGTAGT
AATCCTCGT.CGTGTCCGA	AATCCTCGT.CGTGTCCGA
AATCCTCGT.CTCTGCAAG	AATCCTCGT.CTCTGCAAG
AATCCTCGT.TGTAGGTTA	AATCCTCGT.TGTAGGTTA
AATCGCCAT.ACGTCTATG	AATCGCCAT.ACGTCTATG
AATCGCCAT.ACTAACCGA	AATCGCCAT.ACTAACCGA
AATCGCCAT.CACCAAGAT	AATCGCCAT.CACCAAGAT
AATCGCCAT.CAGTGCCAT	AATCGCCAT.CAGTGCCAT
AATCGCCAT.CCACTTCGC	AATCGCCAT.CCACTTCGC
AATCGCCAT.GAACATGAC	AATCGCCAT.GAACATGAC
AATCGCCAT.TAAGTACAC	AATCGCCAT.TAAGTACAC
AATCGTGTT.AGAAGAGTC	AATCGTGTT.AGAAGAGTC
AATCGTGTT.AGAAGTCCT	AATCGTGTT.AGAAGTCCT
AATCGTGTT.AGTCGATCA	AATCGTGTT.AGTCGATCA
AATCGTGTT.GGATAGTCA	AATCGTGTT.GGATAGTCA
AATCGTGTT.TAGCAGAGT	AATCGTGTT.TAGCAGAGT
AATCTCCTA.GAGCCATCC	AATCTCCTA.GAGCCATCC
AATCTGACC.ATATAGCGT	AATCTGACC.ATATAGCGT
AATCTGACC.CGGTTCTAT	AATCTGACC.CGGTTCTAT
AATCTGACC.GATTCTCGG	AATCTGACC.GATTCTCGG
AATCTGACC.GCCGAACCA	AATCTGACC.GCCGAACCA
AATCTGACC.GCGCATTAC	AATCTGACC.GCGCATTAC
AATCTGACC.GGTTGAAGG	AATCTGACC.GGTTGAAGG
AATGAGTCG.CGGAATGCA	AATGAGTCG.CGGAATGCA
AATGAGTCG.CTCAGGTAC	AATGAGTCG.CTCAGGTAC
AATGAGTCG.CTGCTGCTT	AATGAGTCG.CTGCTGCTT
AATGAGTCG.CTTCTATGA	AATGAGTCG.CTTCTATGA
AATGAGTCG.GGAATTGGA	AATGAGTCG.GGAATTGGA
AATGAGTCG.TAACATTGG	AATGAGTCG.TAACATTGG
AATGAGTCG.TCATCAGAG	AATGAGTCG.TCATCAGAG
AATGCACTT.ACGCGTGAC	AATGCACTT.ACGCGTGAC
AATGCACTT.ATCAAGCAT	AATGCACTT.ATCAAGCAT
AATGCACTT.GAACCAGTT	AATGCACTT.GAACCAGTT
AATGCACTT.TCACACTGC	AATGCACTT.TCACACTGC
AATGCAGCG.CCTCATAAC	AATGCAGCG.CCTCATAAC
AATGCAGCG.CGCAGTGTC	AATGCAGCG.CGCAGTGTC
AATGCAGCG.GACGTCAAT	AATGCAGCG.GACGTCAAT
AATGCAGCG.GATGTTACA	AATGCAGCG.GATGTTACA
AATGCAGCG.TAACCGTGA	AATGCAGCG.TAACCGTGA
AATGCCTCA.AGGTCACGT	AATGCCTCA.AGGTCACGT
AATGCCTCA.ATAAGTTCG	AATGCCTCA.ATAAGTTCG
AATGCCTCA.GTTAGTCAA	AATGCCTCA.GTTAGTCAA
AATGCCTCA.GTTATCGAT	AATGCCTCA.GTTATCGAT
AATGCCTCA.TATGAGACC	AATGCCTCA.TATGAGACC
AATGCGTGC.AGCGTAGAA	AATGCGTGC.AGCGTAGAA
AATGCGTGC.ATATAGCGT	AATGCGTGC.ATATAGCGT
AATGCGTGC.CAACGTCTT	AATGCGTGC.CAACGTCTT
AATGCGTGC.CAAGAACCG	AATGCGTGC.CAAGAACCG
AATGCGTGC.GCCTGGAAT	AATGCGTGC.GCCTGGAAT
AATGCGTGC.GTGATGTGC	AATGCGTGC.GTGATGTGC
AATGCGTGC.TACGACCAT	AATGCGTGC.TACGACCAT
AATGCGTGC.TGCGTCTTA	AATGCGTGC.TGCGTCTTA
AATGCTATC.CCTTGTTGC	AATGCTATC.CCTTGTTGC
AATGCTGAT.AATGCTGAT	AATGCTGAT.AATGCTGAT
AATGCTGAT.CAACACTCC	AATGCTGAT.CAACACTCC
AATGCTGAT.CGCATAACT	AATGCTGAT.CGCATAACT
AATGCTGAT.GGAATTCAC	AATGCTGAT.GGAATTCAC
AATGCTGAT.GGTTACGCA	AATGCTGAT.GGTTACGCA
AATGCTGAT.GTTAATTCG	AATGCTGAT.GTTAATTCG
AATGCTGAT.TACAGGACT	AATGCTGAT.TACAGGACT
AATGCTGAT.TTCCGAGCG	AATGCTGAT.TTCCGAGCG
AATGTGCGT.ACCTAGTTA	AATGTGCGT.ACCTAGTTA
AATGTGCGT.AGTCTAAGC	AATGTGCGT.AGTCTAAGC
AATGTGCGT.ATCGCCTCT	AATGTGCGT.ATCGCCTCT
AATGTGCGT.GATACACTA	AATGTGCGT.GATACACTA
AATGTGCGT.GTCGTGTTA	AATGTGCGT.GTCGTGTTA
AATGTGCGT.TGATAGAGG	AATGTGCGT.TGATAGAGG
AATTAGAGG.AGCAACATT	AATTAGAGG.AGCAACATT
AATTAGAGG.AGGATTGAG	AATTAGAGG.AGGATTGAG
AATTAGAGG.ATTCGAAGA	AATTAGAGG.ATTCGAAGA
AATTAGAGG.CATAAGATC	AATTAGAGG.CATAAGATC
AATTAGAGG.CTATACTAG	AATTAGAGG.CTATACTAG
AATTAGAGG.CTTGCACAA	AATTAGAGG.CTTGCACAA
AATTAGAGG.GATCTGTTC	AATTAGAGG.GATCTGTTC
AATTAGAGG.GCTACAATG	AATTAGAGG.GCTACAATG
AATTAGAGG.TTCCAGATT	AATTAGAGG.TTCCAGATT
AATTCGGAA.AGATCTGAC	AATTCGGAA.AGATCTGAC
AATTCGGAA.ATACCGCTT	AATTCGGAA.ATACCGCTT
AATTCGGAA.ATATAGCGT	AATTCGGAA.ATATAGCGT
AATTCGGAA.ATGGATATC	AATTCGGAA.ATGGATATC
AATTCGGAA.CGTACATCT	AATTCGGAA.CGTACATCT
AATTCGGAA.CTCATGCCA	AATTCGGAA.CTCATGCCA
AATTCGGAA.GCCATACAA	AATTCGGAA.GCCATACAA
AATTGGATC.ACTTGATCT	AATTGGATC.ACTTGATCT
AATTGGTGA.CAACTAATC	AATTGGTGA.CAACTAATC
AATTGGTGA.CACATGTGC	AATTGGTGA.CACATGTGC
AATTGGTGA.CCTTATCCG	AATTGGTGA.CCTTATCCG
AATTGGTGA.TTCGGAGTC	AATTGGTGA.TTCGGAGTC
ACAACCGGA.AACAATGCA	ACAACCGGA.AACAATGCA
ACAACCGGA.CCGGATTGC	ACAACCGGA.CCGGATTGC
ACAACCGGA.CGGACAAGT	ACAACCGGA.CGGACAAGT
ACAACCGGA.TATTGCTAC	ACAACCGGA.TATTGCTAC
ACAACCGGA.TCCAGCAGC	ACAACCGGA.TCCAGCAGC
ACAACCGGA.TCGTCCGAT	ACAACCGGA.TCGTCCGAT
ACAACCGGA.TTCGCATCC	ACAACCGGA.TTCGCATCC
ACAACGAGC.CAAGCTGCA	ACAACGAGC.CAAGCTGCA
ACAACGAGC.TGTTGTCGA	ACAACGAGC.TGTTGTCGA
ACAAGAATG.CGCCATTAC	ACAAGAATG.CGCCATTAC
ACAAGAATG.CTCCGCATT	ACAAGAATG.CTCCGCATT
ACAAGAATG.GTACGCGAT	ACAAGAATG.GTACGCGAT
ACAAGAATG.TAGAGCGTC	ACAAGAATG.TAGAGCGTC
ACAAGGTAC.AACACACTC	ACAAGGTAC.AACACACTC
ACAAGGTAC.GACACCGAT	ACAAGGTAC.GACACCGAT
ACAAGGTAC.GACCGCTTC	ACAAGGTAC.GACCGCTTC
ACAAGGTAC.TAGATCTGT	ACAAGGTAC.TAGATCTGT
ACAAGGTAC.TAGGAGCTA	ACAAGGTAC.TAGGAGCTA
ACAAGTACA.ACAAGTACA	ACAAGTACA.ACAAGTACA
ACAAGTACA.ACTTCTAAC	ACAAGTACA.ACTTCTAAC
ACAAGTACA.GCATGTGGT	ACAAGTACA.GCATGTGGT
ACAAGTACA.GTGCTGACT	ACAAGTACA.GTGCTGACT
ACAATAGGT.AGCAGACAA	ACAATAGGT.AGCAGACAA
ACAATAGGT.CCGGTTCTA	ACAATAGGT.CCGGTTCTA
ACAATAGGT.CCTAAGTCT	ACAATAGGT.CCTAAGTCT
ACAATAGGT.GACGTGGTC	ACAATAGGT.GACGTGGTC
ACAATAGGT.GGTCTTGCA	ACAATAGGT.GGTCTTGCA
ACAATAGGT.GTACGAACG	ACAATAGGT.GTACGAACG
ACAATAGGT.TCCAGCAGC	ACAATAGGT.TCCAGCAGC
ACAATAGGT.TTGATGCTG	ACAATAGGT.TTGATGCTG
ACAATTCGG.AGAGGTGAA	ACAATTCGG.AGAGGTGAA
ACAATTCGG.CGACCTAGC	ACAATTCGG.CGACCTAGC
ACAATTCGG.GTGCGTTCC	ACAATTCGG.GTGCGTTCC
ACAATTCGG.TGGAGAGTG	ACAATTCGG.TGGAGAGTG
ACAATTCGG.TTCTGCCGA	ACAATTCGG.TTCTGCCGA
ACACACCGT.AAGAGAACT	ACACACCGT.AAGAGAACT
ACACACCGT.AGGTCAGCA	ACACACCGT.AGGTCAGCA
ACACACCGT.ATCACCGCA	ACACACCGT.ATCACCGCA
ACACACCGT.ATGTGACGA	ACACACCGT.ATGTGACGA
ACACACCGT.CTCGTCTTG	ACACACCGT.CTCGTCTTG
ACACACCGT.GTCTCTTCA	ACACACCGT.GTCTCTTCA
ACACACCGT.TAGTCGCAT	ACACACCGT.TAGTCGCAT
ACACACGTC.ATCATGTTC	ACACACGTC.ATCATGTTC
ACACACGTC.CCTCATAAC	ACACACGTC.CCTCATAAC
ACACACGTC.GACTCTGGT	ACACACGTC.GACTCTGGT
ACACACGTC.GGAAGTATG	ACACACGTC.GGAAGTATG
ACACACGTC.GTCCACAAC	ACACACGTC.GTCCACAAC
ACACACGTC.TAAGTGTAG	ACACACGTC.TAAGTGTAG
ACACAGAAC.AACTGATTC	ACACAGAAC.AACTGATTC
ACACAGAAC.ACTAAGTTC	ACACAGAAC.ACTAAGTTC
ACACAGAAC.TAGTAGTCT	ACACAGAAC.TAGTAGTCT
ACACATCTG.AAGCAGCAT	ACACATCTG.AAGCAGCAT
ACACATCTG.ACGGTGCCT	ACACATCTG.ACGGTGCCT
ACACATCTG.AGCTTGGTG	ACACATCTG.AGCTTGGTG
ACACATCTG.CAACGTCTT	ACACATCTG.CAACGTCTT
ACACATCTG.GCATACATG	ACACATCTG.GCATACATG
ACACCACAT.CACACCTGT	ACACCACAT.CACACCTGT
ACACCACAT.GATCGATAC	ACACCACAT.GATCGATAC
ACACCACAT.TATCTGTCA	ACACCACAT.TATCTGTCA
ACACCACAT.TGAGACAGC	ACACCACAT.TGAGACAGC
ACACCACAT.TGGTTATAC	ACACCACAT.TGGTTATAC
ACACCACAT.TTCCAGATT	ACACCACAT.TTCCAGATT
ACACCGCCA.AGTCTAAGC	ACACCGCCA.AGTCTAAGC
ACACCGCCA.CAGTTACTG	ACACCGCCA.CAGTTACTG
ACACCGCCA.CGTCATGGA	ACACCGCCA.CGTCATGGA
ACACCGCCA.TTATGAGGA	ACACCGCCA.TTATGAGGA
ACACGTTGC.AAGAGAACT	ACACGTTGC.AAGAGAACT
ACACGTTGC.AGATGAGAT	ACACGTTGC.AGATGAGAT
ACACGTTGC.AGGTGCGAG	ACACGTTGC.AGGTGCGAG
