CACTGGTCC.CGGTCGACA	CACTGGTCC.CGGTCGACA
CACTGGTCC.CGTGTCCGA	CACTGGTCC.CGTGTCCGA
CACTGTATC.ACGTAGTAT	CACTGTATC.ACGTAGTAT
CACTGTATC.AGAGGACGT	CACTGTATC.AGAGGACGT
CACTGTATC.ATGATAGCT	CACTGTATC.ATGATAGCT
CACTGTATC.CGAGCCGTT	CACTGTATC.CGAGCCGTT
CACTGTATC.GCCACGAGT	CACTGTATC.GCCACGAGT
CACTGTATC.GGTGAGTTC	CACTGTATC.GGTGAGTTC
CACTGTATC.TACTAGTAG	CACTGTATC.TACTAGTAG
CACTGTATC.TCCACCGGT	CACTGTATC.TCCACCGGT
CACTTCCTT.AACGATGAC	CACTTCCTT.AACGATGAC
CACTTCCTT.ATATAGCGT	CACTTCCTT.ATATAGCGT
CACTTCCTT.CACCTACGC	CACTTCCTT.CACCTACGC
CACTTCCTT.CAGGTTGTC	CACTTCCTT.CAGGTTGTC
CACTTCCTT.CATACGCAG	CACTTCCTT.CATACGCAG
CACTTCCTT.CCTCCAATC	CACTTCCTT.CCTCCAATC
CACTTCCTT.GCGCATTAC	CACTTCCTT.GCGCATTAC
CACTTCCTT.GTCCTAGTT	CACTTCCTT.GTCCTAGTT
CACTTGGAT.ACTACCATC	CACTTGGAT.ACTACCATC
CACTTGGAT.AGAAGAGTC	CACTTGGAT.AGAAGAGTC
CACTTGGAT.CAGGTTGTC	CACTTGGAT.CAGGTTGTC
CACTTGGAT.CCACTACCA	CACTTGGAT.CCACTACCA
CACTTGGAT.TAACATTGG	CACTTGGAT.TAACATTGG
CACTTGGAT.TACGAACTC	CACTTGGAT.TACGAACTC
CACTTGGAT.TTACTAGTC	CACTTGGAT.TTACTAGTC
CAGAAGTGA.GCTGGTTCG	CAGAAGTGA.GCTGGTTCG
CAGAGCACC.CATTGCAGA	CAGAGCACC.CATTGCAGA
CAGAGCACC.CCATATGCC	CAGAGCACC.CCATATGCC
CAGAGCACC.TCATATCGC	CAGAGCACC.TCATATCGC
CAGATCATT.ATAGCACGG	CAGATCATT.ATAGCACGG
CAGATCATT.CATTCCGAG	CAGATCATT.CATTCCGAG
CAGATCATT.CCACTACCA	CAGATCATT.CCACTACCA
CAGATCATT.CTCCACGTC	CAGATCATT.CTCCACGTC
CAGATCATT.GATATGGAC	CAGATCATT.GATATGGAC
CAGATCATT.GTCAAGATC	CAGATCATT.GTCAAGATC
CAGATCATT.TGCGTGCCA	CAGATCATT.TGCGTGCCA
CAGATCGAC.AGAGCCGCA	CAGATCGAC.AGAGCCGCA
CAGATCGAC.CGGTTCTAT	CAGATCGAC.CGGTTCTAT
CAGATCGAC.GTAATCAGC	CAGATCGAC.GTAATCAGC
CAGATCGAC.TAACCGTGA	CAGATCGAC.TAACCGTGA
CAGATCGAC.TAATGTAGC	CAGATCGAC.TAATGTAGC
CAGCACGTG.GCGACAACC	CAGCACGTG.GCGACAACC
CAGCACGTG.GGTTAGATG	CAGCACGTG.GGTTAGATG
CAGCAGTAC.ACCGATCGA	CAGCAGTAC.ACCGATCGA
CAGCAGTAC.CCGCAATGG	CAGCAGTAC.CCGCAATGG
CAGCAGTAC.CGCTGTAGT	CAGCAGTAC.CGCTGTAGT
CAGCAGTAC.CTTATTGAG	CAGCAGTAC.CTTATTGAG
CAGCAGTAC.GTGCACGAG	CAGCAGTAC.GTGCACGAG
CAGCCGCAA.GCTGGTTCG	CAGCCGCAA.GCTGGTTCG
CAGCGACGT.CCGTACGGA	CAGCGACGT.CCGTACGGA
CAGCGACGT.GTCCTAGTT	CAGCGACGT.GTCCTAGTT
CAGCGACGT.TATCACCTG	CAGCGACGT.TATCACCTG
CAGCGACGT.TATCGGAAC	CAGCGACGT.TATCGGAAC
CAGCGACGT.TCCTCTAGT	CAGCGACGT.TCCTCTAGT
CAGCGTAAG.AGATGAGAT	CAGCGTAAG.AGATGAGAT
CAGCGTAAG.ATTCACCTC	CAGCGTAAG.ATTCACCTC
CAGCGTAAG.GCGAGTCTA	CAGCGTAAG.GCGAGTCTA
CAGCGTAAG.GTGTTGGAA	CAGCGTAAG.GTGTTGGAA
CAGCGTAAG.TCAAGGAGT	CAGCGTAAG.TCAAGGAGT
CAGCGTAAG.TTCCTAAGG	CAGCGTAAG.TTCCTAAGG
CAGCTAGTT.AATATCGCT	CAGCTAGTT.AATATCGCT
CAGCTAGTT.AGAAGTAAC	CAGCTAGTT.AGAAGTAAC
CAGCTAGTT.CAAGCCTCG	CAGCTAGTT.CAAGCCTCG
CAGCTAGTT.CCGTACGGA	CAGCTAGTT.CCGTACGGA
CAGCTAGTT.TACCTCCTC	CAGCTAGTT.TACCTCCTC
CAGCTAGTT.TCTAGTGAC	CAGCTAGTT.TCTAGTGAC
CAGCTCTTC.GCGATATGA	CAGCTCTTC.GCGATATGA
CAGCTCTTC.TCGTTCTCC	CAGCTCTTC.TCGTTCTCC
CAGCTGGAG.AGTCGATCA	CAGCTGGAG.AGTCGATCA
CAGCTGGAG.CTCTGCAAG	CAGCTGGAG.CTCTGCAAG
CAGCTGGAG.GAAGGATCA	CAGCTGGAG.GAAGGATCA
CAGCTGGAG.GCTACAATG	CAGCTGGAG.GCTACAATG
CAGCTGGAG.TAAGGTGAT	CAGCTGGAG.TAAGGTGAT
CAGCTGGAG.TGATTGTGC	CAGCTGGAG.TGATTGTGC
CAGCTGGAG.TTCCTCGGT	CAGCTGGAG.TTCCTCGGT
CAGCTTACC.GATTAGTGT	CAGCTTACC.GATTAGTGT
CAGCTTACC.GCTGAGCAG	CAGCTTACC.GCTGAGCAG
CAGCTTACC.GTAACCATA	CAGCTTACC.GTAACCATA
CAGCTTACC.GTGCTAAGC	CAGCTTACC.GTGCTAAGC
CAGCTTACC.TGGAGAGTG	CAGCTTACC.TGGAGAGTG
CAGCTTCGA.ACCATACTT	CAGCTTCGA.ACCATACTT
CAGCTTCGA.CACACTGCC	CAGCTTCGA.CACACTGCC
CAGCTTCGA.CTCGTTCAC	CAGCTTCGA.CTCGTTCAC
CAGCTTCGA.CTCTCAGTC	CAGCTTCGA.CTCTCAGTC
CAGCTTCGA.CTGAGTAGC	CAGCTTCGA.CTGAGTAGC
CAGCTTCGA.GCGCTACCT	CAGCTTCGA.GCGCTACCT
CAGCTTCGA.TGAGATCAT	CAGCTTCGA.TGAGATCAT
CAGCTTCGA.TTCTGGTGC	CAGCTTCGA.TTCTGGTGC
CAGGAGCCT.AGCAGACAA	CAGGAGCCT.AGCAGACAA
CAGGAGCCT.AGCGTAGAA	CAGGAGCCT.AGCGTAGAA
CAGGAGCCT.CTCTAAGAG	CAGGAGCCT.CTCTAAGAG
CAGGAGCCT.CTGCTTAGG	CAGGAGCCT.CTGCTTAGG
CAGGAGCCT.GGTAGCATC	CAGGAGCCT.GGTAGCATC
CAGGAGCCT.GTACGCGAT	CAGGAGCCT.GTACGCGAT
CAGGAGCCT.GTGCTAAGC	CAGGAGCCT.GTGCTAAGC
CAGGATCAA.ACATTCCAC	CAGGATCAA.ACATTCCAC
CAGGATCAA.ACGGTGCCT	CAGGATCAA.ACGGTGCCT
CAGGATCAA.AGTTGAGCG	CAGGATCAA.AGTTGAGCG
CAGGATCAA.CTTCTGAGT	CAGGATCAA.CTTCTGAGT
CAGGATCAA.GATGTCTAG	CAGGATCAA.GATGTCTAG
CAGGATCAA.GGTTCTATC	CAGGATCAA.GGTTCTATC
CAGGATCAA.GTAAGGTCC	CAGGATCAA.GTAAGGTCC
CAGGATCAA.TCACACTGC	CAGGATCAA.TCACACTGC
CAGGATCAA.TCTGTGAAG	CAGGATCAA.TCTGTGAAG
CAGGTATCG.AGGATCTCA	CAGGTATCG.AGGATCTCA
CAGGTATCG.CACCAAGAT	CAGGTATCG.CACCAAGAT
CAGGTATCG.CTGACGATG	CAGGTATCG.CTGACGATG
CAGGTATCG.TCACCGAGG	CAGGTATCG.TCACCGAGG
CAGGTATCG.TGTTACTGA	CAGGTATCG.TGTTACTGA
CAGGTATCG.TTACAGTGT	CAGGTATCG.TTACAGTGT
CAGGTATCG.TTGCGAACA	CAGGTATCG.TTGCGAACA
CAGGTTGTC.AACTAACTG	CAGGTTGTC.AACTAACTG
CAGGTTGTC.AAGACGAAG	CAGGTTGTC.AAGACGAAG
CAGGTTGTC.ACACAGAAC	CAGGTTGTC.ACACAGAAC
CAGGTTGTC.AGAGAGTGG	CAGGTTGTC.AGAGAGTGG
CAGGTTGTC.CCAGTCTCA	CAGGTTGTC.CCAGTCTCA
CAGGTTGTC.CTAACCGGT	CAGGTTGTC.CTAACCGGT
CAGGTTGTC.GATAGTTCT	CAGGTTGTC.GATAGTTCT
CAGGTTGTC.TACCTATCC	CAGGTTGTC.TACCTATCC
CAGGTTGTC.TTGAGCTCT	CAGGTTGTC.TTGAGCTCT
CAGTAATGT.AGCCGTTCT	CAGTAATGT.AGCCGTTCT
CAGTAATGT.CCGTTAGAC	CAGTAATGT.CCGTTAGAC
CAGTAATGT.GCTGGTAAC	CAGTAATGT.GCTGGTAAC
CAGTACATC.ACCTGTACC	CAGTACATC.ACCTGTACC
CAGTACATC.AGCCAGGAC	CAGTACATC.AGCCAGGAC
CAGTACATC.AGTTACAAG	CAGTACATC.AGTTACAAG
CAGTACATC.CACTGCTTA	CAGTACATC.CACTGCTTA
CAGTACATC.CTTCGTGCA	CAGTACATC.CTTCGTGCA
CAGTACATC.TCCTTCGTA	CAGTACATC.TCCTTCGTA
CAGTATGAT.AGAGCGCGA	CAGTATGAT.AGAGCGCGA
CAGTATGAT.AGTCAGTTG	CAGTATGAT.AGTCAGTTG
CAGTATGAT.ATGAGATCC	CAGTATGAT.ATGAGATCC
CAGTATGAT.CATATGCGA	CAGTATGAT.CATATGCGA
CAGTCCTAA.ATGCCTTCA	CAGTCCTAA.ATGCCTTCA
CAGTCCTAA.CAGCTCTTC	CAGTCCTAA.CAGCTCTTC
CAGTCCTAA.CCACGAAGG	CAGTCCTAA.CCACGAAGG
CAGTCCTAA.CCATATGCC	CAGTCCTAA.CCATATGCC
CAGTCCTAA.TGGATAGGT	CAGTCCTAA.TGGATAGGT
CAGTCGGTA.AACGTCGAG	CAGTCGGTA.AACGTCGAG
CAGTCGGTA.CACCTCAAC	CAGTCGGTA.CACCTCAAC
CAGTCGGTA.GTCCGCTCA	CAGTCGGTA.GTCCGCTCA
CAGTCGGTA.GTCGTTGCG	CAGTCGGTA.GTCGTTGCG
CAGTCGGTA.TGTCTACAC	CAGTCGGTA.TGTCTACAC
CAGTCGGTA.TGTTAAGCC	CAGTCGGTA.TGTTAAGCC
CAGTCGGTA.TTCACCTTG	CAGTCGGTA.TTCACCTTG
CAGTCTAAC.ACCGACGGT	CAGTCTAAC.ACCGACGGT
CAGTCTAAC.ACTGGTCAG	CAGTCTAAC.ACTGGTCAG
CAGTCTAAC.AGTTAGGTC	CAGTCTAAC.AGTTAGGTC
CAGTCTAAC.CCTACTAGA	CAGTCTAAC.CCTACTAGA
CAGTCTAAC.GAGTCCAAT	CAGTCTAAC.GAGTCCAAT
CAGTCTAAC.GCTAGCTCC	CAGTCTAAC.GCTAGCTCC
CAGTCTAAC.TGCTATGAA	CAGTCTAAC.TGCTATGAA
CAGTGAGGA.AATGCCTCA	CAGTGAGGA.AATGCCTCA
CAGTGAGGA.ACCACTAGG	CAGTGAGGA.ACCACTAGG
CAGTGAGGA.ACCTAGTTA	CAGTGAGGA.ACCTAGTTA
CAGTGAGGA.ACTGACTAC	CAGTGAGGA.ACTGACTAC
CAGTGAGGA.GAATTGTTG	CAGTGAGGA.GAATTGTTG
CAGTGAGGA.TCTCATCGG	CAGTGAGGA.TCTCATCGG
CAGTGCCAT.AAGCAATCG	CAGTGCCAT.AAGCAATCG
CAGTGCCAT.CAGATCATT	CAGTGCCAT.CAGATCATT
CAGTGCCAT.CTATGGATG	CAGTGCCAT.CTATGGATG
CAGTGCCAT.GATGCGGTT	CAGTGCCAT.GATGCGGTT
CAGTGCCAT.GGTACTTCC	CAGTGCCAT.GGTACTTCC
CAGTGCCAT.TGGAGAACC	CAGTGCCAT.TGGAGAACC
CAGTTACTG.ACCGTACGC	CAGTTACTG.ACCGTACGC
CAGTTACTG.ACGATGGAA	CAGTTACTG.ACGATGGAA
CAGTTACTG.GCTGATGTC	CAGTTACTG.GCTGATGTC
CAGTTACTG.TATTGCTAC	CAGTTACTG.TATTGCTAC
CAGTTACTG.TCAGTGCAA	CAGTTACTG.TCAGTGCAA
CAGTTACTG.TCCTGAGAC	CAGTTACTG.TCCTGAGAC
CAGTTGAGT.CCGATCAGC	CAGTTGAGT.CCGATCAGC
CAGTTGAGT.GTAACAGTC	CAGTTGAGT.GTAACAGTC
CAGTTGAGT.TAGTAACGG	CAGTTGAGT.TAGTAACGG
CAGTTGAGT.TGAACTTGC	CAGTTGAGT.TGAACTTGC
CATAAGATC.AGGATCTCA	CATAAGATC.AGGATCTCA
CATAAGATC.AGTGTGCAC	CATAAGATC.AGTGTGCAC
CATAAGATC.CCTCGCGTT	CATAAGATC.CCTCGCGTT
CATAAGATC.CCTTGTTGC	CATAAGATC.CCTTGTTGC
CATAAGATC.CTAGAGGTA	CATAAGATC.CTAGAGGTA
CATAAGATC.GACGGACTA	CATAAGATC.GACGGACTA
CATAATTGG.ATCCACAGT	CATAATTGG.ATCCACAGT
CATAATTGG.CAATGCATT	CATAATTGG.CAATGCATT
CATAATTGG.CAGATCGAC	CATAATTGG.CAGATCGAC
CATAATTGG.CAGTACATC	CATAATTGG.CAGTACATC
CATAATTGG.CCAACAACA	CATAATTGG.CCAACAACA
CATAATTGG.CCGCAATGG	CATAATTGG.CCGCAATGG
CATAATTGG.CGGAAGACG	CATAATTGG.CGGAAGACG
CATAATTGG.GATGTTACA	CATAATTGG.GATGTTACA
CATAATTGG.GGTGTGACC	CATAATTGG.GGTGTGACC
CATAATTGG.TCCACCTCA	CATAATTGG.TCCACCTCA
CATAATTGG.TCGAATAGA	CATAATTGG.TCGAATAGA
CATAATTGG.TCTATGACA	CATAATTGG.TCTATGACA
CATAATTGG.TGCTTACGG	CATAATTGG.TGCTTACGG
CATACAACC.CCATATGCC	CATACAACC.CCATATGCC
CATACAACC.CGTCAGCAC	CATACAACC.CGTCAGCAC
CATACAACC.GGATACAAT	CATACAACC.GGATACAAT
CATACGCAG.ACAATAGGT	CATACGCAG.ACAATAGGT
CATACGCAG.ATGAGGTAT	CATACGCAG.ATGAGGTAT
CATACGCAG.CTCGTTCAC	CATACGCAG.CTCGTTCAC
CATACGCAG.TAGATCTGT	CATACGCAG.TAGATCTGT
CATACGCAG.TCGGTATCA	CATACGCAG.TCGGTATCA
CATAGAGAT.AGCGCATGA	CATAGAGAT.AGCGCATGA
CATAGAGAT.ATTGACACG	CATAGAGAT.ATTGACACG
CATAGAGAT.GAACTGCAA	CATAGAGAT.GAACTGCAA
CATAGAGAT.GAGACATTG	CATAGAGAT.GAGACATTG
CATAGAGAT.TGCTCAGCG	CATAGAGAT.TGCTCAGCG
CATAGGTGT.AGATGTTGG	CATAGGTGT.AGATGTTGG
CATAGGTGT.AGTAATCAG	CATAGGTGT.AGTAATCAG
CATAGGTGT.CAGTGCCAT	CATAGGTGT.CAGTGCCAT
CATAGGTGT.CATTGACAA	CATAGGTGT.CATTGACAA
CATAGGTGT.CCACGGATC	CATAGGTGT.CCACGGATC
CATAGGTGT.CGCAGTGTC	CATAGGTGT.CGCAGTGTC
CATAGGTGT.GCTACAATG	CATAGGTGT.GCTACAATG
CATAGGTGT.GTGAGGACG	CATAGGTGT.GTGAGGACG
CATAGGTGT.GTGTCTGGA	CATAGGTGT.GTGTCTGGA
CATAGGTGT.GTGTTCCAG	CATAGGTGT.GTGTTCCAG
CATAGGTGT.TACCGCGTT	CATAGGTGT.TACCGCGTT
CATAGTATG.AAGAGAGAG	CATAGTATG.AAGAGAGAG
CATAGTATG.AAGTCATGA	CATAGTATG.AAGTCATGA
CATAGTATG.AATCTCCTA	CATAGTATG.AATCTCCTA
CATAGTATG.AGCATTCCA	CATAGTATG.AGCATTCCA
CATAGTATG.CAACACTCC	CATAGTATG.CAACACTCC
CATAGTATG.CGATACTCT	CATAGTATG.CGATACTCT
CATAGTATG.CTGTCACTT	CATAGTATG.CTGTCACTT
CATAGTATG.TAACGTGTC	CATAGTATG.TAACGTGTC
CATATGCGA.ACTGGACCA	CATATGCGA.ACTGGACCA
CATATGCGA.AGGAATTGG	CATATGCGA.AGGAATTGG
CATATGCGA.ATCACCGCA	CATATGCGA.ATCACCGCA
CATATGCGA.CGACAGGAA	CATATGCGA.CGACAGGAA
CATATGCGA.CGTCGTCAA	CATATGCGA.CGTCGTCAA
CATATGCGA.GGTGATAGG	CATATGCGA.GGTGATAGG
CATATGCGA.GTCGTGTTA	CATATGCGA.GTCGTGTTA
CATATGTCG.ATAAGACAG	CATATGTCG.ATAAGACAG
CATATGTCG.CCATACGAT	CATATGTCG.CCATACGAT
CATATGTCG.CGGTGTTAC	CATATGTCG.CGGTGTTAC
CATATGTCG.GGATCGTTC	CATATGTCG.GGATCGTTC
CATATGTCG.TACGACTTG	CATATGTCG.TACGACTTG
CATATGTCG.TCGCTTAAC	CATATGTCG.TCGCTTAAC
CATCAATAG.GTCCTTCAT	CATCAATAG.GTCCTTCAT
CATCAATAG.TAGCACACG	CATCAATAG.TAGCACACG
CATCAATAG.TGTCATAGC	CATCAATAG.TGTCATAGC
CATCAATAG.TTCCAGATT	CATCAATAG.TTCCAGATT
CATCCACCG.ACTTCTAAC	CATCCACCG.ACTTCTAAC
CATCCACCG.ATATTCGCA	CATCCACCG.ATATTCGCA
CATCCACCG.CATCAATAG	CATCCACCG.CATCAATAG
CATCCACCG.CCATGCGTC	CATCCACCG.CCATGCGTC
CATCCACCG.GTGTCACAC	CATCCACCG.GTGTCACAC
CATCCAGGA.ACTCACGAA	CATCCAGGA.ACTCACGAA
CATCCAGGA.CACCTTCCT	CATCCAGGA.CACCTTCCT
CATCCAGGA.GAATAAGAG	CATCCAGGA.GAATAAGAG
CATCCAGGA.GGAGATGAG	CATCCAGGA.GGAGATGAG
CATCCAGGA.TCTAGGATG	CATCCAGGA.TCTAGGATG
CATCCGACA.TGATACCGT	CATCCGACA.TGATACCGT
CATCCGACA.TGCCAGACG	CATCCGACA.TGCCAGACG
CATCCTCTC.ATCTCGTGA	CATCCTCTC.ATCTCGTGA
CATCCTCTC.GGAAGAAGC	CATCCTCTC.GGAAGAAGC
CATCCTCTC.GTAGCTACA	CATCCTCTC.GTAGCTACA
CATCCTCTC.TTGGACTTC	CATCCTCTC.TTGGACTTC
CATCGAAGC.AAGACTACC	CATCGAAGC.AAGACTACC
CATCGAAGC.ACAATTCGG	CATCGAAGC.ACAATTCGG
CATCGAAGC.AGCTCTCCG	CATCGAAGC.AGCTCTCCG
CATCGAAGC.AGGTGTACA	CATCGAAGC.AGGTGTACA
CATCGAAGC.ATGAGGTAT	CATCGAAGC.ATGAGGTAT
CATCGAAGC.CCGCTCATG	CATCGAAGC.CCGCTCATG
CATCGAAGC.CTGCAAGCC	CATCGAAGC.CTGCAAGCC
CATCGAAGC.GAATTCAGT	CATCGAAGC.GAATTCAGT
CATCGAAGC.GCCGAGTCT	CATCGAAGC.GCCGAGTCT
CATCGAAGC.TAACACGAG	CATCGAAGC.TAACACGAG
CATCGAAGC.TAGATAGCC	CATCGAAGC.TAGATAGCC
CATCGAAGC.TATTCAACG	CATCGAAGC.TATTCAACG
CATCGAAGC.TCCACCGGT	CATCGAAGC.TCCACCGGT
CATCGAAGC.TCGTGACGT	CATCGAAGC.TCGTGACGT
CATCGAAGC.TTACGCTCG	CATCGAAGC.TTACGCTCG
CATCGCTGG.AATTAGAGG	CATCGCTGG.AATTAGAGG
CATCGCTGG.ACAACCGGA	CATCGCTGG.ACAACCGGA
CATCGCTGG.CCACGCCAT	CATCGCTGG.CCACGCCAT
CATCGCTGG.GCCAACAAT	CATCGCTGG.GCCAACAAT
CATCGCTGG.GGTTAGATG	CATCGCTGG.GGTTAGATG
CATCGCTGG.TCAGACAAG	CATCGCTGG.TCAGACAAG
CATCGCTGG.TTGGTAACT	CATCGCTGG.TTGGTAACT
CATCTCACG.ACAGAAGAG	CATCTCACG.ACAGAAGAG
CATCTCACG.CAACTAATC	CATCTCACG.CAACTAATC
CATCTCACG.GCTAGTGGA	CATCTCACG.GCTAGTGGA
CATCTCACG.GGATTCGTC	CATCTCACG.GGATTCGTC
CATCTCACG.GTGCATCAA	CATCTCACG.GTGCATCAA
CATCTCACG.GTGTCCGTG	CATCTCACG.GTGTCCGTG
CATCTCACG.TCATGCTCA	CATCTCACG.TCATGCTCA
CATCTCACG.TGGAACTAA	CATCTCACG.TGGAACTAA
CATCTCGAT.AGGTCAGCA	CATCTCGAT.AGGTCAGCA
CATCTCGAT.TAAGCCATT	CATCTCGAT.TAAGCCATT
CATCTCGAT.TAGTAACGG	CATCTCGAT.TAGTAACGG
CATGACGTT.CACTGTATC	CATGACGTT.CACTGTATC
CATGACGTT.CGCATCTAC	CATGACGTT.CGCATCTAC
CATGACGTT.GTTATCGAT	CATGACGTT.GTTATCGAT
CATGCCAGT.ATAGAGCAG	CATGCCAGT.ATAGAGCAG
CATGCCAGT.GTGCTCGGA	CATGCCAGT.GTGCTCGGA
CATGCCAGT.TGACCTATG	CATGCCAGT.TGACCTATG
CATGCCAGT.TTGTAATGC	CATGCCAGT.TTGTAATGC
CATGGACTC.ACCGAGACA	CATGGACTC.ACCGAGACA
CATGGACTC.ATGCGCTAC	CATGGACTC.ATGCGCTAC
CATGGACTC.CACTGTATC	CATGGACTC.CACTGTATC
CATGGACTC.CCTGTATCT	CATGGACTC.CCTGTATCT
CATGGACTC.GCAACTCGC	CATGGACTC.GCAACTCGC
CATGGTCGA.AAGGATACG	CATGGTCGA.AAGGATACG
CATGGTCGA.AATGCTATC	CATGGTCGA.AATGCTATC
CATGGTCGA.AGACCACGC	CATGGTCGA.AGACCACGC
CATGGTCGA.ATAGCACGG	CATGGTCGA.ATAGCACGG
CATGGTCGA.CACGTCATA	CATGGTCGA.CACGTCATA
CATGGTCGA.GGTGTTCAT	CATGGTCGA.GGTGTTCAT
CATGGTCGA.TATACGGAT	CATGGTCGA.TATACGGAT
CATGGTTAC.ACGGTGTAC	CATGGTTAC.ACGGTGTAC
CATGGTTAC.AGACTTCGT	CATGGTTAC.AGACTTCGT
CATGGTTAC.CCTGACCTC	CATGGTTAC.CCTGACCTC
CATGGTTAC.GTGTATCTG	CATGGTTAC.GTGTATCTG
CATGGTTAC.TGCGTATCT	CATGGTTAC.TGCGTATCT
CATGGTTAC.TGGATTAGC	CATGGTTAC.TGGATTAGC
CATGGTTAC.TTGTAATGC	CATGGTTAC.TTGTAATGC
CATGTCCTG.GATCTGTTC	CATGTCCTG.GATCTGTTC
CATGTGAAC.GATGCGACG	CATGTGAAC.GATGCGACG
CATGTGAAC.GTGCGTTCC	CATGTGAAC.GTGCGTTCC
CATTATGTC.ATAGCACGG	CATTATGTC.ATAGCACGG
CATTATGTC.CCGGTGGTT	CATTATGTC.CCGGTGGTT
CATTATGTC.TCCGTATAC	CATTATGTC.TCCGTATAC
CATTATGTC.TTCACCTTG	CATTATGTC.TTCACCTTG
CATTATGTC.TTGTTAGAG	CATTATGTC.TTGTTAGAG
CATTCAGTT.CCATAAGTA	CATTCAGTT.CCATAAGTA
CATTCAGTT.CTGGTAATC	CATTCAGTT.CTGGTAATC
CATTCAGTT.GCAGATCCG	CATTCAGTT.GCAGATCCG
CATTCAGTT.GCTTACGTT	CATTCAGTT.GCTTACGTT
CATTCAGTT.TAATGTAGC	CATTCAGTT.TAATGTAGC
CATTCCGAG.AATCCTCGT	CATTCCGAG.AATCCTCGT
CATTCCGAG.ATAATGTGG	CATTCCGAG.ATAATGTGG
CATTCCGAG.ATTAAGACC	CATTCCGAG.ATTAAGACC
CATTCCGAG.ATTCTCTGG	CATTCCGAG.ATTCTCTGG
CATTCCGAG.CCTAAGTCT	CATTCCGAG.CCTAAGTCT
CATTCCGAG.GATCGCGAA	CATTCCGAG.GATCGCGAA
CATTCCGAG.GATGCAGAA	CATTCCGAG.GATGCAGAA
CATTCCGAG.GCGACACAG	CATTCCGAG.GCGACACAG
CATTCCGAG.TACGACTTG	CATTCCGAG.TACGACTTG
CATTCCGAG.TGGTAGCAG	CATTCCGAG.TGGTAGCAG
CATTCCGAG.TGGTGGTAA	CATTCCGAG.TGGTGGTAA
CATTCGAAT.AAGGTGCTG	CATTCGAAT.AAGGTGCTG
CATTCGAAT.CCAGGAGTT	CATTCGAAT.CCAGGAGTT
CATTCGAAT.TGCTGCGTC	CATTCGAAT.TGCTGCGTC
CATTCGAAT.TTGTCAACC	CATTCGAAT.TTGTCAACC
CATTGACAA.ACATCGTCC	CATTGACAA.ACATCGTCC
CATTGACAA.CTCTCAGTC	CATTGACAA.CTCTCAGTC
CATTGACAA.GCGAGCAAG	CATTGACAA.GCGAGCAAG
CATTGACAA.TGACAAGTT	CATTGACAA.TGACAAGTT
CATTGCAGA.ATTCGCTTA	CATTGCAGA.ATTCGCTTA
CATTGCAGA.CGTCGTCAA	CATTGCAGA.CGTCGTCAA
CATTGCAGA.CTCTGCGGT	CATTGCAGA.CTCTGCGGT
CATTGCAGA.GTCAGCGTC	CATTGCAGA.GTCAGCGTC
CATTGTTCA.AGGATCTCA	CATTGTTCA.AGGATCTCA
CATTGTTCA.CGAATGAGT	CATTGTTCA.CGAATGAGT
CATTGTTCA.CTGTCTAGT	CATTGTTCA.CTGTCTAGT
CCAACAACA.AGAAGAGTC	CCAACAACA.AGAAGAGTC
CCAACAACA.ATCTCGAAC	CCAACAACA.ATCTCGAAC
CCAACAACA.CAACCGGTC	CCAACAACA.CAACCGGTC
CCAACAACA.GGTGAGTTC	CCAACAACA.GGTGAGTTC
CCAACAACA.TATCATGCT	CCAACAACA.TATCATGCT
CCAACAACA.TGAACCAAT	CCAACAACA.TGAACCAAT
CCAACAACA.TGAGACAGC	CCAACAACA.TGAGACAGC
CCAACAACA.TTAGCGTCT	CCAACAACA.TTAGCGTCT
CCAACGGAA.CCACGCCAT	CCAACGGAA.CCACGCCAT
CCAACGGAA.CTGTCTAGT	CCAACGGAA.CTGTCTAGT
CCAACGGAA.CTTCTGAGT	CCAACGGAA.CTTCTGAGT
CCAACGGAA.GCCGTGAAC	CCAACGGAA.GCCGTGAAC
CCAACGGAA.TAAGCACTA	CCAACGGAA.TAAGCACTA
CCAACGGAA.TAAGGTGAT	CCAACGGAA.TAAGGTGAT
CCAACGGAA.TTCCTCGGT	CCAACGGAA.TTCCTCGGT
CCAAGCGAG.AGCGGAACA	CCAAGCGAG.AGCGGAACA
CCAAGCGAG.GCTTACGTT	CCAAGCGAG.GCTTACGTT
CCAAGCGAG.GCTTGGTTC	CCAAGCGAG.GCTTGGTTC
CCAAGCGAG.TATAATCGC	CCAAGCGAG.TATAATCGC
CCAAGCGAG.TGATCTCGG	CCAAGCGAG.TGATCTCGG
CCAAGTCGA.AATCCTCGT	CCAAGTCGA.AATCCTCGT
CCAAGTCGA.CTACGGTAT	CCAAGTCGA.CTACGGTAT
CCAAGTCGA.CTCCAGCGT	CCAAGTCGA.CTCCAGCGT
CCAAGTCGA.TCTAGGATG	CCAAGTCGA.TCTAGGATG
CCAAGTCGA.TTCTGGTGC	CCAAGTCGA.TTCTGGTGC
CCAATATAC.AACAGATCG	CCAATATAC.AACAGATCG
CCAATATAC.CGGTGTTAC	CCAATATAC.CGGTGTTAC
CCAATATAC.CTCGTGTCC	CCAATATAC.CTCGTGTCC
CCAATATAC.CTGCTGCTT	CCAATATAC.CTGCTGCTT
CCAATATAC.GGATGCGAA	CCAATATAC.GGATGCGAA
CCAATATAC.GGTCCTAAG	CCAATATAC.GGTCCTAAG
CCAATATAC.TACAAGAGG	CCAATATAC.TACAAGAGG
CCAATGCCT.ACAACGAGC	CCAATGCCT.ACAACGAGC
CCAATGCCT.AGTAGAGGA	CCAATGCCT.AGTAGAGGA
CCAATGCCT.CTCGCAAGA	CCAATGCCT.CTCGCAAGA
CCAATGCCT.CTGGAGCGA	CCAATGCCT.CTGGAGCGA
CCAATGCCT.GCCGAACCA	CCAATGCCT.GCCGAACCA
CCAATGCCT.TAATCACGC	CCAATGCCT.TAATCACGC
CCACAAGGT.AGCCTCTAG	CCACAAGGT.AGCCTCTAG
CCACAAGGT.CTTAAGTTG	CCACAAGGT.CTTAAGTTG
CCACAAGGT.TGGTGCCTG	CCACAAGGT.TGGTGCCTG
CCACACAGA.ACTACTCAT	CCACACAGA.ACTACTCAT
CCACACAGA.CAGCTGGAG	CCACACAGA.CAGCTGGAG
CCACACAGA.CGACCTAGC	CCACACAGA.CGACCTAGC
CCACACAGA.CTGTAGAAG	CCACACAGA.CTGTAGAAG
CCACACAGA.TCCAGCAGC	CCACACAGA.TCCAGCAGC
CCACATTAG.AATGCTGAT	CCACATTAG.AATGCTGAT
CCACATTAG.ACACTGTGA	CCACATTAG.ACACTGTGA
CCACATTAG.ATAGACCGA	CCACATTAG.ATAGACCGA
CCACATTAG.CTCGTCTTG	CCACATTAG.CTCGTCTTG
CCACATTAG.TAGCGCAGC	CCACATTAG.TAGCGCAGC
CCACCATGC.ACGACATCT	CCACCATGC.ACGACATCT
CCACCATGC.ACTCCTGAG	CCACCATGC.ACTCCTGAG
CCACCATGC.AGCAGACAA	CCACCATGC.AGCAGACAA
CCACCATGC.ATGTGACGA	CCACCATGC.ATGTGACGA
CCACCATGC.CGCAATCGA	CCACCATGC.CGCAATCGA
CCACCATGC.CTCATGCCA	CCACCATGC.CTCATGCCA
CCACCATGC.CTCCACGTC	CCACCATGC.CTCCACGTC
CCACCATGC.CTTCACTGT	CCACCATGC.CTTCACTGT
CCACCATGC.TCCTTAGGT	CCACCATGC.TCCTTAGGT
CCACGAAGG.AGAAGTAAC	CCACGAAGG.AGAAGTAAC
CCACGAAGG.CCGCAGCTA	CCACGAAGG.CCGCAGCTA
CCACGAAGG.GCCGTGAAC	CCACGAAGG.GCCGTGAAC
CCACGCCAT.AATCTCCTA	CCACGCCAT.AATCTCCTA
CCACGCCAT.AGTGTGCAC	CCACGCCAT.AGTGTGCAC
CCACGCCAT.GACAGGTTA	CCACGCCAT.GACAGGTTA
CCACGCCAT.GCTGACAGA	CCACGCCAT.GCTGACAGA
CCACGCCAT.TGACTGAGA	CCACGCCAT.TGACTGAGA
CCACGGATC.ATCCATTAG	CCACGGATC.ATCCATTAG
CCACGGATC.CCGTCAGGT	CCACGGATC.CCGTCAGGT
CCACGGATC.CGTATAGCG	CCACGGATC.CGTATAGCG
CCACGGATC.TAGTAGTCT	CCACGGATC.TAGTAGTCT
CCACGTTCT.AAGGATACG	CCACGTTCT.AAGGATACG
CCACGTTCT.CCAGTCTCA	CCACGTTCT.CCAGTCTCA
CCACGTTCT.CCTCCAATC	CCACGTTCT.CCTCCAATC
CCACGTTCT.CTACGGTAT	CCACGTTCT.CTACGGTAT
CCACGTTCT.GTGTCGAGC	CCACGTTCT.GTGTCGAGC
CCACTACCA.ACTGGTGCT	CCACTACCA.ACTGGTGCT
CCACTACCA.CTAGACATG	CCACTACCA.CTAGACATG
CCACTACCA.CTAGAGTCG	CCACTACCA.CTAGAGTCG
CCACTACCA.GTATGATCT	CCACTACCA.GTATGATCT
CCACTACCA.TCTAGTGAC	CCACTACCA.TCTAGTGAC
CCACTGAAG.AGAAGAGTC	CCACTGAAG.AGAAGAGTC
CCACTGAAG.AGGTCCGTC	CCACTGAAG.AGGTCCGTC
CCACTGAAG.ATTCGAAGA	CCACTGAAG.ATTCGAAGA
CCACTGAAG.CCGCAGAAT	CCACTGAAG.CCGCAGAAT
CCACTGAAG.CCTAGTCTC	CCACTGAAG.CCTAGTCTC
CCACTGAAG.CGATTCGAG	CCACTGAAG.CGATTCGAG
CCACTGAAG.CTTGATCTA	CCACTGAAG.CTTGATCTA
CCACTGAAG.GATCGCGAA	CCACTGAAG.GATCGCGAA
CCACTGAAG.TTCTGGTGC	CCACTGAAG.TTCTGGTGC
CCACTTCGC.AAGGATACG	CCACTTCGC.AAGGATACG
CCAGATCAC.CAAGTACGA	CCAGATCAC.CAAGTACGA
CCAGATCAC.CCAGTCTCA	CCAGATCAC.CCAGTCTCA
CCAGATCAC.CGGTGAGTC	CCAGATCAC.CGGTGAGTC
CCAGATCAC.CTGTGGTGG	CCAGATCAC.CTGTGGTGG
CCAGATCAC.GCGTGATAC	CCAGATCAC.GCGTGATAC
CCAGCCAAT.CGTCTGTCC	CCAGCCAAT.CGTCTGTCC
CCAGCCAAT.CGTGAGACT	CCAGCCAAT.CGTGAGACT
CCAGCCAAT.GTCGTCGAC	CCAGCCAAT.GTCGTCGAC
CCAGCCAAT.GTGCGAGTA	CCAGCCAAT.GTGCGAGTA
CCAGCCAAT.TACAGGACT	CCAGCCAAT.TACAGGACT
CCAGCCAAT.TCAATCTAG	CCAGCCAAT.TCAATCTAG
CCAGCCAAT.TGCGTGCCA	CCAGCCAAT.TGCGTGCCA
CCAGCCAAT.TGTCTACAC	CCAGCCAAT.TGTCTACAC
CCAGCCAAT.TTGTATCAC	CCAGCCAAT.TTGTATCAC
CCAGGAGTT.CTGTGGTGG	CCAGGAGTT.CTGTGGTGG
CCAGGAGTT.GATACACTA	CCAGGAGTT.GATACACTA
CCAGGAGTT.GCTGTTCGG	CCAGGAGTT.GCTGTTCGG
CCAGGAGTT.TCTGATGAA	CCAGGAGTT.TCTGATGAA
CCAGTACTC.ACGCAAGAT	CCAGTACTC.ACGCAAGAT
CCAGTACTC.CTATACTAG	CCAGTACTC.CTATACTAG
CCAGTACTC.CTGCAAGCC	CCAGTACTC.CTGCAAGCC
CCAGTACTC.GTAACTCAT	CCAGTACTC.GTAACTCAT
CCAGTACTC.TAGTGCACT	CCAGTACTC.TAGTGCACT
CCAGTCTCA.CAGTATGAT	CCAGTCTCA.CAGTATGAT
CCAGTTACG.CCGATACCG	CCAGTTACG.CCGATACCG
CCAGTTACG.CGTTAATGG	CCAGTTACG.CGTTAATGG
CCAGTTACG.GGATGCGAA	CCAGTTACG.GGATGCGAA
CCAGTTACG.GGTTACGCA	CCAGTTACG.GGTTACGCA
CCATAAGTA.ATGACACAA	CCATAAGTA.ATGACACAA
CCATAAGTA.CGAAGAGGT	CCATAAGTA.CGAAGAGGT
CCATAATCG.ACATCGTCC	CCATAATCG.ACATCGTCC
CCATAATCG.AGATCTTCA	CCATAATCG.AGATCTTCA
CCATAATCG.AGCAACATT	CCATAATCG.AGCAACATT
CCATAATCG.AGCGGAACA	CCATAATCG.AGCGGAACA
CCATAATCG.CGGACAAGT	CCATAATCG.CGGACAAGT
CCATAATCG.GCCTTATCT	CCATAATCG.GCCTTATCT
CCATAATCG.GGTAAGTGA	CCATAATCG.GGTAAGTGA
CCATAATCG.GTAATATCG	CCATAATCG.GTAATATCG
CCATAATCG.TGATGGACA	CCATAATCG.TGATGGACA
CCATACGAT.ACCATCTAA	CCATACGAT.ACCATCTAA
CCATACGAT.AGTCAGTTG	CCATACGAT.AGTCAGTTG
CCATACGAT.CCAAGCGAG	CCATACGAT.CCAAGCGAG
CCATACGAT.GCACGTAGA	CCATACGAT.GCACGTAGA
CCATACGAT.GCCAACAAT	CCATACGAT.GCCAACAAT
CCATACGAT.TGAGTTAAG	CCATACGAT.TGAGTTAAG
CCATAGCCA.AACAACCTA	CCATAGCCA.AACAACCTA
CCATAGCCA.GCGTAACAA	CCATAGCCA.GCGTAACAA
CCATAGCCA.GTAATCAGC	CCATAGCCA.GTAATCAGC
CCATATCTT.AGGATCTCA	CCATATCTT.AGGATCTCA
CCATATCTT.ATCTGGTAG	CCATATCTT.ATCTGGTAG
CCATATCTT.ATTGGTTCC	CCATATCTT.ATTGGTTCC
CCATATCTT.CAACCGGTC	CCATATCTT.CAACCGGTC
