AGTGGAATG.ACGTTCAAT	AGTGGAATG.ACGTTCAAT
AGTGTCTCT.ATGAGATCC	AGTGTCTCT.ATGAGATCC
AGTGTCTCT.CTACTGTCA	AGTGTCTCT.CTACTGTCA
AGTGTCTCT.GCCTGCATC	AGTGTCTCT.GCCTGCATC
AGTGTCTCT.GTCAGTTGT	AGTGTCTCT.GTCAGTTGT
AGTGTCTCT.TGATTGCTG	AGTGTCTCT.TGATTGCTG
AGTGTGCAC.CACTGGTCC	AGTGTGCAC.CACTGGTCC
AGTGTGCAC.CAGAGCACC	AGTGTGCAC.CAGAGCACC
AGTGTGCAC.CGGTTCTAT	AGTGTGCAC.CGGTTCTAT
AGTGTGCAC.GATATATCC	AGTGTGCAC.GATATATCC
AGTGTGCAC.GCTGGTTCG	AGTGTGCAC.GCTGGTTCG
AGTGTTCTG.CCATATCTT	AGTGTTCTG.CCATATCTT
AGTGTTCTG.CTACGGTAT	AGTGTTCTG.CTACGGTAT
AGTGTTCTG.GTAGCCTTG	AGTGTTCTG.GTAGCCTTG
AGTGTTCTG.GTATTACTG	AGTGTTCTG.GTATTACTG
AGTGTTCTG.GTCCTTCAT	AGTGTTCTG.GTCCTTCAT
AGTGTTCTG.GTTAGTCAA	AGTGTTCTG.GTTAGTCAA
AGTGTTCTG.TCAGGTGCA	AGTGTTCTG.TCAGGTGCA
AGTTACAAG.ACGCAAGAT	AGTTACAAG.ACGCAAGAT
AGTTACAAG.ATGCTCACC	AGTTACAAG.ATGCTCACC
AGTTACAAG.CCGCAGCTA	AGTTACAAG.CCGCAGCTA
AGTTACAAG.GGTCTCATG	AGTTACAAG.GGTCTCATG
AGTTACAAG.TCGTTCTCC	AGTTACAAG.TCGTTCTCC
AGTTAGGTC.ATACCGAAG	AGTTAGGTC.ATACCGAAG
AGTTAGGTC.CCGTCCACT	AGTTAGGTC.CCGTCCACT
AGTTAGGTC.TAGCTAAGA	AGTTAGGTC.TAGCTAAGA
AGTTAGGTC.TTGGAGAAC	AGTTAGGTC.TTGGAGAAC
AGTTATCGC.CGGTTCGTA	AGTTATCGC.CGGTTCGTA
AGTTCAACC.ATCTCGAAC	AGTTCAACC.ATCTCGAAC
AGTTCAACC.GAGTTATAG	AGTTCAACC.GAGTTATAG
AGTTCAACC.TATCTAGGT	AGTTCAACC.TATCTAGGT
AGTTCGATA.ACCTTGAAG	AGTTCGATA.ACCTTGAAG
AGTTCGATA.GACCAACAG	AGTTCGATA.GACCAACAG
AGTTCGATA.TAACGGATA	AGTTCGATA.TAACGGATA
AGTTGAGCG.CCGATCTCT	AGTTGAGCG.CCGATCTCT
AGTTGAGCG.GATCGTTGA	AGTTGAGCG.GATCGTTGA
AGTTGCCTT.GGATACCTA	AGTTGCCTT.GGATACCTA
AGTTGCCTT.TAGACACGT	AGTTGCCTT.TAGACACGT
AGTTGCCTT.TTGCGAACA	AGTTGCCTT.TTGCGAACA
ATAACGACA.CCAGCCAAT	ATAACGACA.CCAGCCAAT
ATAACGACA.GATACCGGA	ATAACGACA.GATACCGGA
ATAACGACA.TCCTCGTCG	ATAACGACA.TCCTCGTCG
ATAACGACA.TCGCCAAGC	ATAACGACA.TCGCCAAGC
ATAAGACAG.CTGTCACTT	ATAAGACAG.CTGTCACTT
ATAAGACAG.GCTTCACTC	ATAAGACAG.GCTTCACTC
ATAAGACAG.TAGTAACGG	ATAAGACAG.TAGTAACGG
ATAAGACAG.TATTACTCG	ATAAGACAG.TATTACTCG
ATAAGTTCG.AATCGTGTT	ATAAGTTCG.AATCGTGTT
ATAAGTTCG.CAAGGTGTG	ATAAGTTCG.CAAGGTGTG
ATAAGTTCG.GACAATGTT	ATAAGTTCG.GACAATGTT
ATAAGTTCG.GAGCACATT	ATAAGTTCG.GAGCACATT
ATAAGTTCG.GCGTGATAC	ATAAGTTCG.GCGTGATAC
ATAAGTTCG.TTCAACTAC	ATAAGTTCG.TTCAACTAC
ATAATCGAG.ACAATAGGT	ATAATCGAG.ACAATAGGT
ATAATCGAG.ATAATCGAG	ATAATCGAG.ATAATCGAG
ATAATCGAG.CCTGCGTTA	ATAATCGAG.CCTGCGTTA
ATAATCGAG.GCGTAACAA	ATAATCGAG.GCGTAACAA
ATAATGTGG.CTGGTAATC	ATAATGTGG.CTGGTAATC
ATACAACCG.CACCTAGCG	ATACAACCG.CACCTAGCG
ATACAACCG.CTAGAGGTA	ATACAACCG.CTAGAGGTA
ATACAACCG.GCCAACAAT	ATACAACCG.GCCAACAAT
ATACAACCG.TCCTTCGTA	ATACAACCG.TCCTTCGTA
ATACCGAAG.AGACGGAGG	ATACCGAAG.AGACGGAGG
ATACCGAAG.AGACTTCGT	ATACCGAAG.AGACTTCGT
ATACCGAAG.CTCTACGCA	ATACCGAAG.CTCTACGCA
ATACCGAAG.GGTGCGTAG	ATACCGAAG.GGTGCGTAG
ATACCGAAG.GTAGTGGAG	ATACCGAAG.GTAGTGGAG
ATACCGAAG.TCTACATCC	ATACCGAAG.TCTACATCC
ATACCGCTT.AGTCCGTGT	ATACCGCTT.AGTCCGTGT
ATACCGCTT.ATAATCGAG	ATACCGCTT.ATAATCGAG
ATACCGCTT.GCTGTTCGG	ATACCGCTT.GCTGTTCGG
ATACCGCTT.GTTAGAGAC	ATACCGCTT.GTTAGAGAC
ATACCGCTT.TTACTTACG	ATACCGCTT.TTACTTACG
ATACCGCTT.TTGGAGAAC	ATACCGCTT.TTGGAGAAC
ATACGAGGT.ACGTCGCTC	ATACGAGGT.ACGTCGCTC
ATACGAGGT.CCACAAGGT	ATACGAGGT.CCACAAGGT
ATACGAGGT.CGTGAGACT	ATACGAGGT.CGTGAGACT
ATACGAGGT.CTCTACGCA	ATACGAGGT.CTCTACGCA
ATACGAGGT.GACTCTCAC	ATACGAGGT.GACTCTCAC
ATACGAGGT.TACTACTGT	ATACGAGGT.TACTACTGT
ATACGAGGT.TATGTATGC	ATACGAGGT.TATGTATGC
ATACTTGCT.ACCGTCACG	ATACTTGCT.ACCGTCACG
ATACTTGCT.AGTCGTCCG	ATACTTGCT.AGTCGTCCG
ATACTTGCT.CGTGGTACC	ATACTTGCT.CGTGGTACC
ATACTTGCT.GATGTTACA	ATACTTGCT.GATGTTACA
ATACTTGCT.GGAATTGGA	ATACTTGCT.GGAATTGGA
ATAGACCGA.ACACAGAAC	ATAGACCGA.ACACAGAAC
ATAGAGCAG.TAAGCACTA	ATAGAGCAG.TAAGCACTA
ATAGCACGG.CTATACTAG	ATAGCACGG.CTATACTAG
ATAGCACGG.GACGCTTGC	ATAGCACGG.GACGCTTGC
ATAGCCTAA.GAGCGACTC	ATAGCCTAA.GAGCGACTC
ATAGCTTGC.ACTATCCTG	ATAGCTTGC.ACTATCCTG
ATAGCTTGC.ATATAGCGT	ATAGCTTGC.ATATAGCGT
ATAGCTTGC.CAAGTCGAA	ATAGCTTGC.CAAGTCGAA
ATAGCTTGC.CCGATCTCT	ATAGCTTGC.CCGATCTCT
ATAGCTTGC.CTCCTATCT	ATAGCTTGC.CTCCTATCT
ATAGCTTGC.TCGTCCGAT	ATAGCTTGC.TCGTCCGAT
ATAGCTTGC.TGCGTCTTA	ATAGCTTGC.TGCGTCTTA
ATAGTCAGT.AATCGTGTT	ATAGTCAGT.AATCGTGTT
ATAGTCAGT.ACGCGTGAC	ATAGTCAGT.ACGCGTGAC
ATAGTCAGT.CAGTACATC	ATAGTCAGT.CAGTACATC
ATAGTCAGT.CCGAGTACT	ATAGTCAGT.CCGAGTACT
ATAGTCAGT.CTAACACTG	ATAGTCAGT.CTAACACTG
ATAGTCAGT.TCCAGCAGC	ATAGTCAGT.TCCAGCAGC
ATAGTCAGT.TTCGTGATG	ATAGTCAGT.TTCGTGATG
ATAGTCTCC.AGGTGTACA	ATAGTCTCC.AGGTGTACA
ATAGTCTCC.CACACCACA	ATAGTCTCC.CACACCACA
ATAGTCTCC.CATGTGAAC	ATAGTCTCC.CATGTGAAC
ATAGTCTCC.GAAGAGCAC	ATAGTCTCC.GAAGAGCAC
ATAGTCTCC.GCCGTTGTT	ATAGTCTCC.GCCGTTGTT
ATAGTCTCC.GTGGATAAG	ATAGTCTCC.GTGGATAAG
ATAGTGGTT.CATTGACAA	ATAGTGGTT.CATTGACAA
ATAGTGGTT.GTAGACTCT	ATAGTGGTT.GTAGACTCT
ATATAGCGT.GGAATTCAC	ATATAGCGT.GGAATTCAC
ATATCAGCC.AGTAACGTA	ATATCAGCC.AGTAACGTA
ATATCAGCC.ATCCACAGT	ATATCAGCC.ATCCACAGT
ATATCAGCC.GGTACTTCC	ATATCAGCC.GGTACTTCC
ATATCAGCC.TAATCTGGA	ATATCAGCC.TAATCTGGA
ATATCCGAT.CTAGACATG	ATATCCGAT.CTAGACATG
ATATCCGAT.CTCTACGCA	ATATCCGAT.CTCTACGCA
ATATCCGAT.GATGCGGTT	ATATCCGAT.GATGCGGTT
ATATCCGAT.GTCTGACGT	ATATCCGAT.GTCTGACGT
ATATCCGAT.TATCGGAAC	ATATCCGAT.TATCGGAAC
ATATGCAGC.AGGAGGTGA	ATATGCAGC.AGGAGGTGA
ATATGCAGC.GGTTCTATC	ATATGCAGC.GGTTCTATC
ATATGCAGC.GTCGAGTAC	ATATGCAGC.GTCGAGTAC
ATATGTCCA.AGTACTCTC	ATATGTCCA.AGTACTCTC
ATATTCGCA.AATAGACGC	ATATTCGCA.AATAGACGC
ATATTCGCA.ATATAGCGT	ATATTCGCA.ATATAGCGT
ATATTCGCA.CTGGTGACA	ATATTCGCA.CTGGTGACA
ATCAAGAGA.CAGCGACGT	ATCAAGAGA.CAGCGACGT
ATCAAGAGA.CCAGTCTCA	ATCAAGAGA.CCAGTCTCA
ATCAAGCAT.AGATACGTT	ATCAAGCAT.AGATACGTT
ATCAAGCAT.GCCTGGAAT	ATCAAGCAT.GCCTGGAAT
ATCAAGCAT.GCGCTACCT	ATCAAGCAT.GCGCTACCT
ATCAAGCAT.TGCGCACTG	ATCAAGCAT.TGCGCACTG
ATCACCGCA.ATCCATTAG	ATCACCGCA.ATCCATTAG
ATCACCGCA.CTAGAGTCG	ATCACCGCA.CTAGAGTCG
ATCACCGCA.CTAGTTCCA	ATCACCGCA.CTAGTTCCA
ATCACCGCA.GAGTTAACT	ATCACCGCA.GAGTTAACT
ATCACCGCA.TTCCAGGAG	ATCACCGCA.TTCCAGGAG
ATCACTTCC.GAGAACAGG	ATCACTTCC.GAGAACAGG
ATCAGAAGC.ACACCGCCA	ATCAGAAGC.ACACCGCCA
ATCAGAAGC.CTATCTTGA	ATCAGAAGC.CTATCTTGA
ATCAGAAGC.GATATGGAC	ATCAGAAGC.GATATGGAC
ATCAGAAGC.TCAGTGTTC	ATCAGAAGC.TCAGTGTTC
ATCAGGATG.ATGCGCCGT	ATCAGGATG.ATGCGCCGT
ATCAGGATG.CCATAGCCA	ATCAGGATG.CCATAGCCA
ATCAGGATG.TCAACACTC	ATCAGGATG.TCAACACTC
ATCAGTCGA.CTGCGTCAC	ATCAGTCGA.CTGCGTCAC
ATCAGTCGA.GCGAGTCTA	ATCAGTCGA.GCGAGTCTA
ATCATAGAC.ACGTGAATC	ATCATAGAC.ACGTGAATC
ATCATAGAC.CATAGAGAT	ATCATAGAC.CATAGAGAT
ATCATAGAC.GTGCTCGGA	ATCATAGAC.GTGCTCGGA
ATCATAGAC.TATACGTGG	ATCATAGAC.TATACGTGG
ATCATAGAC.TCGCCAAGC	ATCATAGAC.TCGCCAAGC
ATCATAGAC.TGACTGAGA	ATCATAGAC.TGACTGAGA
ATCATAGAC.TGTGTCTAC	ATCATAGAC.TGTGTCTAC
ATCATGTTC.AACGCCTAC	ATCATGTTC.AACGCCTAC
ATCATGTTC.ATCACTTCC	ATCATGTTC.ATCACTTCC
ATCATGTTC.ATGGTTCGA	ATCATGTTC.ATGGTTCGA
ATCATGTTC.GCGACAACC	ATCATGTTC.GCGACAACC
ATCATGTTC.GGAAGTATG	ATCATGTTC.GGAAGTATG
ATCATGTTC.GGTCGGTCT	ATCATGTTC.GGTCGGTCT
ATCATGTTC.GTGTCACAC	ATCATGTTC.GTGTCACAC
ATCATGTTC.TAGTAGTCT	ATCATGTTC.TAGTAGTCT
ATCATTACG.ATAATGTGG	ATCATTACG.ATAATGTGG
ATCATTACG.ATGAGTGTG	ATCATTACG.ATGAGTGTG
ATCATTACG.CTTCTATGA	ATCATTACG.CTTCTATGA
ATCATTACG.GAGTGCATA	ATCATTACG.GAGTGCATA
ATCATTACG.GCCAATGAA	ATCATTACG.GCCAATGAA
ATCATTACG.TCGACGTTG	ATCATTACG.TCGACGTTG
ATCATTACG.TCTAATACC	ATCATTACG.TCTAATACC
ATCCAATGA.AACGCCTAC	ATCCAATGA.AACGCCTAC
ATCCAATGA.ACATTGACA	ATCCAATGA.ACATTGACA
ATCCAATGA.CCAGGAGTT	ATCCAATGA.CCAGGAGTT
ATCCAATGA.CGATCCAGA	ATCCAATGA.CGATCCAGA
ATCCAATGA.TAGAGACTA	ATCCAATGA.TAGAGACTA
ATCCAATGA.TCAATGGAC	ATCCAATGA.TCAATGGAC
ATCCAATGA.TGAGATCAT	ATCCAATGA.TGAGATCAT
ATCCAATGA.TGGAAGATT	ATCCAATGA.TGGAAGATT
ATCCACAGT.AACGTCGAG	ATCCACAGT.AACGTCGAG
ATCCACAGT.ACACCGCCA	ATCCACAGT.ACACCGCCA
ATCCACAGT.AGCGTCGTC	ATCCACAGT.AGCGTCGTC
ATCCACAGT.ATAGCACGG	ATCCACAGT.ATAGCACGG
ATCCACAGT.CTGTCTAGT	ATCCACAGT.CTGTCTAGT
ATCCACAGT.TACGAACTC	ATCCACAGT.TACGAACTC
ATCCAGCTG.ACACGTTGC	ATCCAGCTG.ACACGTTGC
ATCCAGCTG.TGAGATCAT	ATCCAGCTG.TGAGATCAT
ATCCATTAG.CTCCACGTC	ATCCATTAG.CTCCACGTC
ATCCATTAG.TGTGCCATG	ATCCATTAG.TGTGCCATG
ATCCGACCA.GGTGAGCGT	ATCCGACCA.GGTGAGCGT
ATCCGGTCC.ACACGTTGC	ATCCGGTCC.ACACGTTGC
ATCCGGTCC.AGATCTGAC	ATCCGGTCC.AGATCTGAC
ATCCGGTCC.CGCCTGCAA	ATCCGGTCC.CGCCTGCAA
ATCCGGTCC.GCCTGCATC	ATCCGGTCC.GCCTGCATC
ATCCGTCTC.AATGTGCGT	ATCCGTCTC.AATGTGCGT
ATCCTCCGA.ACATCGTCC	ATCCTCCGA.ACATCGTCC
ATCCTCCGA.ATCCACAGT	ATCCTCCGA.ATCCACAGT
ATCCTCCGA.CTTATCTCA	ATCCTCCGA.CTTATCTCA
ATCCTCCGA.TGTCGTGAG	ATCCTCCGA.TGTCGTGAG
ATCCTCCGA.TTATTCGAC	ATCCTCCGA.TTATTCGAC
ATCCTGCCT.CCATACGAT	ATCCTGCCT.CCATACGAT
ATCCTGCCT.CTCTGTCAA	ATCCTGCCT.CTCTGTCAA
ATCCTGCCT.TCCTTCAAC	ATCCTGCCT.TCCTTCAAC
ATCCTGCCT.TTACGCTCG	ATCCTGCCT.TTACGCTCG
ATCGAATCG.AAGCCAAGT	ATCGAATCG.AAGCCAAGT
ATCGAATCG.ACGTACTGC	ATCGAATCG.ACGTACTGC
ATCGAATCG.CATACGCAG	ATCGAATCG.CATACGCAG
ATCGAATCG.CTCCACGTC	ATCGAATCG.CTCCACGTC
ATCGAATCG.GTATCGTCG	ATCGAATCG.GTATCGTCG
ATCGAATCG.GTGACTCTC	ATCGAATCG.GTGACTCTC
ATCGATCCT.AATACTCCG	ATCGATCCT.AATACTCCG
ATCGATCCT.ACTGCTAGT	ATCGATCCT.ACTGCTAGT
ATCGATCCT.ATTGGTTCC	ATCGATCCT.ATTGGTTCC
ATCGATCCT.CAATCAAGT	ATCGATCCT.CAATCAAGT
ATCGATCCT.GTCTACCAA	ATCGATCCT.GTCTACCAA
ATCGATCCT.TGCGCACTG	ATCGATCCT.TGCGCACTG
ATCGCCTCT.CAACGATCG	ATCGCCTCT.CAACGATCG
ATCGCCTCT.CGGTCGACA	ATCGCCTCT.CGGTCGACA
ATCGCCTCT.TTCTGGTGC	ATCGCCTCT.TTCTGGTGC
ATCGGTGGT.ACACAGAAC	ATCGGTGGT.ACACAGAAC
ATCGGTGGT.ACTAAGTTC	ATCGGTGGT.ACTAAGTTC
ATCGTAGTG.GAGACGATC	ATCGTAGTG.GAGACGATC
ATCGTAGTG.GCCTTAGAG	ATCGTAGTG.GCCTTAGAG
ATCGTAGTG.GTTAGTCAA	ATCGTAGTG.GTTAGTCAA
ATCGTAGTG.TAGACCATG	ATCGTAGTG.TAGACCATG
ATCGTAGTG.TGTCGTGAG	ATCGTAGTG.TGTCGTGAG
ATCTACATC.ACATCGTCC	ATCTACATC.ACATCGTCC
ATCTACATC.ACCGGAAGG	ATCTACATC.ACCGGAAGG
ATCTACATC.ATGCTGTCG	ATCTACATC.ATGCTGTCG
ATCTACATC.CAGATCATT	ATCTACATC.CAGATCATT
ATCTACATC.TCAATGGAC	ATCTACATC.TCAATGGAC
ATCTAGGTT.AAGCAACTA	ATCTAGGTT.AAGCAACTA
ATCTAGGTT.ATGAGCAGG	ATCTAGGTT.ATGAGCAGG
ATCTAGGTT.CACTAGACT	ATCTAGGTT.CACTAGACT
ATCTAGGTT.CTCCAGCGT	ATCTAGGTT.CTCCAGCGT
ATCTCGAAC.AACAACCTA	ATCTCGAAC.AACAACCTA
ATCTCGAAC.AATCTGACC	ATCTCGAAC.AATCTGACC
ATCTCGAAC.AGGATTGAG	ATCTCGAAC.AGGATTGAG
ATCTCGAAC.AGGTGCGAG	ATCTCGAAC.AGGTGCGAG
ATCTCGAAC.TCCTGAGAC	ATCTCGAAC.TCCTGAGAC
ATCTCGTGA.ACTCCGGTT	ATCTCGTGA.ACTCCGGTT
ATCTCGTGA.TTGAGCTCT	ATCTCGTGA.TTGAGCTCT
ATCTCTGCT.CTGCAAGCC	ATCTCTGCT.CTGCAAGCC
ATCTCTGCT.GTAACAGTC	ATCTCTGCT.GTAACAGTC
ATCTCTGCT.TACTTCCAG	ATCTCTGCT.TACTTCCAG
ATCTCTGCT.TATCGGAAC	ATCTCTGCT.TATCGGAAC
ATCTGCGTA.AACTCCATG	ATCTGCGTA.AACTCCATG
ATCTGCGTA.AATTGGTGA	ATCTGCGTA.AATTGGTGA
ATCTGCGTA.ACTGGTGCT	ATCTGCGTA.ACTGGTGCT
ATCTGGTAG.AATTGGATC	ATCTGGTAG.AATTGGATC
ATCTGGTAG.AGGATTGAG	ATCTGGTAG.AGGATTGAG
ATCTGGTAG.CATCGAAGC	ATCTGGTAG.CATCGAAGC
ATCTTACAG.ACGACTGCG	ATCTTACAG.ACGACTGCG
ATCTTACAG.ATTGGTTCC	ATCTTACAG.ATTGGTTCC
ATCTTACAG.CGTTAATGG	ATCTTACAG.CGTTAATGG
ATCTTACAG.GGTCTTGCA	ATCTTACAG.GGTCTTGCA
ATCTTACAG.TGTAACAGT	ATCTTACAG.TGTAACAGT
ATCTTACAG.TTCCATACC	ATCTTACAG.TTCCATACC
ATGAACTAG.AATTAGAGG	ATGAACTAG.AATTAGAGG
ATGAACTAG.TCCAATCAT	ATGAACTAG.TCCAATCAT
ATGACACAA.AGACGCTAT	ATGACACAA.AGACGCTAT
ATGACACAA.AGTAACGTA	ATGACACAA.AGTAACGTA
ATGACACAA.CCTAGTTAG	ATGACACAA.CCTAGTTAG
ATGAGATCC.ACTGGTGCT	ATGAGATCC.ACTGGTGCT
ATGAGATCC.CTCGACTGC	ATGAGATCC.CTCGACTGC
ATGAGATCC.CTTATTGAG	ATGAGATCC.CTTATTGAG
ATGAGCAGG.ATTCACCTC	ATGAGCAGG.ATTCACCTC
ATGAGCAGG.CAACCGGTC	ATGAGCAGG.CAACCGGTC
ATGAGCAGG.CGTCTGTCC	ATGAGCAGG.CGTCTGTCC
ATGAGCAGG.GATGCGGTT	ATGAGCAGG.GATGCGGTT
ATGAGCAGG.TCGACGTTG	ATGAGCAGG.TCGACGTTG
ATGAGGTAT.ACCTCCTAG	ATGAGGTAT.ACCTCCTAG
ATGAGGTAT.ACTCTAGGA	ATGAGGTAT.ACTCTAGGA
ATGAGGTAT.AGATCTGAC	ATGAGGTAT.AGATCTGAC
ATGAGTGTG.CTCGCTACG	ATGAGTGTG.CTCGCTACG
ATGAGTGTG.CTGATCAAG	ATGAGTGTG.CTGATCAAG
ATGATAGCT.CGCTTATGA	ATGATAGCT.CGCTTATGA
ATGCAGTTC.AGAGCGGAG	ATGCAGTTC.AGAGCGGAG
ATGCAGTTC.GAACATGAC	ATGCAGTTC.GAACATGAC
ATGCAGTTC.TGATGTGTG	ATGCAGTTC.TGATGTGTG
ATGCCTGTC.AGTCGCCGA	ATGCCTGTC.AGTCGCCGA
ATGCCTGTC.ATGGAGGAA	ATGCCTGTC.ATGGAGGAA
ATGCCTGTC.CCATTACAG	ATGCCTGTC.CCATTACAG
ATGCCTGTC.CTCTTCAGC	ATGCCTGTC.CTCTTCAGC
ATGCCTGTC.GCCACATGG	ATGCCTGTC.GCCACATGG
ATGCCTGTC.GGATCAGGT	ATGCCTGTC.GGATCAGGT
ATGCCTTCA.GGAATTGGA	ATGCCTTCA.GGAATTGGA
ATGCCTTCA.GTGCTGACT	ATGCCTTCA.GTGCTGACT
ATGCCTTCA.TGCAGTCGG	ATGCCTTCA.TGCAGTCGG
ATGCCTTCA.TGTCGTACA	ATGCCTTCA.TGTCGTACA
ATGCGCCGT.ACGACGATT	ATGCGCCGT.ACGACGATT
ATGCGCCGT.GCCGTCTTC	ATGCGCCGT.GCCGTCTTC
ATGCGCCGT.GTGGACTGG	ATGCGCCGT.GTGGACTGG
ATGCGGATT.CACAACGCT	ATGCGGATT.CACAACGCT
ATGCGGATT.TATGACCGA	ATGCGGATT.TATGACCGA
ATGCGGATT.TGGACTGCC	ATGCGGATT.TGGACTGCC
ATGCGTGGA.CTCGTTCAC	ATGCGTGGA.CTCGTTCAC
ATGCTCACC.CTGACGGAT	ATGCTCACC.CTGACGGAT
ATGCTCACC.GTGTCGAGC	ATGCTCACC.GTGTCGAGC
ATGCTCACC.GTTAGATTG	ATGCTCACC.GTTAGATTG
ATGCTGTCG.CTCAGGTAC	ATGCTGTCG.CTCAGGTAC
ATGCTGTCG.GATCGCGAA	ATGCTGTCG.GATCGCGAA
ATGCTGTCG.GATCTAGAG	ATGCTGTCG.GATCTAGAG
ATGCTTCAG.AACAGATCG	ATGCTTCAG.AACAGATCG
ATGCTTCAG.AATGAGTCG	ATGCTTCAG.AATGAGTCG
ATGCTTCAG.AGCATTGTT	ATGCTTCAG.AGCATTGTT
ATGGACGTT.CAAGAGAGT	ATGGACGTT.CAAGAGAGT
ATGGACGTT.CAGGAGCCT	ATGGACGTT.CAGGAGCCT
ATGGACGTT.TCAAGGAGT	ATGGACGTT.TCAAGGAGT
ATGGACGTT.TCAATCTAG	ATGGACGTT.TCAATCTAG
ATGGACGTT.TGATAGAGG	ATGGACGTT.TGATAGAGG
ATGGAGGAA.ATATAGCGT	ATGGAGGAA.ATATAGCGT
ATGGAGGAA.CACACCTGT	ATGGAGGAA.CACACCTGT
ATGGATATC.AACGTTCTT	ATGGATATC.AACGTTCTT
ATGGATATC.AGAGGTGAA	ATGGATATC.AGAGGTGAA
ATGGATATC.ATAGAGCAG	ATGGATATC.ATAGAGCAG
ATGGATATC.CGACCTGTA	ATGGATATC.CGACCTGTA
ATGGATATC.GGTTCGCAA	ATGGATATC.GGTTCGCAA
ATGGATATC.GTCTTCTCG	ATGGATATC.GTCTTCTCG
ATGGTTCGA.AGGTGTACA	ATGGTTCGA.AGGTGTACA
ATGGTTCGA.CCACACAGA	ATGGTTCGA.CCACACAGA
ATGGTTCGA.TGAGATCAT	ATGGTTCGA.TGAGATCAT
ATGTCCTCC.ACTAACCGA	ATGTCCTCC.ACTAACCGA
ATGTCCTCC.ACTTGATCT	ATGTCCTCC.ACTTGATCT
ATGTCCTCC.GAAGTGTGA	ATGTCCTCC.GAAGTGTGA
ATGTCCTCC.TCAGAGTCA	ATGTCCTCC.TCAGAGTCA
ATGTCGCCT.CCATTACAG	ATGTCGCCT.CCATTACAG
ATGTCGCCT.TCGTACCTT	ATGTCGCCT.TCGTACCTT
ATGTGACGA.ATTGATTGG	ATGTGACGA.ATTGATTGG
ATGTGACGA.GTTGACCAT	ATGTGACGA.GTTGACCAT
ATGTGACGA.TACCATGTA	ATGTGACGA.TACCATGTA
ATGTGAGAC.ACAGGTATC	ATGTGAGAC.ACAGGTATC
ATGTGAGAC.CCAACAACA	ATGTGAGAC.CCAACAACA
ATGTGAGAC.CGAATGAGT	ATGTGAGAC.CGAATGAGT
ATGTGAGAC.CGGTTCGTA	ATGTGAGAC.CGGTTCGTA
ATGTGAGAC.CTCTGCAAG	ATGTGAGAC.CTCTGCAAG
ATTAAGACC.AAGCATTGC	ATTAAGACC.AAGCATTGC
ATTAAGACC.AGTAAGCCA	ATTAAGACC.AGTAAGCCA
ATTAAGACC.CTTGCGACC	ATTAAGACC.CTTGCGACC
ATTAAGACC.GAGGTGAGC	ATTAAGACC.GAGGTGAGC
ATTAAGACC.TGGTCCTAG	ATTAAGACC.TGGTCCTAG
ATTAGCACA.GATAAGCTG	ATTAGCACA.GATAAGCTG
ATTAGCACA.TAGGATGCC	ATTAGCACA.TAGGATGCC
ATTAGCACA.TCAAGCGTA	ATTAGCACA.TCAAGCGTA
ATTAGCACA.TGCGATACT	ATTAGCACA.TGCGATACT
ATTAGCCAC.AATGCGTGC	ATTAGCCAC.AATGCGTGC
ATTAGCCAC.AGTGTCTCT	ATTAGCCAC.AGTGTCTCT
ATTAGCCAC.CAATCATAC	ATTAGCCAC.CAATCATAC
ATTAGCCAC.CATTGTTCA	ATTAGCCAC.CATTGTTCA
ATTAGCGGT.CTAACCGGT	ATTAGCGGT.CTAACCGGT
ATTAGCGGT.GTCAGCGTC	ATTAGCGGT.GTCAGCGTC
ATTATGCAG.CACTGTATC	ATTATGCAG.CACTGTATC
ATTCACCTC.GTGTCACAC	ATTCACCTC.GTGTCACAC
ATTCACCTC.TCACCGAGG	ATTCACCTC.TCACCGAGG
ATTCACCTC.TCTAGTGAC	ATTCACCTC.TCTAGTGAC
ATTCACCTC.TTCTGGTGC	ATTCACCTC.TTCTGGTGC
ATTCATGTG.ACAATTCGG	ATTCATGTG.ACAATTCGG
ATTCATGTG.TCTAGCTGG	ATTCATGTG.TCTAGCTGG
ATTCCGTAC.GAAGGATCA	ATTCCGTAC.GAAGGATCA
ATTCCGTAC.GATTCCTCT	ATTCCGTAC.GATTCCTCT
ATTCCTACG.CCAGATCAC	ATTCCTACG.CCAGATCAC
ATTCCTACG.GGTGTTCAT	ATTCCTACG.GGTGTTCAT
ATTCCTACG.TCTGCGCTG	ATTCCTACG.TCTGCGCTG
ATTCGAAGA.AACGCATTG	ATTCGAAGA.AACGCATTG
ATTCGAAGA.ACAGAAGAG	ATTCGAAGA.ACAGAAGAG
ATTCGAAGA.CAGTATGAT	ATTCGAAGA.CAGTATGAT
ATTCGAAGA.GAACCAGTT	ATTCGAAGA.GAACCAGTT
ATTCGAAGA.GAGTGTGCC	ATTCGAAGA.GAGTGTGCC
ATTCGAAGA.GTGACGTAA	ATTCGAAGA.GTGACGTAA
ATTCGCTTA.AAGCAATCG	ATTCGCTTA.AAGCAATCG
ATTCGCTTA.ACGCAAGAT	ATTCGCTTA.ACGCAAGAT
ATTCGCTTA.TTCATTCGC	ATTCGCTTA.TTCATTCGC
ATTCTCTGG.CTTCGTGCA	ATTCTCTGG.CTTCGTGCA
ATTCTCTGG.GCGACCTGT	ATTCTCTGG.GCGACCTGT
ATTCTCTGG.GGTAAGTGA	ATTCTCTGG.GGTAAGTGA
ATTGACACG.AAGTTCTCT	ATTGACACG.AAGTTCTCT
ATTGACACG.GCCTGCATC	ATTGACACG.GCCTGCATC
ATTGACACG.TACTCGACC	ATTGACACG.TACTCGACC
ATTGATCAC.AACTTGTCG	ATTGATCAC.AACTTGTCG
ATTGATCAC.AGAAGTAAC	ATTGATCAC.AGAAGTAAC
ATTGATCAC.TACCGATTG	ATTGATCAC.TACCGATTG
ATTGATTGG.CAGGTATCG	ATTGATTGG.CAGGTATCG
ATTGATTGG.TGTGCTAAC	ATTGATTGG.TGTGCTAAC
ATTGCCGAC.AATTGGTGA	ATTGCCGAC.AATTGGTGA
ATTGCCGAC.ACAGGTATC	ATTGCCGAC.ACAGGTATC
ATTGCCGAC.CGGTTCGTA	ATTGCCGAC.CGGTTCGTA
ATTGCCGAC.TTCCATACC	ATTGCCGAC.TTCCATACC
ATTGCGCTA.AAGTTCTCT	ATTGCGCTA.AAGTTCTCT
ATTGCGCTA.GATCTTCGC	ATTGCGCTA.GATCTTCGC
ATTGCGCTA.GTGTCTGGA	ATTGCGCTA.GTGTCTGGA
ATTGCGCTA.TCGTGCCAC	ATTGCGCTA.TCGTGCCAC
ATTGGTTCC.GATCCGCAC	ATTGGTTCC.GATCCGCAC
ATTGGTTCC.GTCATTCTA	ATTGGTTCC.GTCATTCTA
ATTGGTTCC.TCTATGACA	ATTGGTTCC.TCTATGACA
CAACACTCC.ACACATCTG	CAACACTCC.ACACATCTG
CAACACTCC.AGCAGACAA	CAACACTCC.AGCAGACAA
CAACACTCC.CTTCGTGCA	CAACACTCC.CTTCGTGCA
CAACCGGTC.CGCTGTAGT	CAACCGGTC.CGCTGTAGT
CAACCGGTC.CGTAATGAC	CAACCGGTC.CGTAATGAC
CAACCGGTC.GCCGTCTTC	CAACCGGTC.GCCGTCTTC
CAACCGGTC.TATTGCTAC	CAACCGGTC.TATTGCTAC
CAACCGGTC.TCCTTCAAC	CAACCGGTC.TCCTTCAAC
CAACCGGTC.TGTCGTGAG	CAACCGGTC.TGTCGTGAG
CAACCTGGT.CGGAACGAG	CAACCTGGT.CGGAACGAG
CAACCTGGT.GTGGTACGG	CAACCTGGT.GTGGTACGG
CAACGATCG.CCATATGCC	CAACGATCG.CCATATGCC
CAACGATCG.TCGTGCCAC	CAACGATCG.TCGTGCCAC
CAACGCACA.AGCACCAGC	CAACGCACA.AGCACCAGC
CAACGCACA.CACCAAGAT	CAACGCACA.CACCAAGAT
CAACGCACA.CGGTAGCTT	CAACGCACA.CGGTAGCTT
CAACGCACA.CTCGTGTCC	CAACGCACA.CTCGTGTCC
CAACGCACA.GCTAGCTCC	CAACGCACA.GCTAGCTCC
CAACGTCTT.AAGCACAAC	CAACGTCTT.AAGCACAAC
CAACGTCTT.CTGATCCGA	CAACGTCTT.CTGATCCGA
CAACGTCTT.GCATTGATC	CAACGTCTT.GCATTGATC
CAACGTCTT.TAGGAGGAT	CAACGTCTT.TAGGAGGAT
CAACGTCTT.TGTTACTGA	CAACGTCTT.TGTTACTGA
CAACTAATC.AGACATCCA	CAACTAATC.AGACATCCA
CAACTAATC.ATCATGTTC	CAACTAATC.ATCATGTTC
CAACTAATC.CAGCGTAAG	CAACTAATC.CAGCGTAAG
CAACTAATC.GGACAGATT	CAACTAATC.GGACAGATT
CAACTCCAG.AATGAGTCG	CAACTCCAG.AATGAGTCG
CAACTCCAG.CTCCACGTC	CAACTCCAG.CTCCACGTC
CAAGAACCG.CTCTCGATA	CAAGAACCG.CTCTCGATA
CAAGAACCG.CTTACCTAG	CAAGAACCG.CTTACCTAG
CAAGAACCG.TGGATAGGT	CAAGAACCG.TGGATAGGT
CAAGAGAGT.AACACACTC	CAAGAGAGT.AACACACTC
CAAGAGAGT.CAGGTTGTC	CAAGAGAGT.CAGGTTGTC
CAAGAGAGT.CGGTGAGTC	CAAGAGAGT.CGGTGAGTC
CAAGAGAGT.GACCTTGTG	CAAGAGAGT.GACCTTGTG
CAAGAGAGT.GCGCTCTAT	CAAGAGAGT.GCGCTCTAT
CAAGAGAGT.TGGATTAGC	CAAGAGAGT.TGGATTAGC
CAAGAGAGT.TTAACGGAG	CAAGAGAGT.TTAACGGAG
CAAGAGGAG.AACGAGAAT	CAAGAGGAG.AACGAGAAT
CAAGAGGAG.CGGTTCTAT	CAAGAGGAG.CGGTTCTAT
CAAGAGGAG.GATACCGGA	CAAGAGGAG.GATACCGGA
CAAGAGGAG.GCTCCTAGC	CAAGAGGAG.GCTCCTAGC
CAAGAGGAG.GGTCCTAAG	CAAGAGGAG.GGTCCTAAG
CAAGAGGAG.GGTGTTCAT	CAAGAGGAG.GGTGTTCAT
CAAGCCTCG.CAGTCGGTA	CAAGCCTCG.CAGTCGGTA
CAAGCCTCG.CGGACAAGT	CAAGCCTCG.CGGACAAGT
CAAGCCTCG.CGTGAGACT	CAAGCCTCG.CGTGAGACT
CAAGCCTCG.GCCGCTATC	CAAGCCTCG.GCCGCTATC
CAAGCCTCG.TCAGTAAGC	CAAGCCTCG.TCAGTAAGC
CAAGCCTCG.TCCAGCTAT	CAAGCCTCG.TCCAGCTAT
CAAGCCTCG.TGAGGTCTC	CAAGCCTCG.TGAGGTCTC
CAAGCCTCG.TGTTAAGCC	CAAGCCTCG.TGTTAAGCC
CAAGCGCAT.ACGATGACC	CAAGCGCAT.ACGATGACC
CAAGCGCAT.AGTTATCGC	CAAGCGCAT.AGTTATCGC
CAAGCGCAT.CCATACGAT	CAAGCGCAT.CCATACGAT
CAAGCGCAT.GATTGAGTA	CAAGCGCAT.GATTGAGTA
CAAGCGCAT.GCCAACAAT	CAAGCGCAT.GCCAACAAT
CAAGCGCAT.GCGGTAGTC	CAAGCGCAT.GCGGTAGTC
CAAGCGCAT.TAATCACGC	CAAGCGCAT.TAATCACGC
CAAGCTGCA.ACGACATCT	CAAGCTGCA.ACGACATCT
CAAGGTGTG.AGTGAACGG	CAAGGTGTG.AGTGAACGG
CAAGGTGTG.ATTCACCTC	CAAGGTGTG.ATTCACCTC
CAAGGTGTG.GATCTAGAG	CAAGGTGTG.GATCTAGAG
CAAGGTGTG.TGTTGTCGA	CAAGGTGTG.TGTTGTCGA
CAAGTACGA.CCGCATCCT	CAAGTACGA.CCGCATCCT
CAAGTACGA.TAACACGAG	CAAGTACGA.TAACACGAG
CAAGTCACT.CTCTGCAAG	CAAGTCACT.CTCTGCAAG
CAAGTCACT.GTCCGTAAG	CAAGTCACT.GTCCGTAAG
CAAGTCACT.TTCTCCACA	CAAGTCACT.TTCTCCACA
CAAGTCACT.TTGCGAACA	CAAGTCACT.TTGCGAACA
CAAGTCGAA.CGGAAGACG	CAAGTCGAA.CGGAAGACG
CAAGTCGAA.CTAGTTCCA	CAAGTCGAA.CTAGTTCCA
CAAGTCGAA.CTCGTGTCC	CAAGTCGAA.CTCGTGTCC
CAAGTCGAA.GCCGTGAAC	CAAGTCGAA.GCCGTGAAC
CAAGTCGAA.GGTGAGTTC	CAAGTCGAA.GGTGAGTTC
CAATACCAC.CCTATTCAA	CAATACCAC.CCTATTCAA
CAATACCAC.CTGATGCAC	CAATACCAC.CTGATGCAC
CAATCAAGT.ACCTGTACC	CAATCAAGT.ACCTGTACC
CAATCAAGT.ACTGACTAC	CAATCAAGT.ACTGACTAC
CAATCAAGT.CACTACAGG	CAATCAAGT.CACTACAGG
CAATCAAGT.CAGCAGTAC	CAATCAAGT.CAGCAGTAC
CAATCAAGT.CCAGTACTC	CAATCAAGT.CCAGTACTC
CAATCAAGT.GTCCTTCAT	CAATCAAGT.GTCCTTCAT
CAATCAAGT.TGATGACAG	CAATCAAGT.TGATGACAG
CAATCATAC.AGCGGTAAG	CAATCATAC.AGCGGTAAG
CAATCATAC.AGCGTAGAA	CAATCATAC.AGCGTAGAA
CAATCATAC.ATGAACTAG	CAATCATAC.ATGAACTAG
CAATCATAC.CTCGTGTCC	CAATCATAC.CTCGTGTCC
CAATCTCCG.ACAGCATCA	CAATCTCCG.ACAGCATCA
CAATCTCCG.ACCTAGCAC	CAATCTCCG.ACCTAGCAC
CAATCTCCG.AGGAATTGG	CAATCTCCG.AGGAATTGG
CAATGCATT.AAGCTGAGG	CAATGCATT.AAGCTGAGG
CAATGCATT.CCTTGTTGC	CAATGCATT.CCTTGTTGC
CAATGCATT.CTAGACATG	CAATGCATT.CTAGACATG
CAATGCATT.TCACAGGTA	CAATGCATT.TCACAGGTA
CAATGCATT.TCAGGTGCA	CAATGCATT.TCAGGTGCA
CAATGCATT.TCCATCATT	CAATGCATT.TCCATCATT
CAATGTGCT.CCAATGCCT	CAATGTGCT.CCAATGCCT
CAATGTGCT.CGTATTCCT	CAATGTGCT.CGTATTCCT
CAATGTGCT.CTAACTAAG	CAATGTGCT.CTAACTAAG
CAATGTGCT.TCTATGACA	CAATGTGCT.TCTATGACA
CAATTGTCT.CCTTAACAT	CAATTGTCT.CCTTAACAT
CAATTGTCT.CTCAGCTGG	CAATTGTCT.CTCAGCTGG
