AACAACCTA.GATTATGCG	AACAACCTA.GATTATGCG
AACAACCTA.GTGAATGCC	AACAACCTA.GTGAATGCC
AACAACCTA.TGCAACTCT	AACAACCTA.TGCAACTCT
AACAACTGG.ATCATAGAC	AACAACTGG.ATCATAGAC
AACAACTGG.ATGAACTAG	AACAACTGG.ATGAACTAG
AACAATGCA.ACTTCTTGG	AACAATGCA.ACTTCTTGG
AACACACTC.ACCTGCAGA	AACACACTC.ACCTGCAGA
AACACACTC.ACGATGGAA	AACACACTC.ACGATGGAA
AACACACTC.ATCGTAGTG	AACACACTC.ATCGTAGTG
AACACACTC.CATGCCAGT	AACACACTC.CATGCCAGT
AACACACTC.GGTCTCATG	AACACACTC.GGTCTCATG
AACAGCAGT.AGAAGTCCT	AACAGCAGT.AGAAGTCCT
AACAGCAGT.ATATGCAGC	AACAGCAGT.ATATGCAGC
AACAGCAGT.TCGTACCTT	AACAGCAGT.TCGTACCTT
AACCATGGT.AACGATGAC	AACCATGGT.AACGATGAC
AACCATGGT.ACCTAGTTA	AACCATGGT.ACCTAGTTA
AACCATGGT.ACTTCAGTA	AACCATGGT.ACTTCAGTA
AACCATGGT.TCAAGGAGT	AACCATGGT.TCAAGGAGT
AACCATGGT.TCGATTCAG	AACCATGGT.TCGATTCAG
AACCGCTGA.ACGTACTGC	AACCGCTGA.ACGTACTGC
AACCGCTGA.GGTACTTCC	AACCGCTGA.GGTACTTCC
AACCGTGAG.ACTCCTGAG	AACCGTGAG.ACTCCTGAG
AACGAGAAT.TATAGTGCG	AACGAGAAT.TATAGTGCG
AACGAGGTG.ACTATCCTG	AACGAGGTG.ACTATCCTG
AACGAGGTG.CAATGCATT	AACGAGGTG.CAATGCATT
AACGAGGTG.CCTGACCTC	AACGAGGTG.CCTGACCTC
AACGAGGTG.TCGGAACGA	AACGAGGTG.TCGGAACGA
AACGATGAC.TCGACGTTG	AACGATGAC.TCGACGTTG
AACGCATTG.CGCTGTAGT	AACGCATTG.CGCTGTAGT
AACGCATTG.CTTCCGTGG	AACGCATTG.CTTCCGTGG
AACGCATTG.TTATTCGAC	AACGCATTG.TTATTCGAC
AACGCCTAC.CTCGTTCAC	AACGCCTAC.CTCGTTCAC
AACGCCTAC.GAGTTAACT	AACGCCTAC.GAGTTAACT
AACGCCTAC.TCAGGTGCA	AACGCCTAC.TCAGGTGCA
AACGCCTAC.TCTTGGTAG	AACGCCTAC.TCTTGGTAG
AACGCTCAA.ACATTGACA	AACGCTCAA.ACATTGACA
AACGCTCAA.ATAGCCTAA	AACGCTCAA.ATAGCCTAA
AACGCTCAA.CACTACAGG	AACGCTCAA.CACTACAGG
AACGCTCAA.CCGCAATGG	AACGCTCAA.CCGCAATGG
AACGCTCAA.CCTGCAGAT	AACGCTCAA.CCTGCAGAT
AACGCTCAA.GTCGTTGCG	AACGCTCAA.GTCGTTGCG
AACGCTCAA.TCGTACCTT	AACGCTCAA.TCGTACCTT
AACGCTCAA.TGGACTGCC	AACGCTCAA.TGGACTGCC
AACGGAGAT.ATCATAGAC	AACGGAGAT.ATCATAGAC
AACGGTAGC.AGTTAGGTC	AACGGTAGC.AGTTAGGTC
AACGGTAGC.CCACACAGA	AACGGTAGC.CCACACAGA
AACGGTAGC.GCCGTGAAC	AACGGTAGC.GCCGTGAAC
AACGGTAGC.GCTGATGTC	AACGGTAGC.GCTGATGTC
AACGGTAGC.GTCTCCAGG	AACGGTAGC.GTCTCCAGG
AACGGTAGC.TAAGGTCCG	AACGGTAGC.TAAGGTCCG
AACGTCGAG.ACTCTCACA	AACGTCGAG.ACTCTCACA
AACGTCGAG.GACCTTGTG	AACGTCGAG.GACCTTGTG
AACGTCGAG.GTGGTACGG	AACGTCGAG.GTGGTACGG
AACGTCGAG.TCGCCAAGC	AACGTCGAG.TCGCCAAGC
AACGTCGAG.TTCACCTTG	AACGTCGAG.TTCACCTTG
AACGTTCTT.ACTCCAACT	AACGTTCTT.ACTCCAACT
AACGTTCTT.CGAATGAGT	AACGTTCTT.CGAATGAGT
AACTAACTG.CATGCCAGT	AACTAACTG.CATGCCAGT
AACTAACTG.CCTGACCTC	AACTAACTG.CCTGACCTC
AACTCCATG.AATGCTATC	AACTCCATG.AATGCTATC
AACTCCATG.CATAGGTGT	AACTCCATG.CATAGGTGT
AACTCCATG.CTGAGATAG	AACTCCATG.CTGAGATAG
AACTCCATG.CTGAGTAGC	AACTCCATG.CTGAGTAGC
AACTGATTC.CAAGTCGAA	AACTGATTC.CAAGTCGAA
AACTGATTC.CCGTCCACT	AACTGATTC.CCGTCCACT
AACTGATTC.TAGTGCACT	AACTGATTC.TAGTGCACT
AACTGCGAC.ACGTGTAGT	AACTGCGAC.ACGTGTAGT
AACTGCGAC.CCGAATATG	AACTGCGAC.CCGAATATG
AACTGCGAC.CTCTGTCAA	AACTGCGAC.CTCTGTCAA
AACTGCGAC.CTTGGTCAT	AACTGCGAC.CTTGGTCAT
AACTGCGAC.GCAGCTCTT	AACTGCGAC.GCAGCTCTT
AACTTAGCT.CCATTACAG	AACTTAGCT.CCATTACAG
AACTTAGCT.CGATTCGAG	AACTTAGCT.CGATTCGAG
AACTTCTGC.ACAATTCGG	AACTTCTGC.ACAATTCGG
AACTTCTGC.ATAGAGCAG	AACTTCTGC.ATAGAGCAG
AACTTCTGC.CTCGCTACG	AACTTCTGC.CTCGCTACG
AACTTCTGC.GCGACAACC	AACTTCTGC.GCGACAACC
AACTTGTCG.ATCCATTAG	AACTTGTCG.ATCCATTAG
AACTTGTCG.CTATTAAGG	AACTTGTCG.CTATTAAGG
AACTTGTCG.GCCAACAAT	AACTTGTCG.GCCAACAAT
AACTTGTCG.GCCATACAA	AACTTGTCG.GCCATACAA
AACTTGTCG.TCAGGACTG	AACTTGTCG.TCAGGACTG
AAGACGAAG.AGCACCAGC	AAGACGAAG.AGCACCAGC
AAGACGAAG.AGGATTGAG	AAGACGAAG.AGGATTGAG
AAGACGAAG.CTCATGCCA	AAGACGAAG.CTCATGCCA
AAGACGAAG.GAGATACAC	AAGACGAAG.GAGATACAC
AAGACGAAG.GCGCTAGAA	AAGACGAAG.GCGCTAGAA
AAGACGAAG.GGATGCGAA	AAGACGAAG.GGATGCGAA
AAGACGAAG.GGTGATAGG	AAGACGAAG.GGTGATAGG
AAGACGAAG.GTCTTATGC	AAGACGAAG.GTCTTATGC
AAGACGAAG.TAAGTGTAG	AAGACGAAG.TAAGTGTAG
AAGACGAAG.TAGCCTTGT	AAGACGAAG.TAGCCTTGT
AAGACGAAG.TCTCGTATC	AAGACGAAG.TCTCGTATC
AAGACTACC.TACATGCAC	AAGACTACC.TACATGCAC
AAGACTACC.TGAACGGTT	AAGACTACC.TGAACGGTT
AAGACTGGT.CACCTAGCG	AAGACTGGT.CACCTAGCG
AAGACTGGT.CGACCTGTA	AAGACTGGT.CGACCTGTA
AAGACTGGT.GCGTGATAC	AAGACTGGT.GCGTGATAC
AAGAGAACT.ACTGGTCAG	AAGAGAACT.ACTGGTCAG
AAGAGAACT.TAGACCTAC	AAGAGAACT.TAGACCTAC
AAGAGAACT.TGTCGTACA	AAGAGAACT.TGTCGTACA
AAGAGAGAG.GATACTGTG	AAGAGAGAG.GATACTGTG
AAGAGAGAG.GTACGTCTA	AAGAGAGAG.GTACGTCTA
AAGAGAGAG.GTCGTTAGA	AAGAGAGAG.GTCGTTAGA
AAGAGAGAG.TAGTGATCC	AAGAGAGAG.TAGTGATCC
AAGAGAGAG.TGCCGAACT	AAGAGAGAG.TGCCGAACT
AAGAGAGAG.TGCTCAGCG	AAGAGAGAG.TGCTCAGCG
AAGCAACTA.AGTGTCTCT	AAGCAACTA.AGTGTCTCT
AAGCAACTA.GCCACGAGT	AAGCAACTA.GCCACGAGT
AAGCAATCG.ACAAGGTAC	AAGCAATCG.ACAAGGTAC
AAGCAATCG.CGTTGATCC	AAGCAATCG.CGTTGATCC
AAGCAATCG.GGACTATTC	AAGCAATCG.GGACTATTC
AAGCACAAC.AATTAGAGG	AAGCACAAC.AATTAGAGG
AAGCACAAC.CGAAGAGGT	AAGCACAAC.CGAAGAGGT
AAGCACAAC.CTGACGGAT	AAGCACAAC.CTGACGGAT
AAGCACAAC.GCTCTCCAA	AAGCACAAC.GCTCTCCAA
AAGCACAAC.TGTATCGTG	AAGCACAAC.TGTATCGTG
AAGCAGCAT.CGAGCCGTT	AAGCAGCAT.CGAGCCGTT
AAGCAGCAT.GATCGCGAA	AAGCAGCAT.GATCGCGAA
AAGCAGCAT.GTACAATGC	AAGCAGCAT.GTACAATGC
AAGCAGCAT.TATGGTTGG	AAGCAGCAT.TATGGTTGG
AAGCATTGC.CTTGCGACC	AAGCATTGC.CTTGCGACC
AAGCATTGC.GACTTCACC	AAGCATTGC.GACTTCACC
AAGCATTGC.TCGCATTCG	AAGCATTGC.TCGCATTCG
AAGCCAAGT.ACACTAACG	AAGCCAAGT.ACACTAACG
AAGCCAAGT.AGATACGTT	AAGCCAAGT.AGATACGTT
AAGCCAAGT.CGTCTGTCC	AAGCCAAGT.CGTCTGTCC
AAGCCAAGT.TCTAGTGAC	AAGCCAAGT.TCTAGTGAC
AAGCCAAGT.TTGCCAGAT	AAGCCAAGT.TTGCCAGAT
AAGCCACAC.CTGGACTAA	AAGCCACAC.CTGGACTAA
AAGCTGAGG.ACACACGTC	AAGCTGAGG.ACACACGTC
AAGCTGAGG.ATAGACCGA	AAGCTGAGG.ATAGACCGA
AAGCTGAGG.CAATCATAC	AAGCTGAGG.CAATCATAC
AAGCTGAGG.CGTGAGACT	AAGCTGAGG.CGTGAGACT
AAGCTGAGG.CTCCGCATT	AAGCTGAGG.CTCCGCATT
AAGCTGAGG.CTGCGTCAC	AAGCTGAGG.CTGCGTCAC
AAGCTGGTC.ATAACGACA	AAGCTGGTC.ATAACGACA
AAGCTGGTC.ATGGATATC	AAGCTGGTC.ATGGATATC
AAGCTGGTC.CCTCTCTAG	AAGCTGGTC.CCTCTCTAG
AAGCTGGTC.GGATACAAT	AAGCTGGTC.GGATACAAT
AAGCTGGTC.TTGATGAGT	AAGCTGGTC.TTGATGAGT
AAGCTTGCA.CCACATTAG	AAGCTTGCA.CCACATTAG
AAGCTTGCA.CTAGGTACT	AAGCTTGCA.CTAGGTACT
AAGCTTGCA.GACCACTCG	AAGCTTGCA.GACCACTCG
AAGCTTGCA.GATCGCGAA	AAGCTTGCA.GATCGCGAA
AAGCTTGCA.GGAACCTAG	AAGCTTGCA.GGAACCTAG
AAGGAACAG.TCAGTGCAA	AAGGAACAG.TCAGTGCAA
AAGGAACAG.TTCCAGGAG	AAGGAACAG.TTCCAGGAG
AAGGAACAG.TTCCGAGCG	AAGGAACAG.TTCCGAGCG
AAGGAAGTC.TGGTTATAC	AAGGAAGTC.TGGTTATAC
AAGGATACG.AGCACACCT	AAGGATACG.AGCACACCT
AAGGATACG.ATCGGTGGT	AAGGATACG.ATCGGTGGT
AAGGATCGT.AGATGAGAT	AAGGATCGT.AGATGAGAT
AAGGATCGT.AGGTGTACA	AAGGATCGT.AGGTGTACA
AAGGATCGT.GGTTAGATG	AAGGATCGT.GGTTAGATG
AAGGATCGT.TGTCAACCT	AAGGATCGT.TGTCAACCT
AAGGTCTGA.CCTTGCTTG	AAGGTCTGA.CCTTGCTTG
AAGGTCTGA.CTAGTCGTC	AAGGTCTGA.CTAGTCGTC
AAGGTCTGA.GCTCCTAGC	AAGGTCTGA.GCTCCTAGC
AAGGTCTGA.GCTTGTCCT	AAGGTCTGA.GCTTGTCCT
AAGGTCTGA.GGATACAAT	AAGGTCTGA.GGATACAAT
AAGGTGCTG.ACATGGATT	AAGGTGCTG.ACATGGATT
AAGGTGCTG.CGGACAAGT	AAGGTGCTG.CGGACAAGT
AAGTACAGA.AACGAGGTG	AAGTACAGA.AACGAGGTG
AAGTACAGA.AATGCTGAT	AAGTACAGA.AATGCTGAT
AAGTACAGA.AGACATCCA	AAGTACAGA.AGACATCCA
AAGTACAGA.CTCAGCTGG	AAGTACAGA.CTCAGCTGG
AAGTACAGA.GCGGTAGTC	AAGTACAGA.GCGGTAGTC
AAGTACAGA.TGATCTCGG	AAGTACAGA.TGATCTCGG
AAGTACAGA.TTCTCCACA	AAGTACAGA.TTCTCCACA
AAGTAGGAC.ATACAACCG	AAGTAGGAC.ATACAACCG
AAGTCATGA.CTGATCCGA	AAGTCATGA.CTGATCCGA
AAGTCATGA.TCCACGTGC	AAGTCATGA.TCCACGTGC
AAGTTCTCT.GTGCTGACT	AAGTTCTCT.GTGCTGACT
AAGTTCTCT.TACTTCCAG	AAGTTCTCT.TACTTCCAG
AAGTTGCCA.AACGGAGAT	AAGTTGCCA.AACGGAGAT
AAGTTGCCA.CCAGTCTCA	AAGTTGCCA.CCAGTCTCA
AAGTTGCCA.CTTCCTGAT	AAGTTGCCA.CTTCCTGAT
AAGTTGCCA.GAGTGCATA	AAGTTGCCA.GAGTGCATA
AAGTTGCCA.GGAGTTAGC	AAGTTGCCA.GGAGTTAGC
AAGTTGCCA.TAGCCTTGT	AAGTTGCCA.TAGCCTTGT
AATAACTCC.ATCTCTGCT	AATAACTCC.ATCTCTGCT
AATACCTTG.ACTTCAGTA	AATACCTTG.ACTTCAGTA
AATACCTTG.TACACGGTC	AATACCTTG.TACACGGTC
AATACCTTG.TTCACCTTG	AATACCTTG.TTCACCTTG
AATACGTCT.AATCGTGTT	AATACGTCT.AATCGTGTT
AATACGTCT.ACGTGCTCG	AATACGTCT.ACGTGCTCG
AATACGTCT.CTCGACTGC	AATACGTCT.CTCGACTGC
AATACGTCT.GCGCTAGAA	AATACGTCT.GCGCTAGAA
AATACTCCG.CCATTCTGC	AATACTCCG.CCATTCTGC
AATACTCCG.CCTGCTCCA	AATACTCCG.CCTGCTCCA
AATACTCCG.GCAATCACG	AATACTCCG.GCAATCACG
AATACTCCG.TAGCCAGTG	AATACTCCG.TAGCCAGTG
AATAGACGC.CAACTCCAG	AATAGACGC.CAACTCCAG
AATAGACGC.CCTAAGAAG	AATAGACGC.CCTAAGAAG
AATAGACGC.CTTCTATGA	AATAGACGC.CTTCTATGA
AATAGACGC.GCACGCATT	AATAGACGC.GCACGCATT
AATATCAGC.CCTCCAATC	AATATCAGC.CCTCCAATC
AATATCAGC.GTAGAGAGC	AATATCAGC.GTAGAGAGC
AATATCAGC.TAGCAGAGT	AATATCAGC.TAGCAGAGT
AATATCAGC.TTACAGTGT	AATATCAGC.TTACAGTGT
AATATCGCT.AAGGTCTGA	AATATCGCT.AAGGTCTGA
AATATCGCT.ATATAGCGT	AATATCGCT.ATATAGCGT
AATATCGCT.GCGCATTAC	AATATCGCT.GCGCATTAC
AATATCGCT.TCAGAGTCA	AATATCGCT.TCAGAGTCA
AATCAGGAG.GGACTATTC	AATCAGGAG.GGACTATTC
AATCCGCTG.ACACGTTGC	AATCCGCTG.ACACGTTGC
AATCCGCTG.ACTGTAATC	AATCCGCTG.ACTGTAATC
AATCCGCTG.ACTTCGCAG	AATCCGCTG.ACTTCGCAG
AATCCGCTG.CGACGTGAT	AATCCGCTG.CGACGTGAT
AATCCGCTG.GGTAAGTGA	AATCCGCTG.GGTAAGTGA
AATCCTCGT.ATGCCTTCA	AATCCTCGT.ATGCCTTCA
AATCCTCGT.CATTCCGAG	AATCCTCGT.CATTCCGAG
AATCCTCGT.CTCGTGTCC	AATCCTCGT.CTCGTGTCC
AATCCTCGT.GACGGACTA	AATCCTCGT.GACGGACTA
AATCCTCGT.TAGGAGGAT	AATCCTCGT.TAGGAGGAT
AATCGCCAT.AGCCACTTC	AATCGCCAT.AGCCACTTC
AATCGCCAT.CCGACGTCA	AATCGCCAT.CCGACGTCA
AATCGCCAT.GCGACACAG	AATCGCCAT.GCGACACAG
AATCGCCAT.TGCTCAGCG	AATCGCCAT.TGCTCAGCG
AATCGTGTT.ATAGCTTGC	AATCGTGTT.ATAGCTTGC
AATCGTGTT.CAAGAGGAG	AATCGTGTT.CAAGAGGAG
AATCGTGTT.CCTTGACGG	AATCGTGTT.CCTTGACGG
AATCGTGTT.GGATACAAT	AATCGTGTT.GGATACAAT
AATCGTGTT.TAGCTGTTG	AATCGTGTT.TAGCTGTTG
AATCGTGTT.TCCAACGTG	AATCGTGTT.TCCAACGTG
AATCTGACC.AACGATGAC	AATCTGACC.AACGATGAC
AATCTGACC.TAGACCTAC	AATCTGACC.TAGACCTAC
AATGAGTCG.AGCCGTTCT	AATGAGTCG.AGCCGTTCT
AATGAGTCG.CACAACCAG	AATGAGTCG.CACAACCAG
AATGAGTCG.GCTACAATG	AATGAGTCG.GCTACAATG
AATGAGTCG.TACCATGTA	AATGAGTCG.TACCATGTA
AATGAGTCG.TGGAGAACC	AATGAGTCG.TGGAGAACC
AATGCACTT.AGATGAGAT	AATGCACTT.AGATGAGAT
AATGCACTT.AGTTACAAG	AATGCACTT.AGTTACAAG
AATGCACTT.CAAGGTGTG	AATGCACTT.CAAGGTGTG
AATGCACTT.CACTTCCTT	AATGCACTT.CACTTCCTT
AATGCAGCG.AGACGCCTG	AATGCAGCG.AGACGCCTG
AATGCAGCG.GGATTACGC	AATGCAGCG.GGATTACGC
AATGCAGCG.GTAACGCGA	AATGCAGCG.GTAACGCGA
AATGCAGCG.TCATGCAGG	AATGCAGCG.TCATGCAGG
AATGCAGCG.TTCTCCACA	AATGCAGCG.TTCTCCACA
AATGCCTCA.AACAACCTA	AATGCCTCA.AACAACCTA
AATGCCTCA.AACCGCTGA	AATGCCTCA.AACCGCTGA
AATGCGTGC.ACTGGTGCT	AATGCGTGC.ACTGGTGCT
AATGCGTGC.GAATTCAGT	AATGCGTGC.GAATTCAGT
AATGCGTGC.GAGGTCCTT	AATGCGTGC.GAGGTCCTT
AATGCTATC.CAGCTCTTC	AATGCTATC.CAGCTCTTC
AATGCTATC.CCTGTATCT	AATGCTATC.CCTGTATCT
AATGCTATC.CCTTAATTC	AATGCTATC.CCTTAATTC
AATGCTATC.GGAACCTAG	AATGCTATC.GGAACCTAG
AATGCTATC.TAGTAGTCT	AATGCTATC.TAGTAGTCT
AATGCTGAT.ACGACTGCG	AATGCTGAT.ACGACTGCG
AATGCTGAT.CCGTTCCAA	AATGCTGAT.CCGTTCCAA
AATGCTGAT.CCTTCCTCA	AATGCTGAT.CCTTCCTCA
AATGCTGAT.GAGCGACTC	AATGCTGAT.GAGCGACTC
AATGTGCGT.CCAGGAGTT	AATGTGCGT.CCAGGAGTT
AATGTGCGT.TTGTTAGAG	AATGTGCGT.TTGTTAGAG
AATTAGAGG.AACCATGGT	AATTAGAGG.AACCATGGT
AATTAGAGG.AAGTTGCCA	AATTAGAGG.AAGTTGCCA
AATTAGAGG.GTCCTTCAT	AATTAGAGG.GTCCTTCAT
AATTAGAGG.TCTGCAACA	AATTAGAGG.TCTGCAACA
AATTCGGAA.AATTGGTGA	AATTCGGAA.AATTGGTGA
AATTCGGAA.CAATTGTCT	AATTCGGAA.CAATTGTCT
AATTCGGAA.CACTTCCTT	AATTCGGAA.CACTTCCTT
AATTCGGAA.TACTACTGT	AATTCGGAA.TACTACTGT
AATTCGGAA.TCCGGAGCT	AATTCGGAA.TCCGGAGCT
AATTGGATC.ACAAGGTAC	AATTGGATC.ACAAGGTAC
AATTGGATC.ACTCGAGTC	AATTGGATC.ACTCGAGTC
AATTGGATC.CATCGCTGG	AATTGGATC.CATCGCTGG
AATTGGATC.TAAGCCATT	AATTGGATC.TAAGCCATT
AATTGGTGA.CGATAGGTG	AATTGGTGA.CGATAGGTG
AATTGGTGA.GATTAGACA	AATTGGTGA.GATTAGACA
ACAACCGGA.CCGCATCCT	ACAACCGGA.CCGCATCCT
ACAACCGGA.GATTAGACA	ACAACCGGA.GATTAGACA
ACAACCGGA.TGAACCAAT	ACAACCGGA.TGAACCAAT
ACAACCGGA.TGAACTTGC	ACAACCGGA.TGAACTTGC
ACAACGAGC.ATCAGGATG	ACAACGAGC.ATCAGGATG
ACAACGAGC.CTCTAAGAG	ACAACGAGC.CTCTAAGAG
ACAACGAGC.CTGAGTCCA	ACAACGAGC.CTGAGTCCA
ACAACGAGC.GCCTAACGG	ACAACGAGC.GCCTAACGG
ACAACGAGC.TACGGTCGT	ACAACGAGC.TACGGTCGT
ACAACGAGC.TAGTGATCC	ACAACGAGC.TAGTGATCC
ACAACGAGC.TGACCAAGT	ACAACGAGC.TGACCAAGT
ACAAGAATG.TACCGATTG	ACAAGAATG.TACCGATTG
ACAAGGTAC.CCATCTAGG	ACAAGGTAC.CCATCTAGG
ACAAGGTAC.CTCTAAGAG	ACAAGGTAC.CTCTAAGAG
ACAAGTACA.AGTAATGGT	ACAAGTACA.AGTAATGGT
ACAAGTACA.CGAATGAGT	ACAAGTACA.CGAATGAGT
ACAAGTACA.GATCTACTT	ACAAGTACA.GATCTACTT
ACAATAGGT.AATATCGCT	ACAATAGGT.AATATCGCT
ACAATAGGT.ATCTGCGTA	ACAATAGGT.ATCTGCGTA
ACAATAGGT.CATTGCAGA	ACAATAGGT.CATTGCAGA
ACAATAGGT.CCACTGAAG	ACAATAGGT.CCACTGAAG
ACAATAGGT.CCTTGTTGC	ACAATAGGT.CCTTGTTGC
ACAATAGGT.GACATATGT	ACAATAGGT.GACATATGT
ACAATAGGT.GATCGCGAA	ACAATAGGT.GATCGCGAA
ACAATAGGT.TGAGGTCTC	ACAATAGGT.TGAGGTCTC
ACAATTCGG.AAGACTGGT	ACAATTCGG.AAGACTGGT
ACAATTCGG.ATCCGACCA	ACAATTCGG.ATCCGACCA
ACACACCGT.GTACCTAAC	ACACACCGT.GTACCTAAC
ACACACGTC.AGTAACGTA	ACACACGTC.AGTAACGTA
ACACACGTC.GCTGTTCGG	ACACACGTC.GCTGTTCGG
ACACAGAAC.AGTCATACT	ACACAGAAC.AGTCATACT
ACACAGAAC.GAAGAGCAC	ACACAGAAC.GAAGAGCAC
ACACAGAAC.GCCAATGAA	ACACAGAAC.GCCAATGAA
ACACAGAAC.TACCATGTA	ACACAGAAC.TACCATGTA
ACACAGAAC.TCGTTCTCC	ACACAGAAC.TCGTTCTCC
ACACATCTG.AGACGCCTG	ACACATCTG.AGACGCCTG
ACACCGCCA.CCTATTGGT	ACACCGCCA.CCTATTGGT
ACACCGCCA.CTTCGACTG	ACACCGCCA.CTTCGACTG
ACACGTTGC.CCTCCAATC	ACACGTTGC.CCTCCAATC
ACACGTTGC.CTGGACACT	ACACGTTGC.CTGGACACT
ACACGTTGC.TAGGAGGAT	ACACGTTGC.TAGGAGGAT
ACACGTTGC.TATCGGAAC	ACACGTTGC.TATCGGAAC
ACACTAACG.GGTCCTAAG	ACACTAACG.GGTCCTAAG
ACACTAACG.TCGTACCTT	ACACTAACG.TCGTACCTT
ACACTAACG.TTAGTCGGA	ACACTAACG.TTAGTCGGA
ACACTAACG.TTGCAGTCA	ACACTAACG.TTGCAGTCA
ACACTGTGA.AATGCACTT	ACACTGTGA.AATGCACTT
ACACTGTGA.ATGGTTCGA	ACACTGTGA.ATGGTTCGA
ACACTGTGA.CCTCGGTCA	ACACTGTGA.CCTCGGTCA
ACAGAAGAG.CGCCTGCAA	ACAGAAGAG.CGCCTGCAA
ACAGAAGAG.GTCTGAGCC	ACAGAAGAG.GTCTGAGCC
ACAGAGATG.CGCTTCACG	ACAGAGATG.CGCTTCACG
ACAGAGATG.GACGTAGCA	ACAGAGATG.GACGTAGCA
ACAGAGATG.GATCGCACT	ACAGAGATG.GATCGCACT
ACAGCATCA.AATGCACTT	ACAGCATCA.AATGCACTT
ACAGCATCA.CCTTGTTGC	ACAGCATCA.CCTTGTTGC
ACAGCGGTC.CCTTGTTGC	ACAGCGGTC.CCTTGTTGC
ACAGCGGTC.GCAGCTTGA	ACAGCGGTC.GCAGCTTGA
ACAGCGGTC.TAGGATGCC	ACAGCGGTC.TAGGATGCC
ACAGCGTAT.TGAACCAAT	ACAGCGTAT.TGAACCAAT
ACAGGAACT.CACAGCGAA	ACAGGAACT.CACAGCGAA
ACAGGAACT.TCCTTCGTA	ACAGGAACT.TCCTTCGTA
ACAGGTATC.ACTGTAATC	ACAGGTATC.ACTGTAATC
ACAGGTATC.CGAACAATC	ACAGGTATC.CGAACAATC
ACAGGTATC.GACGGTGCT	ACAGGTATC.GACGGTGCT
ACAGGTATC.GGATGCGAA	ACAGGTATC.GGATGCGAA
ACAGGTATC.TGGTAGCAG	ACAGGTATC.TGGTAGCAG
ACAGTATTG.AGGAATTGG	ACAGTATTG.AGGAATTGG
ACAGTATTG.CTGTGGTGG	ACAGTATTG.CTGTGGTGG
ACATCGTCC.AGAGCGGAG	ACATCGTCC.AGAGCGGAG
ACATCGTCC.CACATATCA	ACATCGTCC.CACATATCA
ACATCGTCC.TGCATACAT	ACATCGTCC.TGCATACAT
ACATCGTCC.TTCGGAGTC	ACATCGTCC.TTCGGAGTC
ACATGACTA.ACCGAGACA	ACATGACTA.ACCGAGACA
ACATGACTA.AGCTATATG	ACATGACTA.AGCTATATG
ACATGACTA.ATTCACCTC	ACATGACTA.ATTCACCTC
ACATGACTA.CGACCATCA	ACATGACTA.CGACCATCA
ACATTCCAC.ACGTGCTCG	ACATTCCAC.ACGTGCTCG
ACATTCCAC.AGTCCAGTG	ACATTCCAC.AGTCCAGTG
ACATTGACA.ACCTTGAAG	ACATTGACA.ACCTTGAAG
ACATTGACA.TAGATCTGT	ACATTGACA.TAGATCTGT
ACATTGACA.TGAGGTCTC	ACATTGACA.TGAGGTCTC
ACATTGACA.TTCCTGCTA	ACATTGACA.TTCCTGCTA
ACCACGCTA.CATGTGAAC	ACCACGCTA.CATGTGAAC
ACCACGCTA.CTAACCGGT	ACCACGCTA.CTAACCGGT
ACCACGCTA.GCCATACAA	ACCACGCTA.GCCATACAA
ACCACGCTA.GGTTCGCAA	ACCACGCTA.GGTTCGCAA
ACCACGGAT.ACCTCCTAG	ACCACGGAT.ACCTCCTAG
ACCACGGAT.AGGAGCAAT	ACCACGGAT.AGGAGCAAT
ACCACGGAT.AGGTCAGCA	ACCACGGAT.AGGTCAGCA
ACCACTAGG.CCTATTCAA	ACCACTAGG.CCTATTCAA
ACCACTAGG.GCCTTATCT	ACCACTAGG.GCCTTATCT
ACCACTAGG.TCGGACAGT	ACCACTAGG.TCGGACAGT
ACCAGCGTT.ACCGTACGC	ACCAGCGTT.ACCGTACGC
ACCAGCGTT.ATCGGTGGT	ACCAGCGTT.ATCGGTGGT
ACCAGCGTT.GACGTAGCA	ACCAGCGTT.GACGTAGCA
ACCAGCGTT.TGAACGTCA	ACCAGCGTT.TGAACGTCA
ACCATACTT.ACTGTAATC	ACCATACTT.ACTGTAATC
ACCATACTT.GAGGTGAGC	ACCATACTT.GAGGTGAGC
ACCATACTT.GGAAGTATG	ACCATACTT.GGAAGTATG
ACCATCTAA.ATGCTTCAG	ACCATCTAA.ATGCTTCAG
ACCATCTAA.CAACACTCC	ACCATCTAA.CAACACTCC
ACCATCTAA.CCGATCTCT	ACCATCTAA.CCGATCTCT
ACCATCTAA.CCGGATTGC	ACCATCTAA.CCGGATTGC
ACCATCTAA.TCCTCGTCG	ACCATCTAA.TCCTCGTCG
ACCATGTCT.AATCGTGTT	ACCATGTCT.AATCGTGTT
ACCATGTCT.ACCTAGCAC	ACCATGTCT.ACCTAGCAC
ACCATGTCT.GATCTTCGC	ACCATGTCT.GATCTTCGC
ACCATTCAC.AGTCGCCGA	ACCATTCAC.AGTCGCCGA
ACCATTCAC.CCATAGCCA	ACCATTCAC.CCATAGCCA
ACCATTCAC.GTCTTATGC	ACCATTCAC.GTCTTATGC
ACCATTCAC.TAGTCAGAC	ACCATTCAC.TAGTCAGAC
ACCGACGGT.ACTCATTCA	ACCGACGGT.ACTCATTCA
ACCGACGGT.CCACTTCGC	ACCGACGGT.CCACTTCGC
ACCGACGGT.GCATACTCC	ACCGACGGT.GCATACTCC
ACCGACGGT.GTCTGAGCC	ACCGACGGT.GTCTGAGCC
ACCGACGGT.TTGGACTTC	ACCGACGGT.TTGGACTTC
ACCGAGACA.CCAGATCAC	ACCGAGACA.CCAGATCAC
ACCGAGACA.CCGATGTTC	ACCGAGACA.CCGATGTTC
ACCGAGACA.GACTCAGTG	ACCGAGACA.GACTCAGTG
ACCGAGACA.GTGCATCAA	ACCGAGACA.GTGCATCAA
ACCGAGTAG.ATTGCGCTA	ACCGAGTAG.ATTGCGCTA
ACCGAGTAG.GGTTACGCA	ACCGAGTAG.GGTTACGCA
ACCGAGTAG.TTCATCCAA	ACCGAGTAG.TTCATCCAA
ACCGATCGA.AAGCCACAC	ACCGATCGA.AAGCCACAC
ACCGATCGA.ACTTCAGTA	ACCGATCGA.ACTTCAGTA
ACCGATCGA.CCACTTCGC	ACCGATCGA.CCACTTCGC
ACCGATCGA.TCCAGCAGC	ACCGATCGA.TCCAGCAGC
ACCGATCGA.TGTCATAGC	ACCGATCGA.TGTCATAGC
ACCGCTGTG.AGAGAGTGG	ACCGCTGTG.AGAGAGTGG
ACCGCTGTG.CCTAGTTAG	ACCGCTGTG.CCTAGTTAG
ACCGCTGTG.CTGGTAATC	ACCGCTGTG.CTGGTAATC
ACCGCTGTG.GGACTCCTT	ACCGCTGTG.GGACTCCTT
ACCGCTGTG.TACGACTTG	ACCGCTGTG.TACGACTTG
ACCGCTGTG.TCATGCAGG	ACCGCTGTG.TCATGCAGG
ACCGGAAGG.CCGAGTACT	ACCGGAAGG.CCGAGTACT
ACCGGAAGG.CGATACTCT	ACCGGAAGG.CGATACTCT
ACCGGAAGG.GGAAGAAGC	ACCGGAAGG.GGAAGAAGC
ACCGGAAGG.TGCTCACAC	ACCGGAAGG.TGCTCACAC
ACCGGAGTA.CTATTAAGG	ACCGGAGTA.CTATTAAGG
ACCGGAGTA.TCCAACGTG	ACCGGAGTA.TCCAACGTG
ACCGGAGTA.TCCTGTGGA	ACCGGAGTA.TCCTGTGGA
ACCGGTTAC.CCGATGTTC	ACCGGTTAC.CCGATGTTC
ACCGGTTAC.CGTGAGACT	ACCGGTTAC.CGTGAGACT
ACCGGTTAC.GTAGGACGC	ACCGGTTAC.GTAGGACGC
ACCGGTTAC.TATTGACTG	ACCGGTTAC.TATTGACTG
ACCGGTTAC.TCCTCGTCG	ACCGGTTAC.TCCTCGTCG
ACCGTACGC.AGTGACGAT	ACCGTACGC.AGTGACGAT
ACCGTACGC.CGCACTGAA	ACCGTACGC.CGCACTGAA
ACCGTACGC.TGGTCCTAG	ACCGTACGC.TGGTCCTAG
ACCGTCACG.CCTGCGTTA	ACCGTCACG.CCTGCGTTA
ACCGTCACG.CGCGTACTA	ACCGTCACG.CGCGTACTA
ACCGTCACG.TGTCATAGC	ACCGTCACG.TGTCATAGC
ACCGTCCTA.GGAAGAAGC	ACCGTCCTA.GGAAGAAGC
ACCGTCCTA.TGACGGTTG	ACCGTCCTA.TGACGGTTG
ACCGTCCTA.TGTAGCAAG	ACCGTCCTA.TGTAGCAAG
ACCTAGCAC.ACCTGTACC	ACCTAGCAC.ACCTGTACC
ACCTAGCAC.CAACGTCTT	ACCTAGCAC.CAACGTCTT
ACCTAGCAC.CACCTCGGA	ACCTAGCAC.CACCTCGGA
ACCTAGCAC.CAGTATGAT	ACCTAGCAC.CAGTATGAT
ACCTAGCAC.TCCGTATAC	ACCTAGCAC.TCCGTATAC
ACCTAGTTA.TCTATGACA	ACCTAGTTA.TCTATGACA
ACCTCCTAG.ATTCTCTGG	ACCTCCTAG.ATTCTCTGG
ACCTCCTAG.GTGCATCAA	ACCTCCTAG.GTGCATCAA
ACCTGCAGA.CTCCTGACG	ACCTGCAGA.CTCCTGACG
ACCTGCAGA.TAGGATTAG	ACCTGCAGA.TAGGATTAG
ACCTGCAGA.TGTCCATAG	ACCTGCAGA.TGTCCATAG
ACCTGTACC.GATTCCTCT	ACCTGTACC.GATTCCTCT
ACCTGTACC.GCCACATGG	ACCTGTACC.GCCACATGG
ACCTTGAAG.AGAGCGGAG	ACCTTGAAG.AGAGCGGAG
ACCTTGAAG.AGATCTGAC	ACCTTGAAG.AGATCTGAC
ACCTTGAAG.GCTACAATG	ACCTTGAAG.GCTACAATG
ACCTTGAAG.TCTACGCAA	ACCTTGAAG.TCTACGCAA
ACCTTGAAG.TGTATCGTG	ACCTTGAAG.TGTATCGTG
ACCTTGAAG.TTATTCGAC	ACCTTGAAG.TTATTCGAC
ACGAATCGC.GCGATGGTG	ACGAATCGC.GCGATGGTG
ACGAATCGC.TCACCGAGG	ACGAATCGC.TCACCGAGG
ACGACAGTC.GCATACTCC	ACGACAGTC.GCATACTCC
ACGACAGTC.GCTGGTTCG	ACGACAGTC.GCTGGTTCG
ACGACATCT.ACCATCTAA	ACGACATCT.ACCATCTAA
ACGACATCT.AGCTTCGAT	ACGACATCT.AGCTTCGAT
ACGACATCT.AGGTATTCC	ACGACATCT.AGGTATTCC
ACGACATCT.ATCACCGCA	ACGACATCT.ATCACCGCA
ACGAGAGCA.AGACGCTAT	ACGAGAGCA.AGACGCTAT
ACGAGAGCA.CCTCGCGTT	ACGAGAGCA.CCTCGCGTT
ACGAGAGCA.TCACCGAGG	ACGAGAGCA.TCACCGAGG
ACGAGCTTC.AGTACGAAT	ACGAGCTTC.AGTACGAAT
ACGAGCTTC.GTGCCATGA	ACGAGCTTC.GTGCCATGA
ACGAGCTTC.GTTAGAGAC	ACGAGCTTC.GTTAGAGAC
ACGAGCTTC.TGCCGAACT	ACGAGCTTC.TGCCGAACT
ACGATGACC.ATTGATTGG	ACGATGACC.ATTGATTGG
ACGATGACC.CCGCTATCC	ACGATGACC.CCGCTATCC
ACGATGACC.CGCCACCAT	ACGATGACC.CGCCACCAT
ACGATGGAA.ACGCACACT	ACGATGGAA.ACGCACACT
ACGATGGAA.ATCCACAGT	ACGATGGAA.ATCCACAGT
ACGATGGAA.CATTCGAAT	ACGATGGAA.CATTCGAAT
ACGATGGAA.CTGAGTAGC	ACGATGGAA.CTGAGTAGC
ACGATGGAA.TACTAGTAG	ACGATGGAA.TACTAGTAG
ACGCAAGAT.CACCAAGAT	ACGCAAGAT.CACCAAGAT
ACGCAAGAT.CACCTCAAC	ACGCAAGAT.CACCTCAAC
ACGCACACT.AACGTCGAG	ACGCACACT.AACGTCGAG
ACGCACACT.ATGGAGGAA	ACGCACACT.ATGGAGGAA
ACGCACACT.GACGTAGCA	ACGCACACT.GACGTAGCA
ACGCACACT.GAGACATTG	ACGCACACT.GAGACATTG
ACGCACACT.GGAAGAAGC	ACGCACACT.GGAAGAAGC
ACGCACACT.TGAGAGGAC	ACGCACACT.TGAGAGGAC
ACGCGACAG.ACGAGAGCA	ACGCGACAG.ACGAGAGCA
ACGCGACAG.AGGAGGTGA	ACGCGACAG.AGGAGGTGA
ACGCGACAG.CCGGTTCTA	ACGCGACAG.CCGGTTCTA
ACGCGACAG.GAATCACAT	ACGCGACAG.GAATCACAT
ACGCGACAG.GCTTCACTC	ACGCGACAG.GCTTCACTC
ACGCGACAG.TCTTAGCGA	ACGCGACAG.TCTTAGCGA
ACGCGACAG.TTGTCAACC	ACGCGACAG.TTGTCAACC
ACGCGTGAC.AGTGAACGG	ACGCGTGAC.AGTGAACGG
ACGCGTGAC.CGACCATCA	ACGCGTGAC.CGACCATCA
ACGCGTGAC.CTCTAGTAA	ACGCGTGAC.CTCTAGTAA
ACGCGTGAC.GGAGTTAGC	ACGCGTGAC.GGAGTTAGC
ACGCGTGAC.TTGAGCTCT	ACGCGTGAC.TTGAGCTCT
ACGCTAGTG.GACTCAGTG	ACGCTAGTG.GACTCAGTG
ACGCTAGTG.GGTAGACAT	ACGCTAGTG.GGTAGACAT
ACGCTATGT.AGCGACACC	ACGCTATGT.AGCGACACC
ACGCTATGT.CGGTGAGTC	ACGCTATGT.CGGTGAGTC
ACGCTATGT.GAGGTCACG	ACGCTATGT.GAGGTCACG
ACGCTATGT.TAACGTGTC	ACGCTATGT.TAACGTGTC
ACGCTATGT.TATGATGTG	ACGCTATGT.TATGATGTG
ACGCTCTTA.AACACACTC	ACGCTCTTA.AACACACTC
ACGCTCTTA.ACTCCGTCG	ACGCTCTTA.ACTCCGTCG
