TGATCTCGG.CTCTACGCA	TGATCTCGG.CTCTACGCA
TGATCTCGG.TAACGTGTC	TGATCTCGG.TAACGTGTC
TGATGACAG.ACCATTCAC	TGATGACAG.ACCATTCAC
TGATGACAG.ATGCTGTCG	TGATGACAG.ATGCTGTCG
TGATGACAG.CGTGGTACC	TGATGACAG.CGTGGTACC
TGATGGACA.ATCCATTAG	TGATGGACA.ATCCATTAG
TGATGGACA.CTGGACACT	TGATGGACA.CTGGACACT
TGATGGACA.GTGCTCGGA	TGATGGACA.GTGCTCGGA
TGATGTGTG.ATCATTACG	TGATGTGTG.ATCATTACG
TGATGTGTG.CTCTCAGTC	TGATGTGTG.CTCTCAGTC
TGATGTGTG.CTGGAGCGA	TGATGTGTG.CTGGAGCGA
TGATGTGTG.GACCACTCG	TGATGTGTG.GACCACTCG
TGATGTGTG.GATCTTCGC	TGATGTGTG.GATCTTCGC
TGATGTGTG.GGATACAAT	TGATGTGTG.GGATACAAT
TGATGTGTG.GTTCCAACA	TGATGTGTG.GTTCCAACA
TGATGTGTG.TGGTCCTAG	TGATGTGTG.TGGTCCTAG
TGATGTGTG.TTCCGCCAG	TGATGTGTG.TTCCGCCAG
TGATTATCG.ACATCGTCC	TGATTATCG.ACATCGTCC
TGATTATCG.ACGGTGTAC	TGATTATCG.ACGGTGTAC
TGATTATCG.AGACTAGTA	TGATTATCG.AGACTAGTA
TGATTATCG.AGGAGGTGA	TGATTATCG.AGGAGGTGA
TGATTATCG.CGCGCACAT	TGATTATCG.CGCGCACAT
TGATTATCG.GAACGCTGT	TGATTATCG.GAACGCTGT
TGATTCACC.AAGCAACTA	TGATTCACC.AAGCAACTA
TGATTCACC.ACGTACTGC	TGATTCACC.ACGTACTGC
TGATTGCTG.AGCACACCT	TGATTGCTG.AGCACACCT
TGATTGCTG.AGCTCTCCG	TGATTGCTG.AGCTCTCCG
TGATTGCTG.CCACGTTCT	TGATTGCTG.CCACGTTCT
TGATTGCTG.CCGTCAGGT	TGATTGCTG.CCGTCAGGT
TGATTGCTG.GACGTCAAT	TGATTGCTG.GACGTCAAT
TGATTGCTG.TGGACGAGA	TGATTGCTG.TGGACGAGA
TGATTGTGC.AACGGTAGC	TGATTGTGC.AACGGTAGC
TGATTGTGC.CTTGTAACG	TGATTGTGC.CTTGTAACG
TGATTGTGC.GCACATGTT	TGATTGTGC.GCACATGTT
TGATTGTGC.TAGTCGCAT	TGATTGTGC.TAGTCGCAT
TGCAACTCT.ATCCGTCTC	TGCAACTCT.ATCCGTCTC
TGCAACTCT.CAAGTCGAA	TGCAACTCT.CAAGTCGAA
TGCAACTCT.TAGAGACTA	TGCAACTCT.TAGAGACTA
TGCAACTCT.TTGCCAGAT	TGCAACTCT.TTGCCAGAT
TGCACGATG.ACAGCATCA	TGCACGATG.ACAGCATCA
TGCACGATG.GACCTTGTG	TGCACGATG.GACCTTGTG
TGCACGATG.TACCGCGTT	TGCACGATG.TACCGCGTT
TGCAGATGC.CCGATACCG	TGCAGATGC.CCGATACCG
TGCAGCCTT.TACAACACC	TGCAGCCTT.TACAACACC
TGCAGCCTT.TACAGGACT	TGCAGCCTT.TACAGGACT
TGCAGTCGG.ACCGTCACG	TGCAGTCGG.ACCGTCACG
TGCAGTCGG.ACCTAGCAC	TGCAGTCGG.ACCTAGCAC
TGCAGTCGG.ATTATGCAG	TGCAGTCGG.ATTATGCAG
TGCAGTCGG.CAGCAGTAC	TGCAGTCGG.CAGCAGTAC
TGCAGTCGG.CATAATTGG	TGCAGTCGG.CATAATTGG
TGCAGTCGG.GCTAGTGGA	TGCAGTCGG.GCTAGTGGA
TGCAGTCGG.TCCAGAACG	TGCAGTCGG.TCCAGAACG
TGCAGTCGG.TGATCTCGG	TGCAGTCGG.TGATCTCGG
TGCAGTCGG.TTGACCTGA	TGCAGTCGG.TTGACCTGA
TGCAGTTCA.ACCACGCTA	TGCAGTTCA.ACCACGCTA
TGCAGTTCA.ATAAGTTCG	TGCAGTTCA.ATAAGTTCG
TGCAGTTCA.GTCACTATG	TGCAGTTCA.GTCACTATG
TGCAGTTCA.TACGGTCGT	TGCAGTTCA.TACGGTCGT
TGCAGTTCA.TCGTACCTT	TGCAGTTCA.TCGTACCTT
TGCATACAT.AGATGTTGG	TGCATACAT.AGATGTTGG
TGCATACAT.ATCAGTCGA	TGCATACAT.ATCAGTCGA
TGCATACAT.GATCTTCGC	TGCATACAT.GATCTTCGC
TGCATACAT.GATGCAGAA	TGCATACAT.GATGCAGAA
TGCATCGGA.ATATGTCCA	TGCATCGGA.ATATGTCCA
TGCATCGGA.CCACAAGGT	TGCATCGGA.CCACAAGGT
TGCATCGGA.CCACTGAAG	TGCATCGGA.CCACTGAAG
TGCATCGGA.GAGATACAC	TGCATCGGA.GAGATACAC
TGCATCGGA.TGGATAGGT	TGCATCGGA.TGGATAGGT
TGCCAATGG.ACAACCGGA	TGCCAATGG.ACAACCGGA
TGCCAATGG.ACAGAAGAG	TGCCAATGG.ACAGAAGAG
TGCCAATGG.CATGTCCTG	TGCCAATGG.CATGTCCTG
TGCCAATGG.TCAATGGAC	TGCCAATGG.TCAATGGAC
TGCCAATGG.TTGCGAACA	TGCCAATGG.TTGCGAACA
TGCCACCGA.GGTCTTGCA	TGCCACCGA.GGTCTTGCA
TGCCACCGA.GTCTACCAA	TGCCACCGA.GTCTACCAA
TGCCACCGA.TAGCTGTTG	TGCCACCGA.TAGCTGTTG
TGCCAGACG.ACGTGCTCG	TGCCAGACG.ACGTGCTCG
TGCCAGACG.AGCACCGTG	TGCCAGACG.AGCACCGTG
TGCCAGACG.GCCGCCTAA	TGCCAGACG.GCCGCCTAA
TGCCAGACG.TCGTCATTC	TGCCAGACG.TCGTCATTC
TGCCGAACT.CTGTTACCA	TGCCGAACT.CTGTTACCA
TGCCGAACT.GCCACATGG	TGCCGAACT.GCCACATGG
TGCCGACTA.AGCAGACAA	TGCCGACTA.AGCAGACAA
TGCCGACTA.CTATACTAG	TGCCGACTA.CTATACTAG
TGCCGACTA.TCGCTTAAC	TGCCGACTA.TCGCTTAAC
TGCCGCTAC.CATCCGACA	TGCCGCTAC.CATCCGACA
TGCCGCTAC.CGTGTCCGA	TGCCGCTAC.CGTGTCCGA
TGCCGCTAC.TGGAGTGGA	TGCCGCTAC.TGGAGTGGA
TGCCTGGTT.ACCTCCTAG	TGCCTGGTT.ACCTCCTAG
TGCCTGGTT.AGGATTACT	TGCCTGGTT.AGGATTACT
TGCCTGGTT.AGTAACGTA	TGCCTGGTT.AGTAACGTA
TGCCTGGTT.CAACACCTA	TGCCTGGTT.CAACACCTA
TGCCTGGTT.CACCTCAAC	TGCCTGGTT.CACCTCAAC
TGCCTGGTT.CATGGTCGA	TGCCTGGTT.CATGGTCGA
TGCCTGGTT.CGATTGAAC	TGCCTGGTT.CGATTGAAC
TGCCTGGTT.CTGAGATAG	TGCCTGGTT.CTGAGATAG
TGCCTGGTT.GAGGTCACG	TGCCTGGTT.GAGGTCACG
TGCCTGGTT.GTGCTAAGC	TGCCTGGTT.GTGCTAAGC
TGCCTGGTT.GTGCTCTTG	TGCCTGGTT.GTGCTCTTG
TGCCTGGTT.TTCCTAAGG	TGCCTGGTT.TTCCTAAGG
TGCCTTCAG.ACAACGAGC	TGCCTTCAG.ACAACGAGC
TGCCTTCAG.ATGAACTAG	TGCCTTCAG.ATGAACTAG
TGCCTTCAG.TATGCCTTC	TGCCTTCAG.TATGCCTTC
TGCCTTCAG.TCTACATCC	TGCCTTCAG.TCTACATCC
TGCCTTCAG.TCTAGGATG	TGCCTTCAG.TCTAGGATG
TGCGACGTT.CGGTTCTAT	TGCGACGTT.CGGTTCTAT
TGCGATACT.CCTCAGGTG	TGCGATACT.CCTCAGGTG
TGCGATACT.GACGTTCAG	TGCGATACT.GACGTTCAG
TGCGATACT.GATGTAAGG	TGCGATACT.GATGTAAGG
TGCGATACT.TTCCGCCAG	TGCGATACT.TTCCGCCAG
TGCGCACTG.ACCATCTAA	TGCGCACTG.ACCATCTAA
TGCGCACTG.AGTCCAGTG	TGCGCACTG.AGTCCAGTG
TGCGCACTG.AGTCGTCCG	TGCGCACTG.AGTCGTCCG
TGCGCACTG.CATCGCTGG	TGCGCACTG.CATCGCTGG
TGCGCACTG.TAATGTAGC	TGCGCACTG.TAATGTAGC
TGCGCTGCA.AAGCCACAC	TGCGCTGCA.AAGCCACAC
TGCGCTGCA.GTCACTATG	TGCGCTGCA.GTCACTATG
TGCGCTGCA.TTAACGGAG	TGCGCTGCA.TTAACGGAG
TGCGTAATC.CTAACACTG	TGCGTAATC.CTAACACTG
TGCGTAATC.GAGCGACTC	TGCGTAATC.GAGCGACTC
TGCGTATCT.ACAAGGTAC	TGCGTATCT.ACAAGGTAC
TGCGTATCT.CTGGTAATC	TGCGTATCT.CTGGTAATC
TGCGTATCT.TAGACACGT	TGCGTATCT.TAGACACGT
TGCGTATCT.TCTGCAACA	TGCGTATCT.TCTGCAACA
TGCGTCTTA.AGCCTCTAG	TGCGTCTTA.AGCCTCTAG
TGCGTCTTA.ATGAGATCC	TGCGTCTTA.ATGAGATCC
TGCGTCTTA.CCTAGCAAT	TGCGTCTTA.CCTAGCAAT
TGCGTCTTA.GAGTCAAGG	TGCGTCTTA.GAGTCAAGG
TGCGTGCCA.ATTCGAAGA	TGCGTGCCA.ATTCGAAGA
TGCGTGCCA.CGAAGAGGT	TGCGTGCCA.CGAAGAGGT
TGCGTGCCA.GACTGCCTG	TGCGTGCCA.GACTGCCTG
TGCGTGCCA.GCGAAGACA	TGCGTGCCA.GCGAAGACA
TGCGTGCCA.TCTATGACA	TGCGTGCCA.TCTATGACA
TGCTATGAA.TTGAGACGG	TGCTATGAA.TTGAGACGG
TGCTCACAC.AGCTGCACT	TGCTCACAC.AGCTGCACT
TGCTCACAC.TGAGCAGAT	TGCTCACAC.TGAGCAGAT
TGCTCAGCG.CAGTATGAT	TGCTCAGCG.CAGTATGAT
TGCTCAGCG.CGAATGAGT	TGCTCAGCG.CGAATGAGT
TGCTCAGCG.TAGCACTAT	TGCTCAGCG.TAGCACTAT
TGCTCCTCC.AGTCCGTGT	TGCTCCTCC.AGTCCGTGT
TGCTCCTCC.CCACCATGC	TGCTCCTCC.CCACCATGC
TGCTCCTCC.CTGCTTAGG	TGCTCCTCC.CTGCTTAGG
TGCTCCTCC.GAGTCAAGG	TGCTCCTCC.GAGTCAAGG
TGCTCCTCC.GCGAGCAAG	TGCTCCTCC.GCGAGCAAG
TGCTGCGTC.CAAGAACCG	TGCTGCGTC.CAAGAACCG
TGCTTACGG.ACCAGCGTT	TGCTTACGG.ACCAGCGTT
TGCTTACGG.ATATGTCCA	TGCTTACGG.ATATGTCCA
TGGAACTAA.AAGAGAACT	TGGAACTAA.AAGAGAACT
TGGAACTAA.AGCGTAGAA	TGGAACTAA.AGCGTAGAA
TGGAACTAA.CTCGTTCAC	TGGAACTAA.CTCGTTCAC
TGGAAGATT.CTTCCTGAT	TGGAAGATT.CTTCCTGAT
TGGAAGATT.GGATTCGTC	TGGAAGATT.GGATTCGTC
TGGAAGATT.TACGTTACC	TGGAAGATT.TACGTTACC
TGGAATCGT.ACTGCTAGT	TGGAATCGT.ACTGCTAGT
TGGAATCGT.GATCCGCAC	TGGAATCGT.GATCCGCAC
TGGAATCGT.GTATACAGA	TGGAATCGT.GTATACAGA
TGGACGAGA.AGCGACACC	TGGACGAGA.AGCGACACC
TGGACGAGA.GTAACGCGA	TGGACGAGA.GTAACGCGA
TGGACGAGA.TACTAGTAG	TGGACGAGA.TACTAGTAG
TGGACGAGA.TGATAGAGG	TGGACGAGA.TGATAGAGG
TGGACTGCC.AGACCACGC	TGGACTGCC.AGACCACGC
TGGACTGCC.CTAGGTACT	TGGACTGCC.CTAGGTACT
TGGACTGCC.GTCTTCTCG	TGGACTGCC.GTCTTCTCG
TGGAGAACC.AAGGAAGTC	TGGAGAACC.AAGGAAGTC
TGGAGAACC.GCACTGGAT	TGGAGAACC.GCACTGGAT
TGGAGAACC.GGATCGTTC	TGGAGAACC.GGATCGTTC
TGGAGAGTG.AATGCACTT	TGGAGAGTG.AATGCACTT
TGGAGAGTG.ACACCGCCA	TGGAGAGTG.ACACCGCCA
TGGAGAGTG.ACTCCAACT	TGGAGAGTG.ACTCCAACT
TGGAGAGTG.CACGGAAGT	TGGAGAGTG.CACGGAAGT
TGGAGAGTG.CAGTACATC	TGGAGAGTG.CAGTACATC
TGGAGAGTG.CCTCGGTCA	TGGAGAGTG.CCTCGGTCA
TGGAGAGTG.CGATTCGAG	TGGAGAGTG.CGATTCGAG
TGGAGAGTG.TCATATCGC	TGGAGAGTG.TCATATCGC
TGGAGTGGA.AGTCGATCA	TGGAGTGGA.AGTCGATCA
TGGAGTGGA.CCACGCCAT	TGGAGTGGA.CCACGCCAT
TGGAGTGGA.TCCTGAGAC	TGGAGTGGA.TCCTGAGAC
TGGAGTGGA.TTGCGAACA	TGGAGTGGA.TTGCGAACA
TGGATAGGT.CGACCTGTA	TGGATAGGT.CGACCTGTA
TGGATAGGT.CTGGAGCGA	TGGATAGGT.CTGGAGCGA
TGGATAGGT.TATCATGCT	TGGATAGGT.TATCATGCT
TGGATTAGC.GAGATACAC	TGGATTAGC.GAGATACAC
TGGATTAGC.GCTTGGTTC	TGGATTAGC.GCTTGGTTC
TGGATTAGC.TCCGGAGCT	TGGATTAGC.TCCGGAGCT
TGGATTAGC.TTCAGTGCC	TGGATTAGC.TTCAGTGCC
TGGTAACCA.TAGGAGGAT	TGGTAACCA.TAGGAGGAT
TGGTAGCAG.CCTGCAGAT	TGGTAGCAG.CCTGCAGAT
TGGTCCTAG.AGAGCGCGA	TGGTCCTAG.AGAGCGCGA
TGGTCCTAG.CACGTCATA	TGGTCCTAG.CACGTCATA
TGGTCCTAG.CCAGTTACG	TGGTCCTAG.CCAGTTACG
TGGTCCTAG.CCGAGTACT	TGGTCCTAG.CCGAGTACT
TGGTCCTAG.CCTTATCCG	TGGTCCTAG.CCTTATCCG
TGGTCCTAG.TACTCGCTG	TGGTCCTAG.TACTCGCTG
TGGTCGCTA.AAGTCATGA	TGGTCGCTA.AAGTCATGA
TGGTCGCTA.CCTTGCTTG	TGGTCGCTA.CCTTGCTTG
TGGTCGCTA.CGCTTATGA	TGGTCGCTA.CGCTTATGA
TGGTCGCTA.GAACCAGTT	TGGTCGCTA.GAACCAGTT
TGGTCGCTA.GGATACCTA	TGGTCGCTA.GGATACCTA
TGGTCTACG.ACCTTGAAG	TGGTCTACG.ACCTTGAAG
TGGTCTACG.TCGCATTCG	TGGTCTACG.TCGCATTCG
TGGTGCCTG.CACACTGCC	TGGTGCCTG.CACACTGCC
TGGTGCCTG.CAGTCTAAC	TGGTGCCTG.CAGTCTAAC
TGGTGCCTG.GCACCATCG	TGGTGCCTG.GCACCATCG
TGGTGGATC.ACTCGCTGT	TGGTGGATC.ACTCGCTGT
TGGTGGATC.CGGTTGCGA	TGGTGGATC.CGGTTGCGA
TGGTGGATC.CTACGAGAA	TGGTGGATC.CTACGAGAA
TGGTGGATC.GAGACATTG	TGGTGGATC.GAGACATTG
TGGTGGTAA.ATTAGCCAC	TGGTGGTAA.ATTAGCCAC
TGGTGGTAA.CTTCCTGAT	TGGTGGTAA.CTTCCTGAT
TGGTTATAC.AAGCCACAC	TGGTTATAC.AAGCCACAC
TGGTTATAC.CCTATTGGT	TGGTTATAC.CCTATTGGT
TGGTTATAC.CCTTCCTCA	TGGTTATAC.CCTTCCTCA
TGTAACAGT.CAATCTCCG	TGTAACAGT.CAATCTCCG
TGTACACGA.CCTTGCTTG	TGTACACGA.CCTTGCTTG
TGTACACGA.GTGGACTGG	TGTACACGA.GTGGACTGG
TGTAGATCG.ACTAAGTTC	TGTAGATCG.ACTAAGTTC
TGTAGATCG.GACGGACTA	TGTAGATCG.GACGGACTA
TGTAGATCG.TGCTCCTCC	TGTAGATCG.TGCTCCTCC
TGTAGCAAG.ATGGAGGAA	TGTAGCAAG.ATGGAGGAA
TGTAGCAAG.CTTGGATCA	TGTAGCAAG.CTTGGATCA
TGTAGCAAG.GAGTCAAGG	TGTAGCAAG.GAGTCAAGG
TGTAGCAAG.GCTTCTACG	TGTAGCAAG.GCTTCTACG
TGTAGCAAG.TGCTCAGCG	TGTAGCAAG.TGCTCAGCG
TGTAGCAAG.TGGAACTAA	TGTAGCAAG.TGGAACTAA
TGTAGGTTA.ATATCAGCC	TGTAGGTTA.ATATCAGCC
TGTAGGTTA.GCGGAGATT	TGTAGGTTA.GCGGAGATT
TGTAGGTTA.GTAAGTGAG	TGTAGGTTA.GTAAGTGAG
TGTATCGTG.AAGCTTGCA	TGTATCGTG.AAGCTTGCA
TGTATCGTG.TACCTCACT	TGTATCGTG.TACCTCACT
TGTATCGTG.TGGTCCTAG	TGTATCGTG.TGGTCCTAG
TGTATCGTG.TGTTGTCGA	TGTATCGTG.TGTTGTCGA
TGTATGTAG.ATAATGTGG	TGTATGTAG.ATAATGTGG
TGTATGTAG.ATCGTAGTG	TGTATGTAG.ATCGTAGTG
TGTCAACCT.AAGTTGCCA	TGTCAACCT.AAGTTGCCA
TGTCAACCT.GAGTTATAG	TGTCAACCT.GAGTTATAG
TGTCAACCT.GTGAATGCC	TGTCAACCT.GTGAATGCC
TGTCACATA.CATAGAGAT	TGTCACATA.CATAGAGAT
TGTCACATA.TGCAACTCT	TGTCACATA.TGCAACTCT
TGTCATAGC.AGAAGCTGC	TGTCATAGC.AGAAGCTGC
TGTCATAGC.GACCGTAGT	TGTCATAGC.GACCGTAGT
TGTCATAGC.GACGGTGCT	TGTCATAGC.GACGGTGCT
TGTCATAGC.GCTCTGTGT	TGTCATAGC.GCTCTGTGT
TGTCATAGC.GTGTTCCAG	TGTCATAGC.GTGTTCCAG
TGTCCATAG.ACACTGTGA	TGTCCATAG.ACACTGTGA
TGTCCATAG.ATCCGGTCC	TGTCCATAG.ATCCGGTCC
TGTCCATAG.CAATCATAC	TGTCCATAG.CAATCATAC
TGTCCATAG.CTTCGTGCA	TGTCCATAG.CTTCGTGCA
TGTCCATAG.GCGCTTCTC	TGTCCATAG.GCGCTTCTC
TGTCCATAG.GCGGAGATT	TGTCCATAG.GCGGAGATT
TGTCCATAG.TATAGTGCG	TGTCCATAG.TATAGTGCG
TGTCGTACA.TCGCCAAGC	TGTCGTACA.TCGCCAAGC
TGTCGTACA.TGACCTCCT	TGTCGTACA.TGACCTCCT
TGTCGTACA.TGCAGTTCA	TGTCGTACA.TGCAGTTCA
TGTCGTGAG.GGTGTTCAT	TGTCGTGAG.GGTGTTCAT
TGTCTACAC.ATATAGCGT	TGTCTACAC.ATATAGCGT
TGTCTACAC.CTTCACTGT	TGTCTACAC.CTTCACTGT
TGTCTACAC.GAGACATTG	TGTCTACAC.GAGACATTG
TGTGAGTAT.ATCTAGGTT	TGTGAGTAT.ATCTAGGTT
TGTGAGTAT.CACATGTGC	TGTGAGTAT.CACATGTGC
TGTGAGTAT.GGATGCGAA	TGTGAGTAT.GGATGCGAA
TGTGAGTAT.TGAGCTAGA	TGTGAGTAT.TGAGCTAGA
TGTGCAGTA.ATCCACAGT	TGTGCAGTA.ATCCACAGT
TGTGCAGTA.CTCTCAGTC	TGTGCAGTA.CTCTCAGTC
TGTGCCATG.ACTCGTCTA	TGTGCCATG.ACTCGTCTA
TGTGCCATG.AGCAAGTCC	TGTGCCATG.AGCAAGTCC
TGTGCCATG.ATCTCTGCT	TGTGCCATG.ATCTCTGCT
TGTGCCATG.CCACGTTCT	TGTGCCATG.CCACGTTCT
TGTGCCATG.CTCTAGTAA	TGTGCCATG.CTCTAGTAA
TGTGCCATG.GCGTGAGCT	TGTGCCATG.GCGTGAGCT
TGTGCCATG.TAGACCATG	TGTGCCATG.TAGACCATG
TGTGCCATG.TATCTGTCA	TGTGCCATG.TATCTGTCA
TGTGCCATG.TGCGTCTTA	TGTGCCATG.TGCGTCTTA
TGTGCCATG.TTAGGAAGG	TGTGCCATG.TTAGGAAGG
TGTGCTAAC.AGAAGAGTC	TGTGCTAAC.AGAAGAGTC
TGTGCTAAC.CTCAGTGAT	TGTGCTAAC.CTCAGTGAT
TGTGCTAAC.GGATCGTTC	TGTGCTAAC.GGATCGTTC
TGTGCTAAC.GGTCTCATG	TGTGCTAAC.GGTCTCATG
TGTGCTAAC.TGGACTGCC	TGTGCTAAC.TGGACTGCC
TGTGCTAAC.TGTGTCTAC	TGTGCTAAC.TGTGTCTAC
TGTGGTCCT.ATCATTACG	TGTGGTCCT.ATCATTACG
TGTGGTCCT.GGAGCATCT	TGTGGTCCT.GGAGCATCT
TGTGTAGAG.GATACACTA	TGTGTAGAG.GATACACTA
TGTGTCTAC.CGGTAGCTT	TGTGTCTAC.CGGTAGCTT
TGTGTCTAC.GCCATTAAG	TGTGTCTAC.GCCATTAAG
TGTGTCTAC.GTAGCATAC	TGTGTCTAC.GTAGCATAC
TGTGTCTAC.GTCTTATGC	TGTGTCTAC.GTCTTATGC
TGTTAAGCC.AACAATGCA	TGTTAAGCC.AACAATGCA
TGTTAAGCC.AAGAGAGAG	TGTTAAGCC.AAGAGAGAG
TGTTAAGCC.AGGTCCGTC	TGTTAAGCC.AGGTCCGTC
TGTTAAGCC.AGTGATGCG	TGTTAAGCC.AGTGATGCG
TGTTAAGCC.GTTGACGTG	TGTTAAGCC.GTTGACGTG
TGTTACTGA.AGTCCAGTG	TGTTACTGA.AGTCCAGTG
TGTTACTGA.ATAATCGAG	TGTTACTGA.ATAATCGAG
TGTTACTGA.CCTCATAAC	TGTTACTGA.CCTCATAAC
TGTTACTGA.TAGCACTAT	TGTTACTGA.TAGCACTAT
TGTTACTGA.TGTCTACAC	TGTTACTGA.TGTCTACAC
TGTTACTGA.TTACGCTCG	TGTTACTGA.TTACGCTCG
TGTTGTCGA.AACGGAGAT	TGTTGTCGA.AACGGAGAT
TGTTGTCGA.CACGTAGAC	TGTTGTCGA.CACGTAGAC
TGTTGTCGA.CGACAGACC	TGTTGTCGA.CGACAGACC
TGTTGTCGA.TAATCACGC	TGTTGTCGA.TAATCACGC
TTAACGGAG.ACTGACTAC	TTAACGGAG.ACTGACTAC
TTAACGGAG.AGTCATACT	TTAACGGAG.AGTCATACT
TTAACGGAG.ATTGATCAC	TTAACGGAG.ATTGATCAC
TTAACGGAG.ATTGGTTCC	TTAACGGAG.ATTGGTTCC
TTAACGGAG.CAGCTCTTC	TTAACGGAG.CAGCTCTTC
TTAACGGAG.GTCTCCAGG	TTAACGGAG.GTCTCCAGG
TTAACGTTC.ACTGGACCA	TTAACGTTC.ACTGGACCA
TTAACGTTC.ATCAGTCGA	TTAACGTTC.ATCAGTCGA
TTAACGTTC.TGGAGAGTG	TTAACGTTC.TGGAGAGTG
TTAAGTGGT.ATCCGTCTC	TTAAGTGGT.ATCCGTCTC
TTAAGTGGT.CACTTCCTT	TTAAGTGGT.CACTTCCTT
TTAAGTGGT.GACGCCGTA	TTAAGTGGT.GACGCCGTA
TTAAGTGGT.TATGTATGC	TTAAGTGGT.TATGTATGC
TTACAGTGT.CCTATTCAA	TTACAGTGT.CCTATTCAA
TTACAGTGT.CTCCTGACG	TTACAGTGT.CTCCTGACG
TTACAGTGT.TCAGGACTG	TTACAGTGT.TCAGGACTG
TTACCTCTC.CTTACATGC	TTACCTCTC.CTTACATGC
TTACCTCTC.TAAGTGTAG	TTACCTCTC.TAAGTGTAG
TTACCTCTC.TTAGTCGGA	TTACCTCTC.TTAGTCGGA
TTACCTCTC.TTCTGGTGC	TTACCTCTC.TTCTGGTGC
TTACGCTCG.CAAGAGGAG	TTACGCTCG.CAAGAGGAG
TTACGCTCG.CACGTCATA	TTACGCTCG.CACGTCATA
TTACGGACC.AGTAACGTA	TTACGGACC.AGTAACGTA
TTACGGACC.CCTCCAATC	TTACGGACC.CCTCCAATC
TTACGGACC.TGCCACCGA	TTACGGACC.TGCCACCGA
TTACTAGTC.ACCGAGTAG	TTACTAGTC.ACCGAGTAG
TTACTAGTC.ATATAGCGT	TTACTAGTC.ATATAGCGT
TTACTAGTC.GACATATGT	TTACTAGTC.GACATATGT
TTACTAGTC.GATCTGTTC	TTACTAGTC.GATCTGTTC
TTACTAGTC.TGCGTCTTA	TTACTAGTC.TGCGTCTTA
TTACTTACG.ACCATTCAC	TTACTTACG.ACCATTCAC
TTACTTACG.GACGCCGTA	TTACTTACG.GACGCCGTA
TTACTTACG.GGTGTGACC	TTACTTACG.GGTGTGACC
TTACTTACG.TAGACCGCA	TTACTTACG.TAGACCGCA
TTACTTACG.TATCACCTG	TTACTTACG.TATCACCTG
TTAGATCGG.ACAGAAGAG	TTAGATCGG.ACAGAAGAG
TTAGATCGG.CCGCATCCT	TTAGATCGG.CCGCATCCT
TTAGCGTCT.ATACAACCG	TTAGCGTCT.ATACAACCG
TTAGCGTCT.CCTATTGGT	TTAGCGTCT.CCTATTGGT
TTAGCGTCT.CTCCGCATT	TTAGCGTCT.CTCCGCATT
TTAGGAAGG.CGACCTGTA	TTAGGAAGG.CGACCTGTA
TTAGGAAGG.TGACGGTTG	TTAGGAAGG.TGACGGTTG
TTAGTCGGA.ACCTCCTAG	TTAGTCGGA.ACCTCCTAG
TTAGTCGGA.ACTCGAGTC	TTAGTCGGA.ACTCGAGTC
TTAGTCGGA.GACGTAGCA	TTAGTCGGA.GACGTAGCA
TTAGTCGGA.GTACCACAA	TTAGTCGGA.GTACCACAA
TTAGTCGGA.GTCAATACA	TTAGTCGGA.GTCAATACA
TTATCCAAG.ACGTCTATG	TTATCCAAG.ACGTCTATG
TTATCCAAG.TAGCTGTTG	TTATCCAAG.TAGCTGTTG
TTATCGCAC.ACGGTGCCT	TTATCGCAC.ACGGTGCCT
TTATCGCAC.CTGAGGTTA	TTATCGCAC.CTGAGGTTA
TTATCGCAC.CTTGGATCA	TTATCGCAC.CTTGGATCA
TTATGAGGA.ATCTCTGCT	TTATGAGGA.ATCTCTGCT
TTATGAGGA.GAGGTCACG	TTATGAGGA.GAGGTCACG
TTATGAGGA.GGATTCGTC	TTATGAGGA.GGATTCGTC
TTATTCGAC.ACGATGACC	TTATTCGAC.ACGATGACC
TTATTCGAC.ACGCTAGTG	TTATTCGAC.ACGCTAGTG
TTATTCGAC.AGGAAGGTG	TTATTCGAC.AGGAAGGTG
TTATTCGAC.CGGAACGAG	TTATTCGAC.CGGAACGAG
TTATTCGAC.GCACATGTT	TTATTCGAC.GCACATGTT
TTCAACTAC.ACCTAGCAC	TTCAACTAC.ACCTAGCAC
TTCAACTAC.CATCTCGAT	TTCAACTAC.CATCTCGAT
TTCAACTAC.CCTCATAAC	TTCAACTAC.CCTCATAAC
TTCAACTAC.GCTCTGTGT	TTCAACTAC.GCTCTGTGT
TTCACCTTG.AACGCTCAA	TTCACCTTG.AACGCTCAA
TTCACCTTG.TATAATCGC	TTCACCTTG.TATAATCGC
TTCACCTTG.TTACCTCTC	TTCACCTTG.TTACCTCTC
TTCACTCCT.ACACACCGT	TTCACTCCT.ACACACCGT
TTCACTCCT.GCGATATGA	TTCACTCCT.GCGATATGA
TTCACTCCT.GTAACTCAT	TTCACTCCT.GTAACTCAT
TTCAGTGCC.CAGCTTACC	TTCAGTGCC.CAGCTTACC
TTCAGTGCC.CGACCATCA	TTCAGTGCC.CGACCATCA
TTCAGTGCC.GATTAGACA	TTCAGTGCC.GATTAGACA
TTCATCCAA.AAGCTTGCA	TTCATCCAA.AAGCTTGCA
TTCATCCAA.AAGGAAGTC	TTCATCCAA.AAGGAAGTC
TTCATCCAA.AGTCATACT	TTCATCCAA.AGTCATACT
TTCATCCAA.CTTAGAAGG	TTCATCCAA.CTTAGAAGG
TTCATCCAA.TGTCGTGAG	TTCATCCAA.TGTCGTGAG
TTCATCCAA.TTAACGGAG	TTCATCCAA.TTAACGGAG
TTCATTCGC.TCGCAAGCA	TTCATTCGC.TCGCAAGCA
TTCCAATTC.AAGTCATGA	TTCCAATTC.AAGTCATGA
TTCCAATTC.TAACACATC	TTCCAATTC.TAACACATC
TTCCAGATT.ATCCGTCTC	TTCCAGATT.ATCCGTCTC
TTCCAGATT.CAACGTCTT	TTCCAGATT.CAACGTCTT
TTCCAGATT.CCTTAACAT	TTCCAGATT.CCTTAACAT
TTCCAGATT.TACAACACC	TTCCAGATT.TACAACACC
TTCCAGGAG.AATCAGGAG	TTCCAGGAG.AATCAGGAG
TTCCAGGAG.ACAATTCGG	TTCCAGGAG.ACAATTCGG
TTCCAGGAG.AGGAGCAAT	TTCCAGGAG.AGGAGCAAT
TTCCAGGAG.CGCTGTAGT	TTCCAGGAG.CGCTGTAGT
TTCCAGGAG.TGCTCACAC	TTCCAGGAG.TGCTCACAC
TTCCATACC.ATCTAGGTT	TTCCATACC.ATCTAGGTT
TTCCATACC.CTTAGAAGG	TTCCATACC.CTTAGAAGG
TTCCATACC.GAGCACATT	TTCCATACC.GAGCACATT
TTCCATACC.GGATCGTTC	TTCCATACC.GGATCGTTC
TTCCGAGCG.AGTTGAGCG	TTCCGAGCG.AGTTGAGCG
TTCCGAGCG.TCTACGCAA	TTCCGAGCG.TCTACGCAA
TTCCGCCAG.ATACTTGCT	TTCCGCCAG.ATACTTGCT
TTCCGCCAG.CCTAGTCTC	TTCCGCCAG.CCTAGTCTC
TTCCGCCAG.GAGTCAAGG	TTCCGCCAG.GAGTCAAGG
TTCCGCCAG.TCTAATACC	TTCCGCCAG.TCTAATACC
TTCCTAAGG.ATGCCTTCA	TTCCTAAGG.ATGCCTTCA
TTCCTAAGG.GCTCCTAGC	TTCCTAAGG.GCTCCTAGC
TTCCTCGGT.AACGTTCTT	TTCCTCGGT.AACGTTCTT
TTCCTCGGT.ACGATGGAA	TTCCTCGGT.ACGATGGAA
TTCCTCGGT.ACTCATTCA	TTCCTCGGT.ACTCATTCA
TTCCTCGGT.CTGACGGAT	TTCCTCGGT.CTGACGGAT
TTCCTCGGT.TCTGTGAAG	TTCCTCGGT.TCTGTGAAG
TTCCTGCTA.AGTCCGTGT	TTCCTGCTA.AGTCCGTGT
TTCCTTGAC.AAGAGAACT	TTCCTTGAC.AAGAGAACT
TTCCTTGAC.CATCCGACA	TTCCTTGAC.CATCCGACA
TTCCTTGAC.GAATCACAT	TTCCTTGAC.GAATCACAT
TTCCTTGAC.TCATATCGC	TTCCTTGAC.TCATATCGC
TTCCTTGAC.TCTCGTATC	TTCCTTGAC.TCTCGTATC
TTCGCATCC.ATCAGAAGC	TTCGCATCC.ATCAGAAGC
TTCGCATCC.ATGGTTCGA	TTCGCATCC.ATGGTTCGA
TTCGCATCC.TTGGACTTC	TTCGCATCC.TTGGACTTC
TTCGCTGAG.AATACGTCT	TTCGCTGAG.AATACGTCT
TTCGCTGAG.AATTGGATC	TTCGCTGAG.AATTGGATC
TTCGCTGAG.ACGAGAGCA	TTCGCTGAG.ACGAGAGCA
TTCGCTGAG.CACTGGTCC	TTCGCTGAG.CACTGGTCC
TTCGCTGAG.CCATTACAG	TTCGCTGAG.CCATTACAG
TTCGCTGAG.GCCATCGCT	TTCGCTGAG.GCCATCGCT
TTCGCTGAG.TACCGCGTT	TTCGCTGAG.TACCGCGTT
TTCGGAGTC.TATAATCGC	TTCGGAGTC.TATAATCGC
TTCGTGATG.GATCTGAAT	TTCGTGATG.GATCTGAAT
TTCGTGATG.GGATAGTCA	TTCGTGATG.GGATAGTCA
TTCGTGATG.TGATTGCTG	TTCGTGATG.TGATTGCTG
TTCGTGATG.TGTATCGTG	TTCGTGATG.TGTATCGTG
TTCTCCACA.AATCGCCAT	TTCTCCACA.AATCGCCAT
TTCTCCACA.ACAAGGTAC	TTCTCCACA.ACAAGGTAC
TTCTCCACA.AGGTCCGTC	TTCTCCACA.AGGTCCGTC
TTCTCCACA.CCGTACGGA	TTCTCCACA.CCGTACGGA
TTCTGAATG.AAGTCATGA	TTCTGAATG.AAGTCATGA
TTCTGAATG.CCTGCGTTA	TTCTGAATG.CCTGCGTTA
TTCTGAATG.GCTGTTCGG	TTCTGAATG.GCTGTTCGG
TTCTGAATG.GTACGAACG	TTCTGAATG.GTACGAACG
TTCTGCCGA.AGTGAACGG	TTCTGCCGA.AGTGAACGG
TTCTGCCGA.ATCTTACAG	TTCTGCCGA.ATCTTACAG
TTCTGCCGA.CCGTCAGGT	TTCTGCCGA.CCGTCAGGT
TTCTGCCGA.CTGCAGAGC	TTCTGCCGA.CTGCAGAGC
TTCTGGTGC.AATCCTCGT	TTCTGGTGC.AATCCTCGT
TTCTGGTGC.AATGCTGAT	TTCTGGTGC.AATGCTGAT
TTCTGGTGC.ACGTGCTCG	TTCTGGTGC.ACGTGCTCG
TTCTGGTGC.ACTCTGCTC	TTCTGGTGC.ACTCTGCTC
TTCTGGTGC.CTCTTCAGC	TTCTGGTGC.CTCTTCAGC
TTCTGGTGC.GAGTCGTAC	TTCTGGTGC.GAGTCGTAC
TTCTGGTGC.TCGCTGATT	TTCTGGTGC.TCGCTGATT
TTGACCTGA.GTAGAGAGC	TTGACCTGA.GTAGAGAGC
TTGAGACGG.AACGGAGAT	TTGAGACGG.AACGGAGAT
TTGAGACGG.CTGGTAATC	TTGAGACGG.CTGGTAATC
TTGAGACGG.CTTGCGACC	TTGAGACGG.CTTGCGACC
TTGAGCTCT.TCTACGCAA	TTGAGCTCT.TCTACGCAA
TTGATCGTA.AAGACTGGT	TTGATCGTA.AAGACTGGT
TTGATCGTA.ACATGGATT	TTGATCGTA.ACATGGATT
TTGATCGTA.ATAGTCTCC	TTGATCGTA.ATAGTCTCC
TTGATCGTA.ATTAGCCAC	TTGATCGTA.ATTAGCCAC
TTGATGAGT.AGCCACTTC	TTGATGAGT.AGCCACTTC
TTGATGAGT.CGCAATCGA	TTGATGAGT.CGCAATCGA
TTGATGAGT.GAGACGATC	TTGATGAGT.GAGACGATC
TTGATGAGT.TAGTAGTCT	TTGATGAGT.TAGTAGTCT
TTGATGCTG.CGTTCCATT	TTGATGCTG.CGTTCCATT
TTGCAGTCA.GGAACCTAG	TTGCAGTCA.GGAACCTAG
TTGCAGTCA.TACTTCCAG	TTGCAGTCA.TACTTCCAG
TTGCAGTCA.TATCTGTCA	TTGCAGTCA.TATCTGTCA
TTGCAGTCA.TGTGCCATG	TTGCAGTCA.TGTGCCATG
TTGCCAGAT.ACTTAGCTT	TTGCCAGAT.ACTTAGCTT
TTGCCAGAT.AGACATCCA	TTGCCAGAT.AGACATCCA
TTGCCAGAT.AGACTAGTA	TTGCCAGAT.AGACTAGTA
TTGCCAGAT.GCAATGAGA	TTGCCAGAT.GCAATGAGA
TTGCCGTAG.CACGACTCA	TTGCCGTAG.CACGACTCA
TTGCCGTAG.CACGATAGA	TTGCCGTAG.CACGATAGA
TTGCCGTAG.GACGCCGTA	TTGCCGTAG.GACGCCGTA
TTGCCGTAG.GCTTGGTTC	TTGCCGTAG.GCTTGGTTC
TTGCGAACA.ACCTAGCAC	TTGCGAACA.ACCTAGCAC
TTGCGAACA.ATCATAGAC	TTGCGAACA.ATCATAGAC
TTGCGAACA.CCGAATATG	TTGCGAACA.CCGAATATG
TTGCGAACA.CTTCTGAGT	TTGCGAACA.CTTCTGAGT
TTGCGAACA.GAGCCGTTA	TTGCGAACA.GAGCCGTTA
TTGCGAACA.GGATTACGC	TTGCGAACA.GGATTACGC
TTGCTCTGC.AAGAGAGAG	TTGCTCTGC.AAGAGAGAG
TTGCTCTGC.AGCATTCCA	TTGCTCTGC.AGCATTCCA
TTGCTCTGC.CAACCTGGT	TTGCTCTGC.CAACCTGGT
TTGCTCTGC.TATTACAGC	TTGCTCTGC.TATTACAGC
TTGGACTTC.CAAGCCTCG	TTGGACTTC.CAAGCCTCG
TTGGACTTC.CATGTCCTG	TTGGACTTC.CATGTCCTG
TTGGACTTC.GATTGAGTA	TTGGACTTC.GATTGAGTA
TTGGACTTC.TGGTTATAC	TTGGACTTC.TGGTTATAC
TTGGAGAAC.CGATTCGAG	TTGGAGAAC.CGATTCGAG
TTGGAGAAC.CTCTGCGGT	TTGGAGAAC.CTCTGCGGT
TTGGAGAAC.GAGGACTTA	TTGGAGAAC.GAGGACTTA
TTGGTAACT.ACTAACCGA	TTGGTAACT.ACTAACCGA
TTGGTAACT.ATTATGCAG	TTGGTAACT.ATTATGCAG
TTGGTAACT.CAATCTCCG	TTGGTAACT.CAATCTCCG
TTGGTAACT.TCTGTGAAG	TTGGTAACT.TCTGTGAAG
TTGTAATGC.ATGACACAA	TTGTAATGC.ATGACACAA
TTGTAATGC.ATTCGCTTA	TTGTAATGC.ATTCGCTTA
TTGTAATGC.CACGGAAGT	TTGTAATGC.CACGGAAGT
TTGTAATGC.CGAAGAGGT	TTGTAATGC.CGAAGAGGT
