GCTCAATGA.GTGCTAAGC	GCTCAATGA.GTGCTAAGC
GCTCAGCCA.ACAATAGGT	GCTCAGCCA.ACAATAGGT
GCTCAGCCA.ACGCAAGAT	GCTCAGCCA.ACGCAAGAT
GCTCAGCCA.AGGAGGTGA	GCTCAGCCA.AGGAGGTGA
GCTCAGCCA.ATTAGCGGT	GCTCAGCCA.ATTAGCGGT
GCTCAGCCA.GTAGAGAGC	GCTCAGCCA.GTAGAGAGC
GCTCAGCCA.TCTGTGAAG	GCTCAGCCA.TCTGTGAAG
GCTCCTAGC.CCAACAACA	GCTCCTAGC.CCAACAACA
GCTCCTAGC.CCAATGCCT	GCTCCTAGC.CCAATGCCT
GCTCCTAGC.GCAACACCT	GCTCCTAGC.GCAACACCT
GCTCCTAGC.GTAACCATA	GCTCCTAGC.GTAACCATA
GCTCCTAGC.TACCATGTA	GCTCCTAGC.TACCATGTA
GCTCCTAGC.TGATGACAG	GCTCCTAGC.TGATGACAG
GCTCTCCAA.AGTTACAAG	GCTCTCCAA.AGTTACAAG
GCTCTCCAA.GCTAGTGGA	GCTCTCCAA.GCTAGTGGA
GCTCTGTGT.AAGCTTGCA	GCTCTGTGT.AAGCTTGCA
GCTGACAGA.CTGCGATTC	GCTGACAGA.CTGCGATTC
GCTGACAGA.GTCCGCTCA	GCTGACAGA.GTCCGCTCA
GCTGACAGA.TAGCACTAT	GCTGACAGA.TAGCACTAT
GCTGACAGA.TCTCAGGAT	GCTGACAGA.TCTCAGGAT
GCTGAGCAG.ACGCTCTTA	GCTGAGCAG.ACGCTCTTA
GCTGATGTC.AATTGGATC	GCTGATGTC.AATTGGATC
GCTGATGTC.ATTCCGTAC	GCTGATGTC.ATTCCGTAC
GCTGATGTC.CACCTAGCG	GCTGATGTC.CACCTAGCG
GCTGATGTC.CGACCACTT	GCTGATGTC.CGACCACTT
GCTGATGTC.GGTCGGTCT	GCTGATGTC.GGTCGGTCT
GCTGATGTC.TATAGTGCG	GCTGATGTC.TATAGTGCG
GCTGGTAAC.AAGCTTGCA	GCTGGTAAC.AAGCTTGCA
GCTGGTAAC.ATATTCGCA	GCTGGTAAC.ATATTCGCA
GCTGGTAAC.GATTCCTCT	GCTGGTAAC.GATTCCTCT
GCTGGTAAC.GTAATATCG	GCTGGTAAC.GTAATATCG
GCTGGTAAC.TGATAGAGG	GCTGGTAAC.TGATAGAGG
GCTGGTTCG.ACTCTCACA	GCTGGTTCG.ACTCTCACA
GCTGGTTCG.CTACTGTCA	GCTGGTTCG.CTACTGTCA
GCTGTTCGG.ATGAGGTAT	GCTGTTCGG.ATGAGGTAT
GCTGTTCGG.GAATCACAT	GCTGTTCGG.GAATCACAT
GCTGTTCGG.GGTGATAGG	GCTGTTCGG.GGTGATAGG
GCTTACGTT.AAGGTCTGA	GCTTACGTT.AAGGTCTGA
GCTTACTAG.AGTATGACG	GCTTACTAG.AGTATGACG
GCTTACTAG.CAACACTCC	GCTTACTAG.CAACACTCC
GCTTACTAG.CGGTGAGTC	GCTTACTAG.CGGTGAGTC
GCTTACTAG.GAGCAGGAA	GCTTACTAG.GAGCAGGAA
GCTTACTAG.GGTAAGGAT	GCTTACTAG.GGTAAGGAT
GCTTAGAAC.ATCTACATC	GCTTAGAAC.ATCTACATC
GCTTCACTC.CACGCGTAA	GCTTCACTC.CACGCGTAA
GCTTCTACG.GCACCATCG	GCTTCTACG.GCACCATCG
GCTTCTACG.GCGGAGATT	GCTTCTACG.GCGGAGATT
GCTTCTACG.TGCTCACAC	GCTTCTACG.TGCTCACAC
GCTTCTGAA.ACAAGAATG	GCTTCTGAA.ACAAGAATG
GCTTCTGAA.ACGCGTGAC	GCTTCTGAA.ACGCGTGAC
GCTTCTGAA.CACTGCTTA	GCTTCTGAA.CACTGCTTA
GCTTCTGAA.GAGCACATT	GCTTCTGAA.GAGCACATT
GCTTCTGAA.GGTCCTGGT	GCTTCTGAA.GGTCCTGGT
GCTTCTGAA.TGCAGATGC	GCTTCTGAA.TGCAGATGC
GCTTGGTTC.ACCGAGTAG	GCTTGGTTC.ACCGAGTAG
GCTTGGTTC.AGCTTGGTG	GCTTGGTTC.AGCTTGGTG
GCTTGGTTC.ATATAGCGT	GCTTGGTTC.ATATAGCGT
GCTTGGTTC.CCGACTGTT	GCTTGGTTC.CCGACTGTT
GCTTGGTTC.GTCAGCGTC	GCTTGGTTC.GTCAGCGTC
GCTTGGTTC.GTCTACCAA	GCTTGGTTC.GTCTACCAA
GCTTGGTTC.GTGATGTGC	GCTTGGTTC.GTGATGTGC
GCTTGGTTC.TGCGTCTTA	GCTTGGTTC.TGCGTCTTA
GCTTGTCCT.AATTAGAGG	GCTTGTCCT.AATTAGAGG
GCTTGTCCT.AGATGAGAT	GCTTGTCCT.AGATGAGAT
GCTTGTCCT.TCGTGCCAC	GCTTGTCCT.TCGTGCCAC
GGAACCTAG.ATAGACCGA	GGAACCTAG.ATAGACCGA
GGAACCTAG.CGCCATTAC	GGAACCTAG.CGCCATTAC
GGAACCTAG.GGACTATTC	GGAACCTAG.GGACTATTC
GGAACCTAG.TACTCGACC	GGAACCTAG.TACTCGACC
GGAACCTAG.TAGCACTAT	GGAACCTAG.TAGCACTAT
GGAACCTAG.TAGTAACGG	GGAACCTAG.TAGTAACGG
GGAACTGCT.CGTGAGACT	GGAACTGCT.CGTGAGACT
GGAACTGCT.CTCAGCTGG	GGAACTGCT.CTCAGCTGG
GGAACTGCT.GAATCACAT	GGAACTGCT.GAATCACAT
GGAACTGCT.GAGCATACA	GGAACTGCT.GAGCATACA
GGAACTGCT.GATACTGTG	GGAACTGCT.GATACTGTG
GGAACTGCT.GTAGACTCT	GGAACTGCT.GTAGACTCT
GGAAGAAGC.ATCGTAGTG	GGAAGAAGC.ATCGTAGTG
GGAAGAAGC.GAGTTAACT	GGAAGAAGC.GAGTTAACT
GGAAGAAGC.TGCAGCCTT	GGAAGAAGC.TGCAGCCTT
GGAAGGTAT.ACGAATCGC	GGAAGGTAT.ACGAATCGC
GGAAGGTAT.AGACGCCTG	GGAAGGTAT.AGACGCCTG
GGAAGGTAT.CCTGTCATT	GGAAGGTAT.CCTGTCATT
GGAAGGTAT.CTGACAGCA	GGAAGGTAT.CTGACAGCA
GGAAGGTAT.TAGCTGTTG	GGAAGGTAT.TAGCTGTTG
GGAAGGTAT.TTACCTCTC	GGAAGGTAT.TTACCTCTC
GGAAGGTAT.TTACTAGTC	GGAAGGTAT.TTACTAGTC
GGAAGTATG.AGGAAGGTG	GGAAGTATG.AGGAAGGTG
GGAAGTATG.CGCAACCTC	GGAAGTATG.CGCAACCTC
GGAAGTATG.CTATTCCGT	GGAAGTATG.CTATTCCGT
GGAAGTATG.GACTCAGTG	GGAAGTATG.GACTCAGTG
GGAAGTATG.GACTTGATT	GGAAGTATG.GACTTGATT
GGAAGTATG.TAACACATC	GGAAGTATG.TAACACATC
GGAAGTATG.TATCACCTG	GGAAGTATG.TATCACCTG
GGAATTCAC.CTCGAACTG	GGAATTCAC.CTCGAACTG
GGAATTCAC.TTCAGTGCC	GGAATTCAC.TTCAGTGCC
GGAATTGGA.TCGATTCAG	GGAATTGGA.TCGATTCAG
GGACACTGG.AATGCAGCG	GGACACTGG.AATGCAGCG
GGACACTGG.CCGTCAGGT	GGACACTGG.CCGTCAGGT
GGACACTGG.GACTCTGGT	GGACACTGG.GACTCTGGT
GGACACTGG.GAGTGCATA	GGACACTGG.GAGTGCATA
GGACACTGG.GGAACTGCT	GGACACTGG.GGAACTGCT
GGACAGATT.ACAGAAGAG	GGACAGATT.ACAGAAGAG
GGACAGATT.ACGTATGTC	GGACAGATT.ACGTATGTC
GGACAGATT.CACGTAGAC	GGACAGATT.CACGTAGAC
GGACAGATT.CCAGCCAAT	GGACAGATT.CCAGCCAAT
GGACAGATT.GCATGTGGT	GGACAGATT.GCATGTGGT
GGACAGATT.GTACGAACG	GGACAGATT.GTACGAACG
GGACGAGCA.AGTCGTCCG	GGACGAGCA.AGTCGTCCG
GGACGAGCA.CATGGTTAC	GGACGAGCA.CATGGTTAC
GGACGAGCA.GACCACTCG	GGACGAGCA.GACCACTCG
GGACGAGCA.GCAGCTTGA	GGACGAGCA.GCAGCTTGA
GGACGAGCA.GTCGTTAGA	GGACGAGCA.GTCGTTAGA
GGACGAGCA.TGCCTGGTT	GGACGAGCA.TGCCTGGTT
GGACTATTC.CTCGACGAT	GGACTATTC.CTCGACGAT
GGACTATTC.GGTCGGATA	GGACTATTC.GGTCGGATA
GGACTATTC.TAGGTCAAC	GGACTATTC.TAGGTCAAC
GGACTATTC.TCCTTCAAC	GGACTATTC.TCCTTCAAC
GGACTCCTT.CCAGTTACG	GGACTCCTT.CCAGTTACG
GGACTCCTT.CCGGTTGAG	GGACTCCTT.CCGGTTGAG
GGAGACACA.CTAACACTG	GGAGACACA.CTAACACTG
GGAGACACA.GAATCAACC	GGAGACACA.GAATCAACC
GGAGACACA.GTGCGTTCC	GGAGACACA.GTGCGTTCC
GGAGACACA.TACCTATCC	GGAGACACA.TACCTATCC
GGAGATGAG.CATATGTCG	GGAGATGAG.CATATGTCG
GGAGCATCT.AGCCACTTC	GGAGCATCT.AGCCACTTC
GGAGCATCT.AGGTCAGCA	GGAGCATCT.AGGTCAGCA
GGAGCATCT.CCTTCCTCA	GGAGCATCT.CCTTCCTCA
GGAGCATCT.GCGGTAAGT	GGAGCATCT.GCGGTAAGT
GGAGCATCT.TGCAACTCT	GGAGCATCT.TGCAACTCT
GGAGCATCT.TGCATACAT	GGAGCATCT.TGCATACAT
GGAGCTCAA.AGCAAGTCC	GGAGCTCAA.AGCAAGTCC
GGAGCTCAA.ATAGTCAGT	GGAGCTCAA.ATAGTCAGT
GGAGCTCAA.CTAACACTG	GGAGCTCAA.CTAACACTG
GGAGCTCAA.TCAATCTAG	GGAGCTCAA.TCAATCTAG
GGAGTACAG.CATCGAAGC	GGAGTACAG.CATCGAAGC
GGAGTACAG.GCCAACAAT	GGAGTACAG.GCCAACAAT
GGAGTACAG.TGACAAGTT	GGAGTACAG.TGACAAGTT
GGAGTTAGC.AGGATCTCA	GGAGTTAGC.AGGATCTCA
GGAGTTAGC.ATGAGCAGG	GGAGTTAGC.ATGAGCAGG
GGAGTTAGC.TCTATTAGG	GGAGTTAGC.TCTATTAGG
GGAGTTAGC.TGTACACGA	GGAGTTAGC.TGTACACGA
GGATAATAC.ACAGCATCA	GGATAATAC.ACAGCATCA
GGATAATAC.ACCACTAGG	GGATAATAC.ACCACTAGG
GGATAATAC.CATAGGTGT	GGATAATAC.CATAGGTGT
GGATAATAC.CGACCTAGC	GGATAATAC.CGACCTAGC
GGATAATAC.TGTCGTACA	GGATAATAC.TGTCGTACA
GGATACAAT.ACTCCGTCG	GGATACAAT.ACTCCGTCG
GGATACAAT.GCTGGTAAC	GGATACAAT.GCTGGTAAC
GGATACAAT.TGAGAGGAC	GGATACAAT.TGAGAGGAC
GGATACCTA.AGGTGTACA	GGATACCTA.AGGTGTACA
GGATACCTA.ATCAAGAGA	GGATACCTA.ATCAAGAGA
GGATACCTA.CAATCAAGT	GGATACCTA.CAATCAAGT
GGATACCTA.CACCTCAAC	GGATACCTA.CACCTCAAC
GGATACCTA.GAGCAGGAA	GGATACCTA.GAGCAGGAA
GGATACCTA.GAGCGACTC	GGATACCTA.GAGCGACTC
GGATACCTA.GTCTGACGT	GGATACCTA.GTCTGACGT
GGATAGTCA.CAGTAATGT	GGATAGTCA.CAGTAATGT
GGATAGTCA.CGGACAAGT	GGATAGTCA.CGGACAAGT
GGATAGTCA.CTGACGGAT	GGATAGTCA.CTGACGGAT
GGATAGTCA.GTGAGGACG	GGATAGTCA.GTGAGGACG
GGATCAATG.AGACGCTAT	GGATCAATG.AGACGCTAT
GGATCAATG.GGTGAGCGT	GGATCAATG.GGTGAGCGT
GGATCAGGT.ACAGCGGTC	GGATCAGGT.ACAGCGGTC
GGATCAGGT.AGTCGATCA	GGATCAGGT.AGTCGATCA
GGATCAGGT.CGAGTAGCA	GGATCAGGT.CGAGTAGCA
GGATCAGGT.CGTACATCT	GGATCAGGT.CGTACATCT
GGATCAGGT.TGCCTGGTT	GGATCAGGT.TGCCTGGTT
GGATCGTTC.CGGTTGCGA	GGATCGTTC.CGGTTGCGA
GGATCGTTC.GAATAAGAG	GGATCGTTC.GAATAAGAG
GGATCGTTC.GATGCAGAA	GGATCGTTC.GATGCAGAA
GGATCGTTC.TCACGCGAC	GGATCGTTC.TCACGCGAC
GGATGCGAA.ATTAGCACA	GGATGCGAA.ATTAGCACA
GGATGCGAA.CCTTAATTC	GGATGCGAA.CCTTAATTC
GGATGCGAA.CCTTGTTGC	GGATGCGAA.CCTTGTTGC
GGATGCGAA.GAGTCTTCG	GGATGCGAA.GAGTCTTCG
GGATGCGAA.GCTGATGTC	GGATGCGAA.GCTGATGTC
GGATGCGAA.GCTTACGTT	GGATGCGAA.GCTTACGTT
GGATGCGAA.TAGCAGAGT	GGATGCGAA.TAGCAGAGT
GGATGCTCG.CTTAAGTTG	GGATGCTCG.CTTAAGTTG
GGATGCTCG.GTAGCATAC	GGATGCTCG.GTAGCATAC
GGATTACGC.AACGGTAGC	GGATTACGC.AACGGTAGC
GGATTACGC.ACTTCGCAG	GGATTACGC.ACTTCGCAG
GGATTCGTC.AACAACTGG	GGATTCGTC.AACAACTGG
GGATTCGTC.ACACCACAT	GGATTCGTC.ACACCACAT
GGATTCGTC.AGGTGCGAG	GGATTCGTC.AGGTGCGAG
GGATTCGTC.GGTAGACAT	GGATTCGTC.GGTAGACAT
GGATTCGTC.GTGTCCGTG	GGATTCGTC.GTGTCCGTG
GGATTCGTC.TCCTGTGGA	GGATTCGTC.TCCTGTGGA
GGATTCGTC.TGTGCTAAC	GGATTCGTC.TGTGCTAAC
GGATTCGTC.TTATCGCAC	GGATTCGTC.TTATCGCAC
GGTAACTAC.CAATTGTCT	GGTAACTAC.CAATTGTCT
GGTAACTAC.CAGCGACGT	GGTAACTAC.CAGCGACGT
GGTAACTAC.TCTAGCTGG	GGTAACTAC.TCTAGCTGG
GGTAAGGAT.AAGAGAGAG	GGTAAGGAT.AAGAGAGAG
GGTAAGGAT.CAAGCGCAT	GGTAAGGAT.CAAGCGCAT
GGTAAGGAT.CCTATTGGT	GGTAAGGAT.CCTATTGGT
GGTAAGGAT.GCTAGCTCC	GGTAAGGAT.GCTAGCTCC
GGTAAGGAT.GTAAGGTCC	GGTAAGGAT.GTAAGGTCC
GGTAAGGAT.TATCGGAAC	GGTAAGGAT.TATCGGAAC
GGTAAGGAT.TTCCAATTC	GGTAAGGAT.TTCCAATTC
GGTAAGTGA.ACCGTACGC	GGTAAGTGA.ACCGTACGC
GGTAAGTGA.ATAGACCGA	GGTAAGTGA.ATAGACCGA
GGTAAGTGA.ATAGCCTAA	GGTAAGTGA.ATAGCCTAA
GGTAAGTGA.GCCATCGCT	GGTAAGTGA.GCCATCGCT
GGTAAGTGA.GTTATCGAT	GGTAAGTGA.GTTATCGAT
GGTAAGTGA.TAACGGATA	GGTAAGTGA.TAACGGATA
GGTAAGTGA.TAGGATTAG	GGTAAGTGA.TAGGATTAG
GGTACGAGC.GCTTGGTTC	GGTACGAGC.GCTTGGTTC
GGTACGAGC.TCAAGCGTA	GGTACGAGC.TCAAGCGTA
GGTACGAGC.TCAGGTGCA	GGTACGAGC.TCAGGTGCA
GGTACGAGC.TCCAAGTAA	GGTACGAGC.TCCAAGTAA
GGTACGAGC.TCGCTTAAC	GGTACGAGC.TCGCTTAAC
GGTACTTCC.ACAGTATTG	GGTACTTCC.ACAGTATTG
GGTACTTCC.ACTCACGAA	GGTACTTCC.ACTCACGAA
GGTACTTCC.AGATGAGAT	GGTACTTCC.AGATGAGAT
GGTACTTCC.AGGAAGGTG	GGTACTTCC.AGGAAGGTG
GGTACTTCC.ATGATAGCT	GGTACTTCC.ATGATAGCT
GGTAGACAT.GCCACATGG	GGTAGACAT.GCCACATGG
GGTAGACAT.TCGACGTTG	GGTAGACAT.TCGACGTTG
GGTAGCATC.CAAGTACGA	GGTAGCATC.CAAGTACGA
GGTAGCATC.CTATAGCTC	GGTAGCATC.CTATAGCTC
GGTAGCATC.CTTCTATGA	GGTAGCATC.CTTCTATGA
GGTAGCATC.TAAGGTCCG	GGTAGCATC.TAAGGTCCG
GGTAGTGTT.AAGCACAAC	GGTAGTGTT.AAGCACAAC
GGTAGTGTT.AAGTTGCCA	GGTAGTGTT.AAGTTGCCA
GGTAGTGTT.TATTACAGC	GGTAGTGTT.TATTACAGC
GGTCCTAAG.TCGTGACGT	GGTCCTAAG.TCGTGACGT
GGTCCTAAG.TTCTGGTGC	GGTCCTAAG.TTCTGGTGC
GGTCCTGGT.ACCTGTACC	GGTCCTGGT.ACCTGTACC
GGTCCTGGT.CACATATCA	GGTCCTGGT.CACATATCA
GGTCCTGGT.CGTGCAAGG	GGTCCTGGT.CGTGCAAGG
GGTCCTGGT.GCTTAGAAC	GGTCCTGGT.GCTTAGAAC
GGTCCTGGT.TACAACACC	GGTCCTGGT.TACAACACC
GGTCGGTCT.AATGCGTGC	GGTCGGTCT.AATGCGTGC
GGTCGGTCT.ATATCCGAT	GGTCGGTCT.ATATCCGAT
GGTCGGTCT.ATGAGATCC	GGTCGGTCT.ATGAGATCC
GGTCGGTCT.CAGCTAGTT	GGTCGGTCT.CAGCTAGTT
GGTCGGTCT.CGCCATTAC	GGTCGGTCT.CGCCATTAC
GGTCGGTCT.GCAGGAGAA	GGTCGGTCT.GCAGGAGAA
GGTCTCATG.AAGGTGCTG	GGTCTCATG.AAGGTGCTG
GGTCTCATG.GACTGCGCA	GGTCTCATG.GACTGCGCA
GGTCTCATG.GTGTCGAGC	GGTCTCATG.GTGTCGAGC
GGTCTCATG.TATGTACCT	GGTCTCATG.TATGTACCT
GGTCTTGCA.GCCGTGAAC	GGTCTTGCA.GCCGTGAAC
GGTCTTGCA.GCGGTAAGT	GGTCTTGCA.GCGGTAAGT
GGTGAGCGT.CTTGGATCA	GGTGAGCGT.CTTGGATCA
GGTGAGCGT.TACAGTTAG	GGTGAGCGT.TACAGTTAG
GGTGAGTTC.ACGTCTATG	GGTGAGTTC.ACGTCTATG
GGTGAGTTC.GGTGCGTAG	GGTGAGTTC.GGTGCGTAG
GGTGAGTTC.TATGTACCT	GGTGAGTTC.TATGTACCT
GGTGAGTTC.TTCATTCGC	GGTGAGTTC.TTCATTCGC
GGTGATAGG.CATAGAGAT	GGTGATAGG.CATAGAGAT
GGTGATAGG.CGTGTATTC	GGTGATAGG.CGTGTATTC
GGTGCGTAG.ACCATCTAA	GGTGCGTAG.ACCATCTAA
GGTGCGTAG.CATGTCCTG	GGTGCGTAG.CATGTCCTG
GGTGCGTAG.CGGACAAGT	GGTGCGTAG.CGGACAAGT
GGTGCGTAG.GACGCCGTA	GGTGCGTAG.GACGCCGTA
GGTGGAGCT.ACTCTGCTC	GGTGGAGCT.ACTCTGCTC
GGTGGAGCT.CATCGCTGG	GGTGGAGCT.CATCGCTGG
GGTGGAGCT.CGCAGTGTC	GGTGGAGCT.CGCAGTGTC
GGTGGAGCT.GAGCATACA	GGTGGAGCT.GAGCATACA
GGTGTGACC.AGCGACACC	GGTGTGACC.AGCGACACC
GGTGTGACC.ATGAACTAG	GGTGTGACC.ATGAACTAG
GGTGTGACC.CGCGTACTA	GGTGTGACC.CGCGTACTA
GGTGTGACC.CTTCGACTG	GGTGTGACC.CTTCGACTG
GGTGTGACC.GCAGCTCTT	GGTGTGACC.GCAGCTCTT
GGTGTGACC.TTAGATCGG	GGTGTGACC.TTAGATCGG
GGTGTTCAT.AGTTAGGTC	GGTGTTCAT.AGTTAGGTC
GGTGTTCAT.GAGCAGGAA	GGTGTTCAT.GAGCAGGAA
GGTGTTCAT.TGAGTTAAG	GGTGTTCAT.TGAGTTAAG
GGTGTTCAT.TGCTTACGG	GGTGTTCAT.TGCTTACGG
GGTTAACAG.ACGCTCTTA	GGTTAACAG.ACGCTCTTA
GGTTAACAG.AGCGTAGAA	GGTTAACAG.AGCGTAGAA
GGTTAACAG.GTCACAGAG	GGTTAACAG.GTCACAGAG
GGTTAACAG.GTCCTAGTT	GGTTAACAG.GTCCTAGTT
GGTTAACAG.TAGGTTAGT	GGTTAACAG.TAGGTTAGT
GGTTAACAG.TATCGGAAC	GGTTAACAG.TATCGGAAC
GGTTACGCA.AAGGTCTGA	GGTTACGCA.AAGGTCTGA
GGTTACGCA.ACGACAGTC	GGTTACGCA.ACGACAGTC
GGTTACGCA.ATTCGAAGA	GGTTACGCA.ATTCGAAGA
GGTTACGCA.CCAGCCAAT	GGTTACGCA.CCAGCCAAT
GGTTACGCA.TCATCTGTC	GGTTACGCA.TCATCTGTC
GGTTAGATG.CTGCTTAGG	GGTTAGATG.CTGCTTAGG
GGTTAGATG.GCCTGCATC	GGTTAGATG.GCCTGCATC
GGTTCAGAC.ACAACCGGA	GGTTCAGAC.ACAACCGGA
GGTTCAGAC.ACGCTATGT	GGTTCAGAC.ACGCTATGT
GGTTCAGAC.CACCTCGGA	GGTTCAGAC.CACCTCGGA
GGTTCAGAC.CACGACTCA	GGTTCAGAC.CACGACTCA
GGTTCAGAC.GGTACGAGC	GGTTCAGAC.GGTACGAGC
GGTTCAGAC.GTCGACATT	GGTTCAGAC.GTCGACATT
GGTTCAGAC.TAGCACTAT	GGTTCAGAC.TAGCACTAT
GGTTCGCAA.ACCATTCAC	GGTTCGCAA.ACCATTCAC
GGTTCGCAA.ATAGCACGG	GGTTCGCAA.ATAGCACGG
GGTTCGCAA.GATAACGTC	GGTTCGCAA.GATAACGTC
GGTTCGCAA.TTACTAGTC	GGTTCGCAA.TTACTAGTC
GGTTCTATC.AGTACTCTC	GGTTCTATC.AGTACTCTC
GGTTCTATC.ATTGCCGAC	GGTTCTATC.ATTGCCGAC
GGTTCTATC.TGTAGGTTA	GGTTCTATC.TGTAGGTTA
GGTTGAAGG.AACGTTCTT	GGTTGAAGG.AACGTTCTT
GGTTGAAGG.AGCTGCACT	GGTTGAAGG.AGCTGCACT
GGTTGAAGG.GAATAAGAG	GGTTGAAGG.GAATAAGAG
GGTTGCTAT.CATTCCGAG	GGTTGCTAT.CATTCCGAG
GGTTGCTAT.CTCCACGTC	GGTTGCTAT.CTCCACGTC
GGTTGCTAT.GCCGTGAAC	GGTTGCTAT.GCCGTGAAC
GGTTGCTAT.GTCAGTTGT	GGTTGCTAT.GTCAGTTGT
GGTTGCTAT.TATCGAGCC	GGTTGCTAT.TATCGAGCC
GTAACAGTC.ACTCTAGGA	GTAACAGTC.ACTCTAGGA
GTAACAGTC.ATTCTCTGG	GTAACAGTC.ATTCTCTGG
GTAACAGTC.CGTGAGACT	GTAACAGTC.CGTGAGACT
GTAACAGTC.GTGTCACAC	GTAACAGTC.GTGTCACAC
GTAACCATA.AGTTGCCTT	GTAACCATA.AGTTGCCTT
GTAACCATA.CATGACGTT	GTAACCATA.CATGACGTT
GTAACCATA.CCAGTTACG	GTAACCATA.CCAGTTACG
GTAACCATA.CGACCTGTA	GTAACCATA.CGACCTGTA
GTAACCATA.GGTCGGATA	GTAACCATA.GGTCGGATA
GTAACCATA.TCCTCTAGT	GTAACCATA.TCCTCTAGT
GTAACGCGA.CAGTACATC	GTAACGCGA.CAGTACATC
GTAACGCGA.CGCACTGAA	GTAACGCGA.CGCACTGAA
GTAACGCGA.GTCTCTTCA	GTAACGCGA.GTCTCTTCA
GTAACGCGA.GTTCCAACA	GTAACGCGA.GTTCCAACA
GTAACGCGA.TCTGCGCTG	GTAACGCGA.TCTGCGCTG
GTAACGCGA.TTATCGCAC	GTAACGCGA.TTATCGCAC
GTAACTCAT.ACCTAGTTA	GTAACTCAT.ACCTAGTTA
GTAAGGTCC.AACTGCGAC	GTAAGGTCC.AACTGCGAC
GTAAGGTCC.ACGAATCGC	GTAAGGTCC.ACGAATCGC
GTAAGGTCC.AGCAACATT	GTAAGGTCC.AGCAACATT
GTAAGGTCC.ATTGATTGG	GTAAGGTCC.ATTGATTGG
GTAAGGTCC.CCACGAAGG	GTAAGGTCC.CCACGAAGG
GTAAGGTCC.CCGCAATGG	GTAAGGTCC.CCGCAATGG
GTAAGGTCC.CGTGAGACT	GTAAGGTCC.CGTGAGACT
GTAAGGTCC.GCGAAGCTC	GTAAGGTCC.GCGAAGCTC
GTAAGTGAG.ACTGACTAC	GTAAGTGAG.ACTGACTAC
GTAAGTGAG.CTCCACGTC	GTAAGTGAG.CTCCACGTC
GTAAGTGAG.GCCTTGTGA	GTAAGTGAG.GCCTTGTGA
GTAAGTGAG.TGCTATGAA	GTAAGTGAG.TGCTATGAA
GTAATATCG.CCTTCCTCA	GTAATATCG.CCTTCCTCA
GTAATATCG.CTGCGATTC	GTAATATCG.CTGCGATTC
GTAATCAGC.ATATGTCCA	GTAATCAGC.ATATGTCCA
GTAATCAGC.GCGTATAGG	GTAATCAGC.GCGTATAGG
GTAATCAGC.GTAACGCGA	GTAATCAGC.GTAACGCGA
GTACAATGC.ACAGAAGAG	GTACAATGC.ACAGAAGAG
GTACAATGC.ATCATAGAC	GTACAATGC.ATCATAGAC
GTACAATGC.TAGCGCAGC	GTACAATGC.TAGCGCAGC
GTACAATGC.TGCCATCTC	GTACAATGC.TGCCATCTC
GTACCACAA.AATCCTCGT	GTACCACAA.AATCCTCGT
GTACCACAA.ACAGCGGTC	GTACCACAA.ACAGCGGTC
GTACCACAA.CAGGATCAA	GTACCACAA.CAGGATCAA
GTACCACAA.GTCGAGTAC	GTACCACAA.GTCGAGTAC
GTACCACAA.GTTACTACT	GTACCACAA.GTTACTACT
GTACCACAA.TACCATGTA	GTACCACAA.TACCATGTA
GTACCTAAC.ACGCTAGTG	GTACCTAAC.ACGCTAGTG
GTACCTAAC.AGCTATATG	GTACCTAAC.AGCTATATG
GTACCTAAC.ATCATTACG	GTACCTAAC.ATCATTACG
GTACCTAAC.ATCGTAGTG	GTACCTAAC.ATCGTAGTG
GTACGAACG.GACGCCGTA	GTACGAACG.GACGCCGTA
GTACGCGAT.AATGCTATC	GTACGCGAT.AATGCTATC
GTACGCGAT.GAACGCTGT	GTACGCGAT.GAACGCTGT
GTACGCGAT.GGAACCTAG	GTACGCGAT.GGAACCTAG
GTACGCGAT.TGCCGACTA	GTACGCGAT.TGCCGACTA
GTACGTCTA.AAGTTGCCA	GTACGTCTA.AAGTTGCCA
GTACGTCTA.ATTGATTGG	GTACGTCTA.ATTGATTGG
GTACGTCTA.CTAGAGGTA	GTACGTCTA.CTAGAGGTA
GTACGTCTA.GCCGCCTAA	GTACGTCTA.GCCGCCTAA
GTACGTCTA.TCAATGGAC	GTACGTCTA.TCAATGGAC
GTACTCTAC.CAGTAATGT	GTACTCTAC.CAGTAATGT
GTAGAAGTT.AGATATGGA	GTAGAAGTT.AGATATGGA
GTAGAAGTT.CCTATTCAA	GTAGAAGTT.CCTATTCAA
GTAGAAGTT.GGACGAGCA	GTAGAAGTT.GGACGAGCA
GTAGAAGTT.GTCGTCGAC	GTAGAAGTT.GTCGTCGAC
GTAGAAGTT.TTGCGAACA	GTAGAAGTT.TTGCGAACA
GTAGACTCT.ACTTAGCTT	GTAGACTCT.ACTTAGCTT
GTAGACTCT.AGGTATTCC	GTAGACTCT.AGGTATTCC
GTAGACTCT.GACACGCAA	GTAGACTCT.GACACGCAA
GTAGAGAGC.ACACGTTGC	GTAGAGAGC.ACACGTTGC
GTAGAGAGC.CCGGATTGC	GTAGAGAGC.CCGGATTGC
GTAGAGAGC.TCCAGAACG	GTAGAGAGC.TCCAGAACG
GTAGAGAGC.TTAGTCGGA	GTAGAGAGC.TTAGTCGGA
GTAGCATAC.ACCGGTTAC	GTAGCATAC.ACCGGTTAC
GTAGCATAC.ACTCGAGTC	GTAGCATAC.ACTCGAGTC
GTAGCATAC.CTCGTGTCC	GTAGCATAC.CTCGTGTCC
GTAGCCTTG.ACCTAGTTA	GTAGCCTTG.ACCTAGTTA
GTAGCTACA.ATAATGTGG	GTAGCTACA.ATAATGTGG
GTAGCTACA.GTCTCTTCA	GTAGCTACA.GTCTCTTCA
GTAGCTACA.TATGCCTTC	GTAGCTACA.TATGCCTTC
GTAGCTACA.TGACCTCCT	GTAGCTACA.TGACCTCCT
GTAGCTACA.TTCAACTAC	GTAGCTACA.TTCAACTAC
GTAGGACGC.AATTGGTGA	GTAGGACGC.AATTGGTGA
GTAGGACGC.ATCAGTCGA	GTAGGACGC.ATCAGTCGA
GTAGGACGC.ATTCTCTGG	GTAGGACGC.ATTCTCTGG
GTAGGACGC.GCAGCGATA	GTAGGACGC.GCAGCGATA
GTAGGACGC.GTCCGTAAG	GTAGGACGC.GTCCGTAAG
GTAGTGGAG.ATACTTGCT	GTAGTGGAG.ATACTTGCT
GTAGTGGAG.CCGACGTCA	GTAGTGGAG.CCGACGTCA
GTAGTGGAG.TGCCACCGA	GTAGTGGAG.TGCCACCGA
GTAGTTGGT.ACAGAAGAG	GTAGTTGGT.ACAGAAGAG
GTAGTTGGT.CTAGAGTCG	GTAGTTGGT.CTAGAGTCG
GTAGTTGGT.TAAGTACAC	GTAGTTGGT.TAAGTACAC
GTATACAGA.CACACCACA	GTATACAGA.CACACCACA
GTATACAGA.CCGTACGGA	GTATACAGA.CCGTACGGA
GTATACAGA.CGTTAATGG	GTATACAGA.CGTTAATGG
GTATACAGA.TTGATGAGT	GTATACAGA.TTGATGAGT
GTATCCTGC.AGTCGCGAC	GTATCCTGC.AGTCGCGAC
GTATCCTGC.CTATAGCTC	GTATCCTGC.CTATAGCTC
GTATCCTGC.GACCGTAGT	GTATCCTGC.GACCGTAGT
GTATCCTGC.GGACACTGG	GTATCCTGC.GGACACTGG
GTATCGTCG.AGATCGAGT	GTATCGTCG.AGATCGAGT
GTATGATCT.ATAGCTTGC	GTATGATCT.ATAGCTTGC
GTATGATCT.ATGGTTCGA	GTATGATCT.ATGGTTCGA
GTATGATCT.GTAACCATA	GTATGATCT.GTAACCATA
GTATGATCT.GTACGTCTA	GTATGATCT.GTACGTCTA
GTATGCCTT.ATCTACATC	GTATGCCTT.ATCTACATC
GTATGCCTT.GTTATCGAT	GTATGCCTT.GTTATCGAT
GTATGCCTT.TGACCTCCT	GTATGCCTT.TGACCTCCT
GTATGTATC.CCATTCTGC	GTATGTATC.CCATTCTGC
GTATGTATC.CGTGCTTGA	GTATGTATC.CGTGCTTGA
GTATGTATC.GTAGCCTTG	GTATGTATC.GTAGCCTTG
GTATGTATC.TGTTGTCGA	GTATGTATC.TGTTGTCGA
GTATTACTG.GCGTGATAC	GTATTACTG.GCGTGATAC
GTATTACTG.GTAGCATAC	GTATTACTG.GTAGCATAC
GTCAACTGA.ACGTGCTCG	GTCAACTGA.ACGTGCTCG
GTCAACTGA.ATACAACCG	GTCAACTGA.ATACAACCG
GTCAACTGA.CCTATTGGT	GTCAACTGA.CCTATTGGT
GTCAAGATC.AACGTTCTT	GTCAAGATC.AACGTTCTT
GTCAAGATC.CTCTGCAAG	GTCAAGATC.CTCTGCAAG
GTCAATACA.CTGGTAATC	GTCAATACA.CTGGTAATC
GTCAATACA.TCAGGACTG	GTCAATACA.TCAGGACTG
GTCAATACA.TGTTGTCGA	GTCAATACA.TGTTGTCGA
GTCACAGAG.GTCTCCAGG	GTCACAGAG.GTCTCCAGG
GTCACAGAG.TCCGGAGCT	GTCACAGAG.TCCGGAGCT
GTCACTATG.ATGAACTAG	GTCACTATG.ATGAACTAG
GTCACTATG.TCTAGGATG	GTCACTATG.TCTAGGATG
GTCACTATG.TTATCCAAG	GTCACTATG.TTATCCAAG
GTCAGACCG.ACGCGTGAC	GTCAGACCG.ACGCGTGAC
GTCAGACCG.ATTAGCGGT	GTCAGACCG.ATTAGCGGT
GTCAGACCG.CGTGTCCGA	GTCAGACCG.CGTGTCCGA
GTCAGACCG.CTGAGGTTA	GTCAGACCG.CTGAGGTTA
GTCAGACCG.TCCGATAAC	GTCAGACCG.TCCGATAAC
GTCAGCGTC.CTGCAGAGC	GTCAGCGTC.CTGCAGAGC
GTCAGCGTC.GAAGTGTGA	GTCAGCGTC.GAAGTGTGA
GTCAGTTGT.GCACGCATT	GTCAGTTGT.GCACGCATT
GTCAGTTGT.TGATGGACA	GTCAGTTGT.TGATGGACA
GTCATTCTA.ACTACCATC	GTCATTCTA.ACTACCATC
GTCATTCTA.CTCGCTACG	GTCATTCTA.CTCGCTACG
GTCATTCTA.GTGTCCGTG	GTCATTCTA.GTGTCCGTG
GTCATTCTA.TCTTAGCGA	GTCATTCTA.TCTTAGCGA
GTCCACAAC.AGTCGCCGA	GTCCACAAC.AGTCGCCGA
GTCCACAAC.CCATATCTT	GTCCACAAC.CCATATCTT
GTCCGCTCA.AATGTGCGT	GTCCGCTCA.AATGTGCGT
GTCCGCTCA.CACACCTGT	GTCCGCTCA.CACACCTGT
GTCCGCTCA.CAGGAGCCT	GTCCGCTCA.CAGGAGCCT
GTCCGCTCA.CATAGAGAT	GTCCGCTCA.CATAGAGAT
GTCCGCTCA.TAATTCGTG	GTCCGCTCA.TAATTCGTG
GTCCGCTCA.TCAAGGTCG	GTCCGCTCA.TCAAGGTCG
GTCCGCTCA.TTCAACTAC	GTCCGCTCA.TTCAACTAC
GTCCGTAAG.ACGATGACC	GTCCGTAAG.ACGATGACC
GTCCGTAAG.ACTCGCTGT	GTCCGTAAG.ACTCGCTGT
GTCCGTAAG.CGAGTAGCA	GTCCGTAAG.CGAGTAGCA
GTCCGTAAG.GAATTGTTG	GTCCGTAAG.GAATTGTTG
GTCCGTAAG.GCTTGTCCT	GTCCGTAAG.GCTTGTCCT
GTCCTAGTT.ATCTCTGCT	GTCCTAGTT.ATCTCTGCT
GTCCTTCAT.CGTACATCT	GTCCTTCAT.CGTACATCT
GTCCTTCAT.CTCTAGTAA	GTCCTTCAT.CTCTAGTAA
GTCCTTCAT.TGGTCGCTA	GTCCTTCAT.TGGTCGCTA
GTCGACATT.AAGTAGGAC	GTCGACATT.AAGTAGGAC
GTCGACATT.AGGATTGAG	GTCGACATT.AGGATTGAG
GTCGACATT.ATTGATTGG	GTCGACATT.ATTGATTGG
GTCGACATT.CCGACGTCA	GTCGACATT.CCGACGTCA
GTCGACATT.CTGAGTCCA	GTCGACATT.CTGAGTCCA
GTCGACATT.TCCTGAGAC	GTCGACATT.TCCTGAGAC
GTCGAGTAC.ACAAGTACA	GTCGAGTAC.ACAAGTACA
GTCGAGTAC.AGCATTGTT	GTCGAGTAC.AGCATTGTT
GTCGAGTAC.ATTCGAAGA	GTCGAGTAC.ATTCGAAGA
GTCGAGTAC.GTCTGACGT	GTCGAGTAC.GTCTGACGT
GTCGAGTAC.TCACAGGTA	GTCGAGTAC.TCACAGGTA
GTCGCAGGT.AACTAACTG	GTCGCAGGT.AACTAACTG
GTCGCAGGT.ACGTGCTCG	GTCGCAGGT.ACGTGCTCG
GTCGCAGGT.AGCTTCGAT	GTCGCAGGT.AGCTTCGAT
GTCGCAGGT.ATGACACAA	GTCGCAGGT.ATGACACAA
GTCGCAGGT.CGAAGAGGT	GTCGCAGGT.CGAAGAGGT
GTCGCAGGT.CGTGTATTC	GTCGCAGGT.CGTGTATTC
GTCGCAGGT.CTAGTTCCA	GTCGCAGGT.CTAGTTCCA
GTCGTCGAC.ACACACCGT	GTCGTCGAC.ACACACCGT
GTCGTCGAC.CCTGCAGAT	GTCGTCGAC.CCTGCAGAT
GTCGTCGAC.CTCATGCCA	GTCGTCGAC.CTCATGCCA
GTCGTCGAC.CTGACGGAT	GTCGTCGAC.CTGACGGAT
GTCGTGTTA.TAAGGTCCG	GTCGTGTTA.TAAGGTCCG
GTCGTTAGA.AGGAATTGG	GTCGTTAGA.AGGAATTGG
GTCGTTGCG.AGTAACGTA	GTCGTTGCG.AGTAACGTA
GTCGTTGCG.CCTCGCGTT	GTCGTTGCG.CCTCGCGTT
GTCGTTGCG.GCTTGTCCT	GTCGTTGCG.GCTTGTCCT
GTCGTTGCG.TGATTGCTG	GTCGTTGCG.TGATTGCTG
GTCTACCAA.AAGCAGCAT	GTCTACCAA.AAGCAGCAT
GTCTACCAA.AGCTGCACT	GTCTACCAA.AGCTGCACT
GTCTACCAA.AGTCCGTGT	GTCTACCAA.AGTCCGTGT
GTCTACCAA.CAACGATCG	GTCTACCAA.CAACGATCG
GTCTACCAA.CCGAGTACT	GTCTACCAA.CCGAGTACT
GTCTACCAA.CTTCGACTG	GTCTACCAA.CTTCGACTG
GTCTACCAA.GTGCTCTTG	GTCTACCAA.GTGCTCTTG
GTCTCCAGG.ATAGCCTAA	GTCTCCAGG.ATAGCCTAA
