GTCTCCAGG.CGGAACGAG	GTCTCCAGG.CGGAACGAG
GTCTCTTCA.ATCCACAGT	GTCTCTTCA.ATCCACAGT
GTCTCTTCA.ATGAGTGTG	GTCTCTTCA.ATGAGTGTG
GTCTCTTCA.GCCAATGAA	GTCTCTTCA.GCCAATGAA
GTCTCTTCA.GCTTCACTC	GTCTCTTCA.GCTTCACTC
GTCTCTTCA.GTGTATCTG	GTCTCTTCA.GTGTATCTG
GTCTGACGT.AGAGCGGAG	GTCTGACGT.AGAGCGGAG
GTCTGACGT.ATATAGCGT	GTCTGACGT.ATATAGCGT
GTCTGACGT.ATTCCTACG	GTCTGACGT.ATTCCTACG
GTCTGACGT.GATATGGAC	GTCTGACGT.GATATGGAC
GTCTGACGT.TCTCAGGAT	GTCTGACGT.TCTCAGGAT
GTCTGACGT.TCTTAGCGA	GTCTGACGT.TCTTAGCGA
GTCTGACGT.TGATGGACA	GTCTGACGT.TGATGGACA
GTCTGAGCC.AGCACCGTG	GTCTGAGCC.AGCACCGTG
GTCTGAGCC.TGATACCGT	GTCTGAGCC.TGATACCGT
GTCTTATGC.AGATATGGA	GTCTTATGC.AGATATGGA
GTCTTATGC.CTTGTAACG	GTCTTATGC.CTTGTAACG
GTCTTCATA.ACACAGAAC	GTCTTCATA.ACACAGAAC
GTCTTCATA.ATTCCTACG	GTCTTCATA.ATTCCTACG
GTCTTCATA.CGGTAGCTT	GTCTTCATA.CGGTAGCTT
GTCTTCATA.CTCAGTGAT	GTCTTCATA.CTCAGTGAT
GTCTTCATA.GATGCGGTT	GTCTTCATA.GATGCGGTT
GTCTTCATA.TTCACCTTG	GTCTTCATA.TTCACCTTG
GTCTTCTCG.ACACATCTG	GTCTTCTCG.ACACATCTG
GTCTTCTCG.CTCTAGTAA	GTCTTCTCG.CTCTAGTAA
GTCTTCTCG.GGATACAAT	GTCTTCTCG.GGATACAAT
GTGAACCAC.ACGCGACAG	GTGAACCAC.ACGCGACAG
GTGAACCAC.ACTAACCGA	GTGAACCAC.ACTAACCGA
GTGAACCAC.TGCTATGAA	GTGAACCAC.TGCTATGAA
GTGAACCAC.TGGTTATAC	GTGAACCAC.TGGTTATAC
GTGAATGCC.CAACCGGTC	GTGAATGCC.CAACCGGTC
GTGAATGCC.CACAACCAG	GTGAATGCC.CACAACCAG
GTGAATGCC.CTTACATGC	GTGAATGCC.CTTACATGC
GTGAATGCC.GATTGGAAG	GTGAATGCC.GATTGGAAG
GTGAATGCC.TCAGACAAG	GTGAATGCC.TCAGACAAG
GTGACGTAA.ACTTCGCAG	GTGACGTAA.ACTTCGCAG
GTGACGTAA.CCTTGCTTG	GTGACGTAA.CCTTGCTTG
GTGACGTAA.GATGCAGAA	GTGACGTAA.GATGCAGAA
GTGACGTAA.TGTGGTCCT	GTGACGTAA.TGTGGTCCT
GTGACTCTC.ATAGCTTGC	GTGACTCTC.ATAGCTTGC
GTGACTCTC.CATCCGACA	GTGACTCTC.CATCCGACA
GTGACTCTC.GAACCAGTT	GTGACTCTC.GAACCAGTT
GTGAGGACG.ACAGCGTAT	GTGAGGACG.ACAGCGTAT
GTGAGGACG.CGACCTGTA	GTGAGGACG.CGACCTGTA
GTGAGGACG.GCCAACAAT	GTGAGGACG.GCCAACAAT
GTGATGTGC.ACAGCGGTC	GTGATGTGC.ACAGCGGTC
GTGATGTGC.AGCATTCCA	GTGATGTGC.AGCATTCCA
GTGATGTGC.CATGTCCTG	GTGATGTGC.CATGTCCTG
GTGATGTGC.CCACAAGGT	GTGATGTGC.CCACAAGGT
GTGATGTGC.CCATACGAT	GTGATGTGC.CCATACGAT
GTGCACGAG.ATGTCCTCC	GTGCACGAG.ATGTCCTCC
GTGCACGAG.CGAGCCGTT	GTGCACGAG.CGAGCCGTT
GTGCACGAG.GCCGTGAAC	GTGCACGAG.GCCGTGAAC
GTGCACGAG.GCGACCTGT	GTGCACGAG.GCGACCTGT
GTGCACGAG.TAACGTGTC	GTGCACGAG.TAACGTGTC
GTGCATCAA.ACTTAGCTT	GTGCATCAA.ACTTAGCTT
GTGCATCAA.CTCAGTGAT	GTGCATCAA.CTCAGTGAT
GTGCATCAA.CTGTCACTT	GTGCATCAA.CTGTCACTT
GTGCATCAA.GGACTCCTT	GTGCATCAA.GGACTCCTT
GTGCATCAA.GGTAATCTA	GTGCATCAA.GGTAATCTA
GTGCATCAA.TACGTTGGA	GTGCATCAA.TACGTTGGA
GTGCATCAA.TCCGATCTG	GTGCATCAA.TCCGATCTG
GTGCATCAA.TCCGGAGCT	GTGCATCAA.TCCGGAGCT
GTGCCATGA.CACTGCTTA	GTGCCATGA.CACTGCTTA
GTGCCATGA.GGTAGCATC	GTGCCATGA.GGTAGCATC
GTGCCATGA.TGCCAATGG	GTGCCATGA.TGCCAATGG
GTGCCATGA.TTCCTGCTA	GTGCCATGA.TTCCTGCTA
GTGCGAGTA.ATAAGTTCG	GTGCGAGTA.ATAAGTTCG
GTGCGTTCC.ACAAGAATG	GTGCGTTCC.ACAAGAATG
GTGCGTTCC.ATATAGCGT	GTGCGTTCC.ATATAGCGT
GTGCGTTCC.GCGCATTAC	GTGCGTTCC.GCGCATTAC
GTGCGTTCC.TCACGCGAC	GTGCGTTCC.TCACGCGAC
GTGCTAAGC.ATGAGATCC	GTGCTAAGC.ATGAGATCC
GTGCTAAGC.ATGTGAGAC	GTGCTAAGC.ATGTGAGAC
GTGCTAAGC.CGTATCGAA	GTGCTAAGC.CGTATCGAA
GTGCTCGGA.AGTGTGCAC	GTGCTCGGA.AGTGTGCAC
GTGCTCGGA.ATATGTCCA	GTGCTCGGA.ATATGTCCA
GTGCTCGGA.ATGGAGGAA	GTGCTCGGA.ATGGAGGAA
GTGCTCGGA.TCCTATTCC	GTGCTCGGA.TCCTATTCC
GTGCTCGGA.TGTATCGTG	GTGCTCGGA.TGTATCGTG
GTGCTCTTG.ATGGTTCGA	GTGCTCTTG.ATGGTTCGA
GTGCTCTTG.CTGGACACT	GTGCTCTTG.CTGGACACT
GTGCTCTTG.GAGGTGAGC	GTGCTCTTG.GAGGTGAGC
GTGCTCTTG.GCCTTCCAT	GTGCTCTTG.GCCTTCCAT
GTGCTCTTG.TCAGACAAG	GTGCTCTTG.TCAGACAAG
GTGCTCTTG.TGCCGCTAC	GTGCTCTTG.TGCCGCTAC
GTGCTCTTG.TTCATCCAA	GTGCTCTTG.TTCATCCAA
GTGCTGACT.ACACACGTC	GTGCTGACT.ACACACGTC
GTGCTGACT.GCCGTGAAC	GTGCTGACT.GCCGTGAAC
GTGCTGACT.GCGATATGA	GTGCTGACT.GCGATATGA
GTGCTGACT.GGATACAAT	GTGCTGACT.GGATACAAT
GTGCTGACT.TCAGTAAGC	GTGCTGACT.TCAGTAAGC
GTGGACTGG.ACAACCGGA	GTGGACTGG.ACAACCGGA
GTGGACTGG.CCACAAGGT	GTGGACTGG.CCACAAGGT
GTGGACTGG.GATACTGTG	GTGGACTGG.GATACTGTG
GTGGACTGG.GGATGCTCG	GTGGACTGG.GGATGCTCG
GTGGACTGG.TATGTATGC	GTGGACTGG.TATGTATGC
GTGGACTGG.TGAGAATCC	GTGGACTGG.TGAGAATCC
GTGGAGGTC.CTGAGTAGC	GTGGAGGTC.CTGAGTAGC
GTGGAGGTC.TGCCGCTAC	GTGGAGGTC.TGCCGCTAC
GTGGAGGTC.TTCGCATCC	GTGGAGGTC.TTCGCATCC
GTGGATAAG.ACTTCTAAC	GTGGATAAG.ACTTCTAAC
GTGGATAAG.TACGGTCGT	GTGGATAAG.TACGGTCGT
GTGGATAAG.TCTAGGATG	GTGGATAAG.TCTAGGATG
GTGGTACGG.AACCGCTGA	GTGGTACGG.AACCGCTGA
GTGGTACGG.CAAGGTGTG	GTGGTACGG.CAAGGTGTG
GTGGTACGG.CCGATACCG	GTGGTACGG.CCGATACCG
GTGGTACGG.CTCTACGCA	GTGGTACGG.CTCTACGCA
GTGGTTACC.TATTACTCG	GTGGTTACC.TATTACTCG
GTGGTTACC.TCCAGAACG	GTGGTTACC.TCCAGAACG
GTGTACCGT.AGTTCAACC	GTGTACCGT.AGTTCAACC
GTGTACCGT.TAGCCTTGT	GTGTACCGT.TAGCCTTGT
GTGTACCGT.TAGTACGTA	GTGTACCGT.TAGTACGTA
GTGTATCTG.ACGGTGCCT	GTGTATCTG.ACGGTGCCT
GTGTATCTG.ACTATTGTC	GTGTATCTG.ACTATTGTC
GTGTATCTG.ACTTAGCTT	GTGTATCTG.ACTTAGCTT
GTGTATCTG.CACCTACGC	GTGTATCTG.CACCTACGC
GTGTATCTG.CTTAAGTTG	GTGTATCTG.CTTAAGTTG
GTGTATCTG.GGATTCGTC	GTGTATCTG.GGATTCGTC
GTGTATCTG.TAGAGACTA	GTGTATCTG.TAGAGACTA
GTGTCACAC.AACGCCTAC	GTGTCACAC.AACGCCTAC
GTGTCACAC.AGGTATTCC	GTGTCACAC.AGGTATTCC
GTGTCACAC.CGAATCCTG	GTGTCACAC.CGAATCCTG
GTGTCACAC.TTCCAATTC	GTGTCACAC.TTCCAATTC
GTGTCCGTG.CAGTACATC	GTGTCCGTG.CAGTACATC
GTGTCCGTG.TGATACCGT	GTGTCCGTG.TGATACCGT
GTGTCCGTG.TGCGTGCCA	GTGTCCGTG.TGCGTGCCA
GTGTCGAGC.CAGGTATCG	GTGTCGAGC.CAGGTATCG
GTGTCGAGC.CCTAGAGTA	GTGTCGAGC.CCTAGAGTA
GTGTCGAGC.GTTAGATTG	GTGTCGAGC.GTTAGATTG
GTGTCTGGA.CCGTACGGA	GTGTCTGGA.CCGTACGGA
GTGTCTGGA.CGTGCAAGG	GTGTCTGGA.CGTGCAAGG
GTGTCTGGA.TATTCAACG	GTGTCTGGA.TATTCAACG
GTGTCTGGA.TCAGGTGCA	GTGTCTGGA.TCAGGTGCA
GTGTTCCAG.ACACCACAT	GTGTTCCAG.ACACCACAT
GTGTTCCAG.ATCTCGAAC	GTGTTCCAG.ATCTCGAAC
GTGTTCCAG.CATACAACC	GTGTTCCAG.CATACAACC
GTGTTCCAG.CCGCAGCTA	GTGTTCCAG.CCGCAGCTA
GTGTTGGAA.ACTAAGTTC	GTGTTGGAA.ACTAAGTTC
GTGTTGGAA.CGCTTATGA	GTGTTGGAA.CGCTTATGA
GTGTTGGAA.TGAACTTGC	GTGTTGGAA.TGAACTTGC
GTGTTGGAA.TGGATTAGC	GTGTTGGAA.TGGATTAGC
GTGTTGGAA.TTCGTGATG	GTGTTGGAA.TTCGTGATG
GTTAATTCG.ACTCGAGTC	GTTAATTCG.ACTCGAGTC
GTTAATTCG.CAGTGCCAT	GTTAATTCG.CAGTGCCAT
GTTAATTCG.CGTCTGTCC	GTTAATTCG.CGTCTGTCC
GTTACTACT.CACTAGACT	GTTACTACT.CACTAGACT
GTTACTACT.GACTTGATT	GTTACTACT.GACTTGATT
GTTACTACT.TATACCACT	GTTACTACT.TATACCACT
GTTACTACT.TTCACTCCT	GTTACTACT.TTCACTCCT
GTTACTACT.TTCGCATCC	GTTACTACT.TTCGCATCC
GTTAGAGAC.AATTAGAGG	GTTAGAGAC.AATTAGAGG
GTTAGAGAC.ACTGTAATC	GTTAGAGAC.ACTGTAATC
GTTAGAGAC.CCATGATGT	GTTAGAGAC.CCATGATGT
GTTAGAGAC.TCAGAGTCA	GTTAGAGAC.TCAGAGTCA
GTTAGAGAC.TTACACCTT	GTTAGAGAC.TTACACCTT
GTTAGATTG.ACCATTCAC	GTTAGATTG.ACCATTCAC
GTTAGATTG.CCGACGTCA	GTTAGATTG.CCGACGTCA
GTTAGATTG.CGAGTAGCA	GTTAGATTG.CGAGTAGCA
GTTAGATTG.CTGCAGAGC	GTTAGATTG.CTGCAGAGC
GTTAGATTG.TATTGCTAC	GTTAGATTG.TATTGCTAC
GTTAGTCAA.AACAATGCA	GTTAGTCAA.AACAATGCA
GTTAGTCAA.AGCCGTTCT	GTTAGTCAA.AGCCGTTCT
GTTAGTCAA.GCGCTCTAT	GTTAGTCAA.GCGCTCTAT
GTTAGTCAA.TAGCCTTGT	GTTAGTCAA.TAGCCTTGT
GTTATCGAT.ACCGTACGC	GTTATCGAT.ACCGTACGC
GTTATCGAT.ACTGTGTCA	GTTATCGAT.ACTGTGTCA
GTTATCGAT.ATGAGATCC	GTTATCGAT.ATGAGATCC
GTTATCGAT.CAGTAATGT	GTTATCGAT.CAGTAATGT
GTTATCGAT.CATAGGTGT	GTTATCGAT.CATAGGTGT
GTTCACTCC.ATAACGACA	GTTCACTCC.ATAACGACA
GTTCAGAAG.CCACACAGA	GTTCAGAAG.CCACACAGA
GTTCAGAAG.GAGGTGAGC	GTTCAGAAG.GAGGTGAGC
GTTCAGAAG.GATAGTTCT	GTTCAGAAG.GATAGTTCT
GTTCAGAAG.TGAGCAGAT	GTTCAGAAG.TGAGCAGAT
GTTCCAACA.AATCTGACC	GTTCCAACA.AATCTGACC
GTTCCAACA.AGAGCGCGA	GTTCCAACA.AGAGCGCGA
GTTCCAACA.GCAACACCT	GTTCCAACA.GCAACACCT
GTTCCAACA.GGTTAGATG	GTTCCAACA.GGTTAGATG
GTTCCAACA.GTCCGCTCA	GTTCCAACA.GTCCGCTCA
GTTCCAACA.TCACCGAGG	GTTCCAACA.TCACCGAGG
GTTGACCAT.ACCGAGTAG	GTTGACCAT.ACCGAGTAG
GTTGACCAT.ATATAGCGT	GTTGACCAT.ATATAGCGT
GTTGACCAT.GAATTCAGT	GTTGACCAT.GAATTCAGT
GTTGACCAT.GCGGTAGTC	GTTGACCAT.GCGGTAGTC
GTTGACCAT.TGCGTCTTA	GTTGACCAT.TGCGTCTTA
GTTGACGTG.AGCCAGGAC	GTTGACGTG.AGCCAGGAC
GTTGACGTG.CATGTGAAC	GTTGACGTG.CATGTGAAC
GTTGACGTG.CCATATGCC	GTTGACGTG.CCATATGCC
GTTGACGTG.CGGAATGCA	GTTGACGTG.CGGAATGCA
GTTGACGTG.CGGTCGACA	GTTGACGTG.CGGTCGACA
GTTGACGTG.GAATCACAT	GTTGACGTG.GAATCACAT
GTTGATGCA.AACAGATCG	GTTGATGCA.AACAGATCG
GTTGATGCA.GGTAAGGAT	GTTGATGCA.GGTAAGGAT
GTTGATGCA.GTTAGAGAC	GTTGATGCA.GTTAGAGAC
GTTGATGCA.TGCTGCGTC	GTTGATGCA.TGCTGCGTC
GTTGCATGG.ACCAGCGTT	GTTGCATGG.ACCAGCGTT
GTTGCATGG.CACTACAGG	GTTGCATGG.CACTACAGG
GTTGCATGG.CACTGCTTA	GTTGCATGG.CACTGCTTA
GTTGCATGG.GATGCGGTT	GTTGCATGG.GATGCGGTT
GTTGCTCAG.CACGTCATA	GTTGCTCAG.CACGTCATA
TAACACATC.AATACCTTG	TAACACATC.AATACCTTG
TAACACATC.CGGATTCTC	TAACACATC.CGGATTCTC
TAACACATC.CGGTTCTAT	TAACACATC.CGGTTCTAT
TAACACGAG.ACATCGTCC	TAACACGAG.ACATCGTCC
TAACACGAG.CAAGCCTCG	TAACACGAG.CAAGCCTCG
TAACACGAG.TGTGCCATG	TAACACGAG.TGTGCCATG
TAACATTGG.AGTCTAAGC	TAACATTGG.AGTCTAAGC
TAACATTGG.GACACGCAA	TAACATTGG.GACACGCAA
TAACATTGG.GCTTACGTT	TAACATTGG.GCTTACGTT
TAACATTGG.GTAGCCTTG	TAACATTGG.GTAGCCTTG
TAACATTGG.TGTAGCAAG	TAACATTGG.TGTAGCAAG
TAACCGTGA.ATTAGCACA	TAACCGTGA.ATTAGCACA
TAACCGTGA.GCAATGAGA	TAACCGTGA.GCAATGAGA
TAACCGTGA.GCACAGTAA	TAACCGTGA.GCACAGTAA
TAACGGATA.ACCGAGTAG	TAACGGATA.ACCGAGTAG
TAACGGATA.ATATAGCGT	TAACGGATA.ATATAGCGT
TAACGGATA.CCACGTTCT	TAACGGATA.CCACGTTCT
TAACGGATA.GACACGCAA	TAACGGATA.GACACGCAA
TAACGGATA.TATGCCTTC	TAACGGATA.TATGCCTTC
TAACGGATA.TGCGTCTTA	TAACGGATA.TGCGTCTTA
TAACGTGTC.AACTTAGCT	TAACGTGTC.AACTTAGCT
TAACGTGTC.TAGACCTAC	TAACGTGTC.TAGACCTAC
TAACTCCGA.CCTCTGCAT	TAACTCCGA.CCTCTGCAT
TAACTCCGA.CTTCTATGA	TAACTCCGA.CTTCTATGA
TAACTCCGA.GGTCGGTCT	TAACTCCGA.GGTCGGTCT
TAAGCACTA.CGCAATCGA	TAAGCACTA.CGCAATCGA
TAAGCACTA.TGGTGGATC	TAAGCACTA.TGGTGGATC
TAAGCCATT.TGGAAGATT	TAAGCCATT.TGGAAGATT
TAAGGTCCG.AACTCCATG	TAAGGTCCG.AACTCCATG
TAAGGTCCG.ACCTAGTTA	TAAGGTCCG.ACCTAGTTA
TAAGGTCCG.GACGTAGCA	TAAGGTCCG.GACGTAGCA
TAAGGTCCG.GGACAGATT	TAAGGTCCG.GGACAGATT
TAAGGTCCG.TCAAGCGTA	TAAGGTCCG.TCAAGCGTA
TAAGGTGAT.AACAACCTA	TAAGGTGAT.AACAACCTA
TAAGGTGAT.ATTAGCACA	TAAGGTGAT.ATTAGCACA
TAAGGTGAT.CCTCATAAC	TAAGGTGAT.CCTCATAAC
TAAGGTGAT.GGTTGAAGG	TAAGGTGAT.GGTTGAAGG
TAAGGTGAT.TATAGTGCG	TAAGGTGAT.TATAGTGCG
TAAGTACAC.CACGCGTAA	TAAGTACAC.CACGCGTAA
TAAGTACAC.CCAATATAC	TAAGTACAC.CCAATATAC
TAAGTACAC.GATACTGTG	TAAGTACAC.GATACTGTG
TAAGTACAC.GCGATGGTG	TAAGTACAC.GCGATGGTG
TAAGTACAC.TACGACTTG	TAAGTACAC.TACGACTTG
TAAGTGTAG.TGAAGACCA	TAAGTGTAG.TGAAGACCA
TAATCACGC.CTGTGGTGG	TAATCACGC.CTGTGGTGG
TAATCACGC.GTGTATCTG	TAATCACGC.GTGTATCTG
TAATCACGC.TGCCTTCAG	TAATCACGC.TGCCTTCAG
TAATCACGC.TTCGCATCC	TAATCACGC.TTCGCATCC
TAATCACGC.TTGTATCAC	TAATCACGC.TTGTATCAC
TAATCTGGA.GTAGCATAC	TAATCTGGA.GTAGCATAC
TAATGTAGC.ACTAACCGA	TAATGTAGC.ACTAACCGA
TAATGTAGC.ACTCATTCA	TAATGTAGC.ACTCATTCA
TAATGTAGC.AGAAGTAAC	TAATGTAGC.AGAAGTAAC
TAATGTAGC.TTACCTCTC	TAATGTAGC.TTACCTCTC
TAATGTAGC.TTGTATCAC	TAATGTAGC.TTGTATCAC
TAATTCGTG.AATCAGGAG	TAATTCGTG.AATCAGGAG
TAATTCGTG.ACGCGACAG	TAATTCGTG.ACGCGACAG
TAATTCGTG.CCGCTATCC	TAATTCGTG.CCGCTATCC
TAATTCGTG.GCGCTACCT	TAATTCGTG.GCGCTACCT
TAATTCGTG.TATGACCGA	TAATTCGTG.TATGACCGA
TACAACACC.AACTTGTCG	TACAACACC.AACTTGTCG
TACAACACC.CGCCATTAC	TACAACACC.CGCCATTAC
TACAACACC.GATAAGCTG	TACAACACC.GATAAGCTG
TACAAGAGG.AGGTCAGCA	TACAAGAGG.AGGTCAGCA
TACAAGAGG.CCATAAGTA	TACAAGAGG.CCATAAGTA
TACACGGTC.AACAATGCA	TACACGGTC.AACAATGCA
TACACGGTC.CCATCACGA	TACACGGTC.CCATCACGA
TACACGGTC.CTGACGATG	TACACGGTC.CTGACGATG
TACACGGTC.GGTGTGACC	TACACGGTC.GGTGTGACC
TACACGGTC.TAAGTACAC	TACACGGTC.TAAGTACAC
TACAGGACT.ACACACCGT	TACAGGACT.ACACACCGT
TACAGGACT.CTGGTGACA	TACAGGACT.CTGGTGACA
TACAGGACT.GGATACCTA	TACAGGACT.GGATACCTA
TACAGGACT.TGAGGTCTC	TACAGGACT.TGAGGTCTC
TACAGGACT.TTACTAGTC	TACAGGACT.TTACTAGTC
TACAGTTAG.CTGTACGAC	TACAGTTAG.CTGTACGAC
TACAGTTAG.GCCACGAGT	TACAGTTAG.GCCACGAGT
TACAGTTAG.TTCCGAGCG	TACAGTTAG.TTCCGAGCG
TACATGCAC.CAGCTTCGA	TACATGCAC.CAGCTTCGA
TACATGCAC.TTGGTAACT	TACATGCAC.TTGGTAACT
TACCAGCCA.CAGTACATC	TACCAGCCA.CAGTACATC
TACCAGCCA.GTCGCAGGT	TACCAGCCA.GTCGCAGGT
TACCATGTA.ACTACCATC	TACCATGTA.ACTACCATC
TACCATGTA.AGAGAGTGG	TACCATGTA.AGAGAGTGG
TACCATGTA.CGAATGAGT	TACCATGTA.CGAATGAGT
TACCATGTA.GTCCTTCAT	TACCATGTA.GTCCTTCAT
TACCGATTG.GTCCACAAC	TACCGATTG.GTCCACAAC
TACCGATTG.TGTCGTACA	TACCGATTG.TGTCGTACA
TACCGATTG.TTCACCTTG	TACCGATTG.TTCACCTTG
TACCGCGTT.CGCCACCAT	TACCGCGTT.CGCCACCAT
TACCTATCC.AAGGAAGTC	TACCTATCC.AAGGAAGTC
TACCTATCC.CACATATCA	TACCTATCC.CACATATCA
TACCTATCC.CATCTCGAT	TACCTATCC.CATCTCGAT
TACCTATCC.GCGTGATAC	TACCTATCC.GCGTGATAC
TACCTCACT.ACGCAAGAT	TACCTCACT.ACGCAAGAT
TACCTCACT.GATCGCGAA	TACCTCACT.GATCGCGAA
TACCTCACT.TGATAGAGG	TACCTCACT.TGATAGAGG
TACCTCCTC.ATACGAGGT	TACCTCCTC.ATACGAGGT
TACCTCCTC.GTCGAGTAC	TACCTCCTC.GTCGAGTAC
TACCTCCTC.TGTTAAGCC	TACCTCCTC.TGTTAAGCC
TACGAACTC.ACTCCAACT	TACGAACTC.ACTCCAACT
TACGAACTC.ATCAAGCAT	TACGAACTC.ATCAAGCAT
TACGAACTC.CGATTGAAC	TACGAACTC.CGATTGAAC
TACGAACTC.GATCGATAC	TACGAACTC.GATCGATAC
TACGAACTC.GTGTCCGTG	TACGAACTC.GTGTCCGTG
TACGAACTC.TAAGCCATT	TACGAACTC.TAAGCCATT
TACGAACTC.TCAAGGAGT	TACGAACTC.TCAAGGAGT
TACGAACTC.TGATCGGAA	TACGAACTC.TGATCGGAA
TACGACCAT.ACATGGATT	TACGACCAT.ACATGGATT
TACGACCAT.ATCAGAAGC	TACGACCAT.ATCAGAAGC
TACGACCAT.GCACAGTAA	TACGACCAT.GCACAGTAA
TACGACTTG.ATGCCTGTC	TACGACTTG.ATGCCTGTC
TACGACTTG.GACCGTAGT	TACGACTTG.GACCGTAGT
TACGAGTGA.CATACGCAG	TACGAGTGA.CATACGCAG
TACGAGTGA.TACCTATCC	TACGAGTGA.TACCTATCC
TACGAGTGA.TGAGAGGAC	TACGAGTGA.TGAGAGGAC
TACGAGTGA.TGGTCCTAG	TACGAGTGA.TGGTCCTAG
TACGGTCGT.AACAACCTA	TACGGTCGT.AACAACCTA
TACGGTCGT.ACGTGCTCG	TACGGTCGT.ACGTGCTCG
TACGGTCGT.CAGTGAGGA	TACGGTCGT.CAGTGAGGA
TACGTTACC.AACGCTCAA	TACGTTACC.AACGCTCAA
TACGTTACC.TCGTACCTT	TACGTTACC.TCGTACCTT
TACGTTGGA.ATATGTCCA	TACGTTGGA.ATATGTCCA
TACGTTGGA.CGACCTGTA	TACGTTGGA.CGACCTGTA
TACGTTGGA.CTGCTTAGG	TACGTTGGA.CTGCTTAGG
TACGTTGGA.GATACCGGA	TACGTTGGA.GATACCGGA
TACGTTGGA.GCGCTACCT	TACGTTGGA.GCGCTACCT
TACGTTGGA.GTAGTGGAG	TACGTTGGA.GTAGTGGAG
TACGTTGGA.GTCTTCTCG	TACGTTGGA.GTCTTCTCG
TACGTTGGA.TCAGACAAG	TACGTTGGA.TCAGACAAG
TACGTTGGA.TCTACGCAA	TACGTTGGA.TCTACGCAA
TACGTTGGA.TCTAGTGAC	TACGTTGGA.TCTAGTGAC
TACTACTGT.CATGTCCTG	TACTACTGT.CATGTCCTG
TACTACTGT.CCACGTTCT	TACTACTGT.CCACGTTCT
TACTAGTAG.ACCGTCCTA	TACTAGTAG.ACCGTCCTA
TACTAGTAG.CTGGACTAA	TACTAGTAG.CTGGACTAA
TACTAGTAG.GTTGCTCAG	TACTAGTAG.GTTGCTCAG
TACTAGTAG.TAGATCTGT	TACTAGTAG.TAGATCTGT
TACTAGTAG.TAGGATTAG	TACTAGTAG.TAGGATTAG
TACTCGACC.CAGGATCAA	TACTCGACC.CAGGATCAA
TACTCGACC.CCGATACCG	TACTCGACC.CCGATACCG
TACTCGACC.GAATCAACC	TACTCGACC.GAATCAACC
TACTCGACC.GACAGGTTA	TACTCGACC.GACAGGTTA
TACTCGACC.GACGTTCAG	TACTCGACC.GACGTTCAG
TACTCGCTG.AACTAACTG	TACTCGCTG.AACTAACTG
TACTCGCTG.ACTGGTCAG	TACTCGCTG.ACTGGTCAG
TACTCGCTG.ACTGTGTCA	TACTCGCTG.ACTGTGTCA
TACTGATGA.AATCGCCAT	TACTGATGA.AATCGCCAT
TACTGATGA.AGCACACCT	TACTGATGA.AGCACACCT
TACTGATGA.AGTCGCCGA	TACTGATGA.AGTCGCCGA
TACTGATGA.GCCGTGAAC	TACTGATGA.GCCGTGAAC
TACTTACCA.GTTGACCAT	TACTTACCA.GTTGACCAT
TACTTCCAG.ATTAGCACA	TACTTCCAG.ATTAGCACA
TACTTCCAG.CCAATATAC	TACTTCCAG.CCAATATAC
TACTTCCAG.GCCGTTGTT	TACTTCCAG.GCCGTTGTT
TACTTCCAG.GGATGCTCG	TACTTCCAG.GGATGCTCG
TACTTCCAG.GTGCTAAGC	TACTTCCAG.GTGCTAAGC
TACTTCCAG.TTAACGTTC	TACTTCCAG.TTAACGTTC
TAGACACGT.GGTAATCTA	TAGACACGT.GGTAATCTA
TAGACCATG.ATGGAGAGT	TAGACCATG.ATGGAGAGT
TAGACCGCA.CTGGTAATC	TAGACCGCA.CTGGTAATC
TAGACCGCA.CTTCTCATC	TAGACCGCA.CTTCTCATC
TAGACCTAC.AACGCATTG	TAGACCTAC.AACGCATTG
TAGACCTAC.AAGCCAAGT	TAGACCTAC.AAGCCAAGT
TAGACCTAC.AGATCTGAC	TAGACCTAC.AGATCTGAC
TAGACCTAC.AGCTATATG	TAGACCTAC.AGCTATATG
TAGACCTAC.CCATAGCCA	TAGACCTAC.CCATAGCCA
TAGACCTAC.GAACCTTCA	TAGACCTAC.GAACCTTCA
TAGACCTAC.GTCTTATGC	TAGACCTAC.GTCTTATGC
TAGACCTAC.TATCACCTG	TAGACCTAC.TATCACCTG
TAGAGACTA.GGACAGATT	TAGAGACTA.GGACAGATT
TAGAGACTA.GTGTTGGAA	TAGAGACTA.GTGTTGGAA
TAGAGACTA.TATGCCTTC	TAGAGACTA.TATGCCTTC
TAGAGACTA.TCCAATCAT	TAGAGACTA.TCCAATCAT
TAGAGCCAG.ATGGACGTT	TAGAGCCAG.ATGGACGTT
TAGAGCCAG.CAGTACATC	TAGAGCCAG.CAGTACATC
TAGAGCCAG.CCACTGAAG	TAGAGCCAG.CCACTGAAG
TAGAGCCAG.CTTGATCTA	TAGAGCCAG.CTTGATCTA
TAGAGCGTC.ACCTGTACC	TAGAGCGTC.ACCTGTACC
TAGAGCGTC.CTGAGATAG	TAGAGCGTC.CTGAGATAG
TAGAGCGTC.GGACAGATT	TAGAGCGTC.GGACAGATT
TAGAGCGTC.TCCGGAGCT	TAGAGCGTC.TCCGGAGCT
TAGATAGCC.AAGACTACC	TAGATAGCC.AAGACTACC
TAGATAGCC.ACCTAGTTA	TAGATAGCC.ACCTAGTTA
TAGATAGCC.CCTCGACCT	TAGATAGCC.CCTCGACCT
TAGATAGCC.GAGATACAC	TAGATAGCC.GAGATACAC
TAGATCTGT.AACGGTAGC	TAGATCTGT.AACGGTAGC
TAGATCTGT.ACACACCGT	TAGATCTGT.ACACACCGT
TAGATCTGT.AGCACCAGC	TAGATCTGT.AGCACCAGC
TAGATCTGT.ATCCAATGA	TAGATCTGT.ATCCAATGA
TAGATCTGT.CTCTGCGGT	TAGATCTGT.CTCTGCGGT
TAGATCTGT.TATGAAGAC	TAGATCTGT.TATGAAGAC
TAGATCTGT.TGGTGGTAA	TAGATCTGT.TGGTGGTAA
TAGATCTGT.TTGAGCTCT	TAGATCTGT.TTGAGCTCT
TAGCACACG.AGATCTTCA	TAGCACACG.AGATCTTCA
TAGCACACG.CGAATCCTG	TAGCACACG.CGAATCCTG
TAGCACACG.GAAGTGTGA	TAGCACACG.GAAGTGTGA
TAGCACACG.GACTTGATT	TAGCACACG.GACTTGATT
TAGCACACG.GATGCAGAA	TAGCACACG.GATGCAGAA
TAGCACACG.TAACGTGTC	TAGCACACG.TAACGTGTC
TAGCACTAT.CCTAGAGTA	TAGCACTAT.CCTAGAGTA
TAGCACTAT.TCGCTGATT	TAGCACTAT.TCGCTGATT
TAGCAGAGT.ATCTCTGCT	TAGCAGAGT.ATCTCTGCT
TAGCAGAGT.CGCCACCAT	TAGCAGAGT.CGCCACCAT
TAGCAGAGT.TCGCAAGCA	TAGCAGAGT.TCGCAAGCA
TAGCAGAGT.TCGTGACGT	TAGCAGAGT.TCGTGACGT
TAGCCAGTG.AGACGCCTG	TAGCCAGTG.AGACGCCTG
TAGCCAGTG.AGCCGTTCT	TAGCCAGTG.AGCCGTTCT
TAGCCAGTG.ATATCCGAT	TAGCCAGTG.ATATCCGAT
TAGCCAGTG.GATAAGCTG	TAGCCAGTG.GATAAGCTG
TAGCCAGTG.TAGCACACG	TAGCCAGTG.TAGCACACG
TAGCCAGTG.TATGTACCT	TAGCCAGTG.TATGTACCT
TAGCCTTGT.GGTTAGATG	TAGCCTTGT.GGTTAGATG
TAGCCTTGT.TGATGACAG	TAGCCTTGT.TGATGACAG
TAGCGAGAA.ACTGTGTCA	TAGCGAGAA.ACTGTGTCA
TAGCGAGAA.TTCGGAGTC	TAGCGAGAA.TTCGGAGTC
TAGCGCAGC.ATCAAGAGA	TAGCGCAGC.ATCAAGAGA
TAGCGCAGC.GATGTTACA	TAGCGCAGC.GATGTTACA
TAGCGCAGC.TGGTTATAC	TAGCGCAGC.TGGTTATAC
TAGCGCAGC.TTACGCTCG	TAGCGCAGC.TTACGCTCG
TAGCGCAGC.TTCAGTGCC	TAGCGCAGC.TTCAGTGCC
TAGCGCAGC.TTCCTGCTA	TAGCGCAGC.TTCCTGCTA
TAGCGCAGC.TTCGGAGTC	TAGCGCAGC.TTCGGAGTC
TAGCTAAGA.GCGAAGACA	TAGCTAAGA.GCGAAGACA
TAGCTGTTG.CGCAATCGA	TAGCTGTTG.CGCAATCGA
TAGCTGTTG.CTCCAGCGT	TAGCTGTTG.CTCCAGCGT
TAGCTGTTG.TAGACACGT	TAGCTGTTG.TAGACACGT
TAGGAGCTA.GGTGCGTAG	TAGGAGCTA.GGTGCGTAG
TAGGAGGAT.GCAACCAAC	TAGGAGGAT.GCAACCAAC
TAGGAGGAT.GCACAACTC	TAGGAGGAT.GCACAACTC
TAGGATGCC.CACGCGTAA	TAGGATGCC.CACGCGTAA
TAGGATGCC.GAAGTGTGA	TAGGATGCC.GAAGTGTGA
TAGGATTAG.AACAATGCA	TAGGATTAG.AACAATGCA
TAGGATTAG.CACATGTGC	TAGGATTAG.CACATGTGC
TAGGATTAG.GAGCACATT	TAGGATTAG.GAGCACATT
TAGGATTAG.GGTAACTAC	TAGGATTAG.GGTAACTAC
TAGGATTAG.GTCAAGATC	TAGGATTAG.GTCAAGATC
TAGGATTAG.TAAGGTCCG	TAGGATTAG.TAAGGTCCG
TAGGATTAG.TCGGATGTT	TAGGATTAG.TCGGATGTT
TAGGTCAAC.ACTATTGTC	TAGGTCAAC.ACTATTGTC
TAGGTCAAC.TATGAGACC	TAGGTCAAC.TATGAGACC
TAGGTTAGT.CACGTCATA	TAGGTTAGT.CACGTCATA
TAGGTTAGT.CCTAGCAAT	TAGGTTAGT.CCTAGCAAT
TAGTAACGG.AAGTTGCCA	TAGTAACGG.AAGTTGCCA
TAGTAACGG.AGTAGAGGA	TAGTAACGG.AGTAGAGGA
TAGTAACGG.ATGAGATCC	TAGTAACGG.ATGAGATCC
TAGTAACGG.CACTGCTTA	TAGTAACGG.CACTGCTTA
TAGTAACGG.CCGCAACAC	TAGTAACGG.CCGCAACAC
TAGTAACGG.GCGCTCTAT	TAGTAACGG.GCGCTCTAT
TAGTAACGG.TATGTATGC	TAGTAACGG.TATGTATGC
TAGTAACGG.TCAGGTGCA	TAGTAACGG.TCAGGTGCA
TAGTAACGG.TCCTGTGGA	TAGTAACGG.TCCTGTGGA
TAGTAACGG.TGCACGATG	TAGTAACGG.TGCACGATG
TAGTACGTA.CATGGTTAC	TAGTACGTA.CATGGTTAC
TAGTACGTA.CGTACATCT	TAGTACGTA.CGTACATCT
TAGTAGTCT.CGTCTGCTG	TAGTAGTCT.CGTCTGCTG
TAGTAGTCT.GTGCTCTTG	TAGTAGTCT.GTGCTCTTG
TAGTCAGAC.ACGCGTGAC	TAGTCAGAC.ACGCGTGAC
TAGTCAGAC.ATCATTACG	TAGTCAGAC.ATCATTACG
TAGTCAGAC.ATCGTAGTG	TAGTCAGAC.ATCGTAGTG
TAGTCAGAC.CGGTAGCTT	TAGTCAGAC.CGGTAGCTT
TAGTCAGAC.CTCGACGAT	TAGTCAGAC.CTCGACGAT
TAGTCAGAC.GCTGGTAAC	TAGTCAGAC.GCTGGTAAC
TAGTCAGAC.GGACTATTC	TAGTCAGAC.GGACTATTC
TAGTCAGAC.GTCCACAAC	TAGTCAGAC.GTCCACAAC
TAGTCAGAC.TAGATAGCC	TAGTCAGAC.TAGATAGCC
TAGTCGCAT.GTCTACCAA	TAGTCGCAT.GTCTACCAA
TAGTCGCAT.TCATATCGC	TAGTCGCAT.TCATATCGC
TAGTGATCC.AGGAGCAAT	TAGTGATCC.AGGAGCAAT
TAGTGATCC.GTACTCTAC	TAGTGATCC.GTACTCTAC
TAGTGATCC.TTCACTCCT	TAGTGATCC.TTCACTCCT
TAGTGCACT.AAGTACAGA	TAGTGCACT.AAGTACAGA
TAGTGCACT.ATTCGAAGA	TAGTGCACT.ATTCGAAGA
TAGTGCACT.CTTGATCTA	TAGTGCACT.CTTGATCTA
TAGTGCACT.GCTAGCTCC	TAGTGCACT.GCTAGCTCC
TAGTTGACG.CTCTGTCAA	TAGTTGACG.CTCTGTCAA
TAGTTGACG.GTGACGTAA	TAGTTGACG.GTGACGTAA
TAGTTGACG.TAGCACTAT	TAGTTGACG.TAGCACTAT
TATAATCGC.AGTCGTCCG	TATAATCGC.AGTCGTCCG
TATAATCGC.CCGATCTCT	TATAATCGC.CCGATCTCT
TATAATCGC.TGCGCACTG	TATAATCGC.TGCGCACTG
TATACCACT.ACTGACTAC	TATACCACT.ACTGACTAC
TATACCACT.AGGAAGGTG	TATACCACT.AGGAAGGTG
TATACCACT.CAGTACATC	TATACCACT.CAGTACATC
TATACCACT.GAGTCTTCG	TATACCACT.GAGTCTTCG
TATACCACT.TAGGATTAG	TATACCACT.TAGGATTAG
TATACGGAT.ACTTGATCT	TATACGGAT.ACTTGATCT
TATACGGAT.CATCCACCG	TATACGGAT.CATCCACCG
TATACGGAT.GACAATGTT	TATACGGAT.GACAATGTT
TATACGGAT.GTACCACAA	TATACGGAT.GTACCACAA
TATACGGAT.TCAGAGTCA	TATACGGAT.TCAGAGTCA
TATACGTGG.AGCTATATG	TATACGTGG.AGCTATATG
TATAGTGCG.CCGTCAGGT	TATAGTGCG.CCGTCAGGT
TATCACCTG.TGCATCGGA	TATCACCTG.TGCATCGGA
TATCAGTGC.AACGATGAC	TATCAGTGC.AACGATGAC
TATCAGTGC.AGTTACAAG	TATCAGTGC.AGTTACAAG
TATCAGTGC.ATTCCTACG	TATCAGTGC.ATTCCTACG
TATCAGTGC.GGAAGTATG	TATCAGTGC.GGAAGTATG
TATCAGTGC.TTCCATACC	TATCAGTGC.TTCCATACC
