ACGCTCTTA.AGACTTCGT	ACGCTCTTA.AGACTTCGT
ACGCTCTTA.CATGTGAAC	ACGCTCTTA.CATGTGAAC
ACGCTCTTA.TGCGTAATC	ACGCTCTTA.TGCGTAATC
ACGGACCAT.CTGCGTCAC	ACGGACCAT.CTGCGTCAC
ACGGTGCCT.AGTCTGGAA	ACGGTGCCT.AGTCTGGAA
ACGGTGCCT.ATCAGAAGC	ACGGTGCCT.ATCAGAAGC
ACGGTGCCT.GCCGAGTCT	ACGGTGCCT.GCCGAGTCT
ACGGTGCCT.GGATCGTTC	ACGGTGCCT.GGATCGTTC
ACGGTGCCT.GTCGTCGAC	ACGGTGCCT.GTCGTCGAC
ACGGTGTAC.ACCTCCTAG	ACGGTGTAC.ACCTCCTAG
ACGGTGTAC.CAATCATAC	ACGGTGTAC.CAATCATAC
ACGGTGTAC.GCGTAACAA	ACGGTGTAC.GCGTAACAA
ACGTACTGC.GGTAGTGTT	ACGTACTGC.GGTAGTGTT
ACGTAGTAT.CATCGAAGC	ACGTAGTAT.CATCGAAGC
ACGTAGTAT.CTATGGATG	ACGTAGTAT.CTATGGATG
ACGTAGTAT.CTCTCGATA	ACGTAGTAT.CTCTCGATA
ACGTATGTC.AAGCACAAC	ACGTATGTC.AAGCACAAC
ACGTATGTC.TCGACGTTG	ACGTATGTC.TCGACGTTG
ACGTCGCTC.CCTCATAAC	ACGTCGCTC.CCTCATAAC
ACGTCGCTC.TAAGTACAC	ACGTCGCTC.TAAGTACAC
ACGTCTATG.ACACAGAAC	ACGTCTATG.ACACAGAAC
ACGTCTATG.ACGAATCGC	ACGTCTATG.ACGAATCGC
ACGTCTATG.GCCGAACCA	ACGTCTATG.GCCGAACCA
ACGTCTATG.TGCCGACTA	ACGTCTATG.TGCCGACTA
ACGTGAATC.AAGTACAGA	ACGTGAATC.AAGTACAGA
ACGTGAATC.ACTCTGCTC	ACGTGAATC.ACTCTGCTC
ACGTGAATC.CATAAGATC	ACGTGAATC.CATAAGATC
ACGTGAATC.CCTAAGAAG	ACGTGAATC.CCTAAGAAG
ACGTGAATC.GCCACATGG	ACGTGAATC.GCCACATGG
ACGTGCTCG.CGCCTGCAA	ACGTGCTCG.CGCCTGCAA
ACGTGTAGT.GCCGTCTTC	ACGTGTAGT.GCCGTCTTC
ACGTGTAGT.TGTGGACAA	ACGTGTAGT.TGTGGACAA
ACGTTCAAT.AACGAGGTG	ACGTTCAAT.AACGAGGTG
ACGTTCAAT.ATTGGTTCC	ACGTTCAAT.ATTGGTTCC
ACGTTCAAT.GACACGCAA	ACGTTCAAT.GACACGCAA
ACTAACCGA.AATATCGCT	ACTAACCGA.AATATCGCT
ACTAACCGA.CGCACTCTT	ACTAACCGA.CGCACTCTT
ACTAACCGA.TAAGTGTAG	ACTAACCGA.TAAGTGTAG
ACTAAGTTC.ACCAGCGTT	ACTAAGTTC.ACCAGCGTT
ACTAAGTTC.CCTAGCAAT	ACTAAGTTC.CCTAGCAAT
ACTAAGTTC.GCCTGCATC	ACTAAGTTC.GCCTGCATC
ACTAAGTTC.GGTAACTAC	ACTAAGTTC.GGTAACTAC
ACTAAGTTC.TACGTTACC	ACTAAGTTC.TACGTTACC
ACTACCATC.AAGGAACAG	ACTACCATC.AAGGAACAG
ACTACCATC.AGTCCGTGT	ACTACCATC.AGTCCGTGT
ACTACCATC.CTGATGCAC	ACTACCATC.CTGATGCAC
ACTACTCAT.CCTTCGAGC	ACTACTCAT.CCTTCGAGC
ACTATCCTG.GCTGTTCGG	ACTATCCTG.GCTGTTCGG
ACTATCCTG.TCAAGGAGT	ACTATCCTG.TCAAGGAGT
ACTATCCTG.TCAGACAAG	ACTATCCTG.TCAGACAAG
ACTATCCTG.TTGTCAACC	ACTATCCTG.TTGTCAACC
ACTATTGTC.AACGGTAGC	ACTATTGTC.AACGGTAGC
ACTATTGTC.AGTAATCAG	ACTATTGTC.AGTAATCAG
ACTATTGTC.TCTTAAGTG	ACTATTGTC.TCTTAAGTG
ACTCACGAA.ATAGTCAGT	ACTCACGAA.ATAGTCAGT
ACTCACGAA.TGGTTATAC	ACTCACGAA.TGGTTATAC
ACTCATTCA.CAATCTCCG	ACTCATTCA.CAATCTCCG
ACTCATTCA.CGGTTGCGA	ACTCATTCA.CGGTTGCGA
ACTCATTCA.GGAGCTCAA	ACTCATTCA.GGAGCTCAA
ACTCATTCA.TGGTCGCTA	ACTCATTCA.TGGTCGCTA
ACTCCAACT.ACAAGAATG	ACTCCAACT.ACAAGAATG
ACTCCAACT.ACAGCGTAT	ACTCCAACT.ACAGCGTAT
ACTCCAACT.CGTTACACC	ACTCCAACT.CGTTACACC
ACTCCAACT.GACACCGAT	ACTCCAACT.GACACCGAT
ACTCCAACT.TAGCCAGTG	ACTCCAACT.TAGCCAGTG
ACTCCGGTT.ACAGCGTAT	ACTCCGGTT.ACAGCGTAT
ACTCCGGTT.CTCATGCCA	ACTCCGGTT.CTCATGCCA
ACTCCGTCG.ACTAACCGA	ACTCCGTCG.ACTAACCGA
ACTCCGTCG.CTCGTGTCC	ACTCCGTCG.CTCGTGTCC
ACTCCGTCG.CTCTGCAAG	ACTCCGTCG.CTCTGCAAG
ACTCCGTCG.TAATGTAGC	ACTCCGTCG.TAATGTAGC
ACTCGAGTC.CCATATCTT	ACTCGAGTC.CCATATCTT
ACTCGAGTC.GGAAGTATG	ACTCGAGTC.GGAAGTATG
ACTCGCTGT.AACGCCTAC	ACTCGCTGT.AACGCCTAC
ACTCGCTGT.ATGCGCTAC	ACTCGCTGT.ATGCGCTAC
ACTCGCTGT.CGCAGTGTC	ACTCGCTGT.CGCAGTGTC
ACTCGTAGG.AAGCAACTA	ACTCGTAGG.AAGCAACTA
ACTCGTAGG.GACCGCTTC	ACTCGTAGG.GACCGCTTC
ACTCGTAGG.GCTCTGTGT	ACTCGTAGG.GCTCTGTGT
ACTCGTAGG.TGAACGGTT	ACTCGTAGG.TGAACGGTT
ACTCGTCTA.ATTCATGTG	ACTCGTCTA.ATTCATGTG
ACTCGTCTA.CACTCACTA	ACTCGTCTA.CACTCACTA
ACTCGTCTA.CCAGATCAC	ACTCGTCTA.CCAGATCAC
ACTCGTCTA.CTCTCAGTC	ACTCGTCTA.CTCTCAGTC
ACTCGTCTA.TGATCTCGG	ACTCGTCTA.TGATCTCGG
ACTCTAGGA.ACCGAGACA	ACTCTAGGA.ACCGAGACA
ACTCTAGGA.ACCTTGAAG	ACTCTAGGA.ACCTTGAAG
ACTCTAGGA.CAGCTGGAG	ACTCTAGGA.CAGCTGGAG
ACTCTAGGA.CTACCTGCG	ACTCTAGGA.CTACCTGCG
ACTCTAGGA.GTTCACTCC	ACTCTAGGA.GTTCACTCC
ACTCTAGGA.TCATCTGTC	ACTCTAGGA.TCATCTGTC
ACTCTAGGA.TTCCTTGAC	ACTCTAGGA.TTCCTTGAC
ACTCTCACA.CTTCTGAGT	ACTCTCACA.CTTCTGAGT
ACTCTCACA.TAACCGTGA	ACTCTCACA.TAACCGTGA
ACTCTGCTC.AAGGAACAG	ACTCTGCTC.AAGGAACAG
ACTCTGCTC.CAGATCATT	ACTCTGCTC.CAGATCATT
ACTCTGCTC.CCATATGCC	ACTCTGCTC.CCATATGCC
ACTCTGCTC.CCTCAGGTG	ACTCTGCTC.CCTCAGGTG
ACTCTGCTC.CGCACTCTT	ACTCTGCTC.CGCACTCTT
ACTCTGCTC.GGTCGGTCT	ACTCTGCTC.GGTCGGTCT
ACTCTGCTC.GTGATGTGC	ACTCTGCTC.GTGATGTGC
ACTGACTAC.CAACCTGGT	ACTGACTAC.CAACCTGGT
ACTGACTAC.GACAATGTT	ACTGACTAC.GACAATGTT
ACTGACTAC.GATTCCTCT	ACTGACTAC.GATTCCTCT
ACTGCTAGT.TCGGTATCA	ACTGCTAGT.TCGGTATCA
ACTGGACCA.AATGCCTCA	ACTGGACCA.AATGCCTCA
ACTGGACCA.AGGTCACGT	ACTGGACCA.AGGTCACGT
ACTGGTCAG.AATTGGATC	ACTGGTCAG.AATTGGATC
ACTGGTCAG.GGAGCATCT	ACTGGTCAG.GGAGCATCT
ACTGGTGCT.CGTCTGTCC	ACTGGTGCT.CGTCTGTCC
ACTGGTGCT.CTGGACACT	ACTGGTGCT.CTGGACACT
ACTGGTGCT.GAGTCTTCG	ACTGGTGCT.GAGTCTTCG
ACTGGTGCT.GGTCCTGGT	ACTGGTGCT.GGTCCTGGT
ACTGTAATC.GATTATGCG	ACTGTAATC.GATTATGCG
ACTGTAATC.GTATCGTCG	ACTGTAATC.GTATCGTCG
ACTGTGTCA.CAGTACATC	ACTGTGTCA.CAGTACATC
ACTGTGTCA.CTGCAGAGC	ACTGTGTCA.CTGCAGAGC
ACTTAGCTT.TATGTACCT	ACTTAGCTT.TATGTACCT
ACTTCAGTA.ACATGGATT	ACTTCAGTA.ACATGGATT
ACTTCAGTA.GGACAGATT	ACTTCAGTA.GGACAGATT
ACTTCAGTA.GTTCACTCC	ACTTCAGTA.GTTCACTCC
ACTTCAGTA.TCGAATAGA	ACTTCAGTA.TCGAATAGA
ACTTCTAAC.ACACTAACG	ACTTCTAAC.ACACTAACG
ACTTCTAAC.TGAGACAGC	ACTTCTAAC.TGAGACAGC
ACTTCTTGG.GCTAGTGGA	ACTTCTTGG.GCTAGTGGA
ACTTCTTGG.TCTAGTGAC	ACTTCTTGG.TCTAGTGAC
ACTTGATCT.CGTGACCAG	ACTTGATCT.CGTGACCAG
ACTTGATCT.GGTCGGTCT	ACTTGATCT.GGTCGGTCT
AGAAGAGTC.AATACGTCT	AGAAGAGTC.AATACGTCT
AGAAGAGTC.AGCGACACC	AGAAGAGTC.AGCGACACC
AGAAGAGTC.CCACATTAG	AGAAGAGTC.CCACATTAG
AGAAGAGTC.CTGGTAATC	AGAAGAGTC.CTGGTAATC
AGAAGAGTC.CTGTACGAC	AGAAGAGTC.CTGTACGAC
AGAAGAGTC.GTACGAACG	AGAAGAGTC.GTACGAACG
AGAAGAGTC.TGCGTAATC	AGAAGAGTC.TGCGTAATC
AGAAGCTGC.AGATCGAGT	AGAAGCTGC.AGATCGAGT
AGAAGCTGC.ATAGTCAGT	AGAAGCTGC.ATAGTCAGT
AGAAGCTGC.TATGACCGA	AGAAGCTGC.TATGACCGA
AGAAGTAAC.ACCGTCACG	AGAAGTAAC.ACCGTCACG
AGAAGTAAC.CGAACAGAG	AGAAGTAAC.CGAACAGAG
AGAAGTAAC.TCCTCGTCG	AGAAGTAAC.TCCTCGTCG
AGAAGTCCT.AGATCGAGT	AGAAGTCCT.AGATCGAGT
AGAAGTCCT.AGTACTCTC	AGAAGTCCT.AGTACTCTC
AGAAGTCCT.CGCTTCACG	AGAAGTCCT.CGCTTCACG
AGAAGTCCT.CTTGCGACC	AGAAGTCCT.CTTGCGACC
AGAAGTCCT.GAGCAGGAA	AGAAGTCCT.GAGCAGGAA
AGAAGTCCT.GATCGCACT	AGAAGTCCT.GATCGCACT
AGAATCAGA.ACGCTCTTA	AGAATCAGA.ACGCTCTTA
AGAATCAGA.GCAACCAAC	AGAATCAGA.GCAACCAAC
AGAATCAGA.GCATGTGGT	AGAATCAGA.GCATGTGGT
AGACATATC.CATCCTCTC	AGACATATC.CATCCTCTC
AGACATATC.GGTCCTAAG	AGACATATC.GGTCCTAAG
AGACATATC.GTCTTCTCG	AGACATATC.GTCTTCTCG
AGACATCCA.AATCAGGAG	AGACATCCA.AATCAGGAG
AGACATCCA.CATAGAGAT	AGACATCCA.CATAGAGAT
AGACATCCA.GTAACCATA	AGACATCCA.GTAACCATA
AGACCACGC.AATCAGGAG	AGACCACGC.AATCAGGAG
AGACCACGC.ACAATTCGG	AGACCACGC.ACAATTCGG
AGACCACGC.ACTGCTAGT	AGACCACGC.ACTGCTAGT
AGACCACGC.GGACGAGCA	AGACCACGC.GGACGAGCA
AGACCACGC.GTCAATACA	AGACCACGC.GTCAATACA
AGACCACGC.GTCTTCATA	AGACCACGC.GTCTTCATA
AGACCAGCT.GCCTAACGG	AGACCAGCT.GCCTAACGG
AGACCAGCT.GGTGAGCGT	AGACCAGCT.GGTGAGCGT
AGACGCTAT.AGTTGCCTT	AGACGCTAT.AGTTGCCTT
AGACGCTAT.CAAGAACCG	AGACGCTAT.CAAGAACCG
AGACGCTAT.CCTGCTCCA	AGACGCTAT.CCTGCTCCA
AGACGCTAT.CGCAATCGA	AGACGCTAT.CGCAATCGA
AGACGCTAT.TCGTCCGAT	AGACGCTAT.TCGTCCGAT
AGACGCTAT.TGAGTTAAG	AGACGCTAT.TGAGTTAAG
AGACGCTAT.TGGAGAGTG	AGACGCTAT.TGGAGAGTG
AGACGGAGG.CAACGATCG	AGACGGAGG.CAACGATCG
AGACGGAGG.CAGTCCTAA	AGACGGAGG.CAGTCCTAA
AGACGGAGG.CCTTATCCG	AGACGGAGG.CCTTATCCG
AGACGGAGG.CGGTTCGTA	AGACGGAGG.CGGTTCGTA
AGACGGAGG.GAGTTATAG	AGACGGAGG.GAGTTATAG
AGACGGAGG.GCCGAACCA	AGACGGAGG.GCCGAACCA
AGACGGAGG.GGAACTGCT	AGACGGAGG.GGAACTGCT
AGACGGAGG.GTGCTCTTG	AGACGGAGG.GTGCTCTTG
AGACGGAGG.GTTACTACT	AGACGGAGG.GTTACTACT
AGACGGAGG.TGATAGAGG	AGACGGAGG.TGATAGAGG
AGACTAGTA.AACAACTGG	AGACTAGTA.AACAACTGG
AGACTAGTA.ATATGCAGC	AGACTAGTA.ATATGCAGC
AGACTTCGT.CTGGACTAA	AGACTTCGT.CTGGACTAA
AGACTTCGT.TAACCGTGA	AGACTTCGT.TAACCGTGA
AGACTTCGT.TATGGTTGG	AGACTTCGT.TATGGTTGG
AGACTTCGT.TTCCGAGCG	AGACTTCGT.TTCCGAGCG
AGAGAGTGG.ATACGAGGT	AGAGAGTGG.ATACGAGGT
AGAGAGTGG.CCTCTGCAT	AGAGAGTGG.CCTCTGCAT
AGAGAGTGG.CGTCTGCTG	AGAGAGTGG.CGTCTGCTG
AGAGAGTGG.CTGCATGTT	AGAGAGTGG.CTGCATGTT
AGAGAGTGG.CTTGGATCA	AGAGAGTGG.CTTGGATCA
AGAGAGTGG.TCTACATCC	AGAGAGTGG.TCTACATCC
AGAGCCGCA.AACAACCTA	AGAGCCGCA.AACAACCTA
AGAGCCGCA.AGGAAGGTG	AGAGCCGCA.AGGAAGGTG
AGAGCCGCA.ATCGAATCG	AGAGCCGCA.ATCGAATCG
AGAGCCGCA.GCTAGCTCC	AGAGCCGCA.GCTAGCTCC
AGAGCCGCA.GTAGAGAGC	AGAGCCGCA.GTAGAGAGC
AGAGCGCGA.GACTCTGGT	AGAGCGCGA.GACTCTGGT
AGAGCGGAG.GTGTCTGGA	AGAGCGGAG.GTGTCTGGA
AGAGCGGAG.TTGATGAGT	AGAGCGGAG.TTGATGAGT
AGAGGACGT.ACACACCGT	AGAGGACGT.ACACACCGT
AGAGGACGT.CAATCAAGT	AGAGGACGT.CAATCAAGT
AGAGGACGT.CACGGAAGT	AGAGGACGT.CACGGAAGT
AGAGGACGT.CATTATGTC	AGAGGACGT.CATTATGTC
AGAGGACGT.GATTGGAAG	AGAGGACGT.GATTGGAAG
AGAGGACGT.GTCGTCGAC	AGAGGACGT.GTCGTCGAC
AGAGGTGAA.CAGCTAGTT	AGAGGTGAA.CAGCTAGTT
AGAGGTGAA.GCCAACAAT	AGAGGTGAA.GCCAACAAT
AGAGGTGAA.TACGACTTG	AGAGGTGAA.TACGACTTG
AGATACGTT.ATGACACAA	AGATACGTT.ATGACACAA
AGATACGTT.CGAAGAGGT	AGATACGTT.CGAAGAGGT
AGATACGTT.CTTCTCATC	AGATACGTT.CTTCTCATC
AGATACGTT.GGTGTGACC	AGATACGTT.GGTGTGACC
AGATATGGA.ATGCCTTCA	AGATATGGA.ATGCCTTCA
AGATCGAGT.CCTGTATCT	AGATCGAGT.CCTGTATCT
AGATCGAGT.CTGACAGCA	AGATCGAGT.CTGACAGCA
AGATCGAGT.CTTCTCATC	AGATCGAGT.CTTCTCATC
AGATCGAGT.TCCTTCAAC	AGATCGAGT.TCCTTCAAC
AGATCGAGT.TGATACCGT	AGATCGAGT.TGATACCGT
AGATCGAGT.TGCCATCTC	AGATCGAGT.TGCCATCTC
AGATCGAGT.TGTCAACCT	AGATCGAGT.TGTCAACCT
AGATCTGAC.AAGCAGCAT	AGATCTGAC.AAGCAGCAT
AGATCTGAC.ACAACCGGA	AGATCTGAC.ACAACCGGA
AGATCTGAC.ATCAGGATG	AGATCTGAC.ATCAGGATG
AGATCTGAC.CGTGTGTGG	AGATCTGAC.CGTGTGTGG
AGATCTTCA.ATACTTGCT	AGATCTTCA.ATACTTGCT
AGATCTTCA.CCTCATAAC	AGATCTTCA.CCTCATAAC
AGATCTTCA.CGTAATGAC	AGATCTTCA.CGTAATGAC
AGATCTTCA.GATCTACTT	AGATCTTCA.GATCTACTT
AGATCTTCA.TGAGTTAAG	AGATCTTCA.TGAGTTAAG
AGATGAAGA.GCGCTACCT	AGATGAAGA.GCGCTACCT
AGATGAAGA.TTCGTGATG	AGATGAAGA.TTCGTGATG
AGATGAGAT.AGTTAGGTC	AGATGAGAT.AGTTAGGTC
AGATGAGAT.GCGACCTGT	AGATGAGAT.GCGACCTGT
AGATGAGAT.TGTGCCATG	AGATGAGAT.TGTGCCATG
AGATGTTGG.ACTCGTAGG	AGATGTTGG.ACTCGTAGG
AGATGTTGG.CTTCCGTGG	AGATGTTGG.CTTCCGTGG
AGATGTTGG.GCTTGTCCT	AGATGTTGG.GCTTGTCCT
AGATGTTGG.TACGGTCGT	AGATGTTGG.TACGGTCGT
AGCAACATT.AGGTCAGCA	AGCAACATT.AGGTCAGCA
AGCAAGTCC.AACAGATCG	AGCAAGTCC.AACAGATCG
AGCAAGTCC.AACTTCTGC	AGCAAGTCC.AACTTCTGC
AGCAAGTCC.ATACTTGCT	AGCAAGTCC.ATACTTGCT
AGCAAGTCC.CGCTTATGA	AGCAAGTCC.CGCTTATGA
AGCAAGTCC.GAACATGAC	AGCAAGTCC.GAACATGAC
AGCAAGTCC.GTGACGTAA	AGCAAGTCC.GTGACGTAA
AGCAAGTCC.TCAATCTAG	AGCAAGTCC.TCAATCTAG
AGCAAGTCC.TCCATCATT	AGCAAGTCC.TCCATCATT
AGCAAGTCC.TTAGGAAGG	AGCAAGTCC.TTAGGAAGG
AGCACACCT.ATGCTCACC	AGCACACCT.ATGCTCACC
AGCACACCT.CACATTCTG	AGCACACCT.CACATTCTG
AGCACACCT.CTGAGTCCA	AGCACACCT.CTGAGTCCA
AGCACACCT.GACTGCGCA	AGCACACCT.GACTGCGCA
AGCACACCT.GTCAGCGTC	AGCACACCT.GTCAGCGTC
AGCACACCT.TCCACGTGC	AGCACACCT.TCCACGTGC
AGCACCAGC.AAGGTCTGA	AGCACCAGC.AAGGTCTGA
AGCACCAGC.AGTGAACGG	AGCACCAGC.AGTGAACGG
AGCACCAGC.CAGTTACTG	AGCACCAGC.CAGTTACTG
AGCACCAGC.TCAAGGTCG	AGCACCAGC.TCAAGGTCG
AGCACCGTG.AAGGAACAG	AGCACCGTG.AAGGAACAG
AGCACCGTG.TACGTTGGA	AGCACCGTG.TACGTTGGA
AGCACCGTG.TCAGTGCAA	AGCACCGTG.TCAGTGCAA
AGCACCGTG.TGCATACAT	AGCACCGTG.TGCATACAT
AGCACCGTG.TTCCAGATT	AGCACCGTG.TTCCAGATT
AGCAGACAA.ACGACATCT	AGCAGACAA.ACGACATCT
AGCAGACAA.CATGGTTAC	AGCAGACAA.CATGGTTAC
AGCAGACAA.CATTCGAAT	AGCAGACAA.CATTCGAAT
AGCAGACAA.CCATAGCCA	AGCAGACAA.CCATAGCCA
AGCAGACAA.TTGTTAGAG	AGCAGACAA.TTGTTAGAG
AGCATATGG.CACGTCATA	AGCATATGG.CACGTCATA
AGCATATGG.GTGTCGAGC	AGCATATGG.GTGTCGAGC
AGCATATGG.TGTACACGA	AGCATATGG.TGTACACGA
AGCATTCCA.ACCGTACGC	AGCATTCCA.ACCGTACGC
AGCATTCCA.AGATATGGA	AGCATTCCA.AGATATGGA
AGCATTCCA.GCGTAACAA	AGCATTCCA.GCGTAACAA
AGCATTCCA.TGTTACTGA	AGCATTCCA.TGTTACTGA
AGCATTCCA.TTATCGCAC	AGCATTCCA.TTATCGCAC
AGCATTGTT.ACGGTGCCT	AGCATTGTT.ACGGTGCCT
AGCATTGTT.ATCGCCTCT	AGCATTGTT.ATCGCCTCT
AGCATTGTT.GACGGTGCT	AGCATTGTT.GACGGTGCT
AGCCACTTC.GTCAAGATC	AGCCACTTC.GTCAAGATC
AGCCACTTC.TAATCACGC	AGCCACTTC.TAATCACGC
AGCCAGGAC.AGGAATTGG	AGCCAGGAC.AGGAATTGG
AGCCAGGAC.CGTATAGCG	AGCCAGGAC.CGTATAGCG
AGCCAGGAC.GATTAGTGT	AGCCAGGAC.GATTAGTGT
AGCCAGGAC.GTTCACTCC	AGCCAGGAC.GTTCACTCC
AGCCAGGAC.TGATGTGTG	AGCCAGGAC.TGATGTGTG
AGCCGGATC.CACAATAAC	AGCCGGATC.CACAATAAC
AGCCGGATC.CACGCGTAA	AGCCGGATC.CACGCGTAA
AGCCGGATC.CTATTCCGT	AGCCGGATC.CTATTCCGT
AGCCGGATC.GCTGTTCGG	AGCCGGATC.GCTGTTCGG
AGCCGGATC.GGAATTGGA	AGCCGGATC.GGAATTGGA
AGCCGTTCT.CCAATGCCT	AGCCGTTCT.CCAATGCCT
AGCCGTTCT.GTCGTCGAC	AGCCGTTCT.GTCGTCGAC
AGCCGTTCT.GTTAATTCG	AGCCGTTCT.GTTAATTCG
AGCCGTTCT.TGCCATCTC	AGCCGTTCT.TGCCATCTC
AGCCGTTCT.TGGACTGCC	AGCCGTTCT.TGGACTGCC
AGCCTCGCA.CCGAAGCGT	AGCCTCGCA.CCGAAGCGT
AGCCTCGCA.CGGAGACTT	AGCCTCGCA.CGGAGACTT
AGCCTCGCA.CTGTACGAC	AGCCTCGCA.CTGTACGAC
AGCCTCTAG.CAGAGCACC	AGCCTCTAG.CAGAGCACC
AGCCTCTAG.CAGTCTAAC	AGCCTCTAG.CAGTCTAAC
AGCCTCTAG.GGAATTCAC	AGCCTCTAG.GGAATTCAC
AGCGACACC.AGGATCTCA	AGCGACACC.AGGATCTCA
AGCGACACC.ATTAGCGGT	AGCGACACC.ATTAGCGGT
AGCGACACC.GTATACAGA	AGCGACACC.GTATACAGA
AGCGACACC.GTCAGACCG	AGCGACACC.GTCAGACCG
AGCGACACC.TGCGTAATC	AGCGACACC.TGCGTAATC
AGCGCATGA.AACGTTCTT	AGCGCATGA.AACGTTCTT
AGCGCATGA.CAGGATCAA	AGCGCATGA.CAGGATCAA
AGCGCATGA.GAACGCTGT	AGCGCATGA.GAACGCTGT
AGCGGAACA.AACACACTC	AGCGGAACA.AACACACTC
AGCGGAACA.TAGGATGCC	AGCGGAACA.TAGGATGCC
AGCGGTAAG.AGGAATTGG	AGCGGTAAG.AGGAATTGG
AGCGGTAAG.ATGGATATC	AGCGGTAAG.ATGGATATC
AGCGGTAAG.CATAATTGG	AGCGGTAAG.CATAATTGG
AGCGGTAAG.TGTGCCATG	AGCGGTAAG.TGTGCCATG
AGCGGTCTA.CCTCTTGTA	AGCGGTCTA.CCTCTTGTA
AGCGGTCTA.CGTTCCATT	AGCGGTCTA.CGTTCCATT
AGCGGTCTA.GAGCCATCC	AGCGGTCTA.GAGCCATCC
AGCGGTCTA.TGAGAGGAC	AGCGGTCTA.TGAGAGGAC
AGCGTAGAA.CGTGTCCGA	AGCGTAGAA.CGTGTCCGA
AGCGTAGAA.TCGCTGTAA	AGCGTAGAA.TCGCTGTAA
AGCGTCGTC.CACACCACA	AGCGTCGTC.CACACCACA
AGCGTCGTC.CCATCACGA	AGCGTCGTC.CCATCACGA
AGCGTCGTC.CCGCAGAAT	AGCGTCGTC.CCGCAGAAT
AGCGTCGTC.TAGTCGCAT	AGCGTCGTC.TAGTCGCAT
AGCGTCGTC.TTAAGTGGT	AGCGTCGTC.TTAAGTGGT
AGCTACTCA.AATGCAGCG	AGCTACTCA.AATGCAGCG
AGCTACTCA.CATTCCGAG	AGCTACTCA.CATTCCGAG
AGCTACTCA.CTAGTGCTG	AGCTACTCA.CTAGTGCTG
AGCTACTCA.GTGAACCAC	AGCTACTCA.GTGAACCAC
AGCTACTCA.TGGAACTAA	AGCTACTCA.TGGAACTAA
AGCTACTCA.TGGAGAACC	AGCTACTCA.TGGAGAACC
AGCTATATG.ACGCTAGTG	AGCTATATG.ACGCTAGTG
AGCTATATG.AGAAGCTGC	AGCTATATG.AGAAGCTGC
AGCTCGTCT.CCACTACCA	AGCTCGTCT.CCACTACCA
AGCTCGTCT.CTGTGGTGG	AGCTCGTCT.CTGTGGTGG
AGCTCGTCT.GTTAGAGAC	AGCTCGTCT.GTTAGAGAC
AGCTCTCCG.AGACATCCA	AGCTCTCCG.AGACATCCA
AGCTCTCCG.TCACTCGCT	AGCTCTCCG.TCACTCGCT
AGCTGCACT.CCTTAATTC	AGCTGCACT.CCTTAATTC
AGCTGCACT.CTCTAGTAA	AGCTGCACT.CTCTAGTAA
AGCTGCACT.TAGAGCCAG	AGCTGCACT.TAGAGCCAG
AGCTGCACT.TATTACTCG	AGCTGCACT.TATTACTCG
AGCTGCACT.TGACCTCCT	AGCTGCACT.TGACCTCCT
AGCTGCACT.TTCCAATTC	AGCTGCACT.TTCCAATTC
AGCTTCGAT.CCTTCGAGC	AGCTTCGAT.CCTTCGAGC
AGCTTCGAT.GTTCCAACA	AGCTTCGAT.GTTCCAACA
AGCTTGGTG.CTCGTTCAC	AGCTTGGTG.CTCGTTCAC
AGCTTGGTG.CTGACAGCA	AGCTTGGTG.CTGACAGCA
AGCTTGGTG.GCATGTGGT	AGCTTGGTG.GCATGTGGT
AGGAAGGTG.ACGTGTAGT	AGGAAGGTG.ACGTGTAGT
AGGAAGGTG.ATCGGTGGT	AGGAAGGTG.ATCGGTGGT
AGGAAGGTG.CACGTCATA	AGGAAGGTG.CACGTCATA
AGGAAGGTG.GAGAACAGG	AGGAAGGTG.GAGAACAGG
AGGAAGGTG.TAGCACACG	AGGAAGGTG.TAGCACACG
AGGAAGGTG.TGCTCCTCC	AGGAAGGTG.TGCTCCTCC
AGGAATTGG.CCAGTACTC	AGGAATTGG.CCAGTACTC
AGGAATTGG.CTGCAGAGC	AGGAATTGG.CTGCAGAGC
AGGAATTGG.GCTAGTGGA	AGGAATTGG.GCTAGTGGA
AGGAGCAAT.ATGTGAGAC	AGGAGCAAT.ATGTGAGAC
AGGAGCAAT.GTCCACAAC	AGGAGCAAT.GTCCACAAC
AGGAGCAAT.TAGGATTAG	AGGAGCAAT.TAGGATTAG
AGGAGGTGA.AAGTTGCCA	AGGAGGTGA.AAGTTGCCA
AGGAGGTGA.CAGCTGGAG	AGGAGGTGA.CAGCTGGAG
AGGAGGTGA.CATGACGTT	AGGAGGTGA.CATGACGTT
AGGAGGTGA.GTTAGATTG	AGGAGGTGA.GTTAGATTG
AGGAGGTGA.TCAGGTGCA	AGGAGGTGA.TCAGGTGCA
AGGATCATG.AGGTCAGCA	AGGATCATG.AGGTCAGCA
AGGATCATG.AGTAATGGT	AGGATCATG.AGTAATGGT
AGGATCATG.CACTGTATC	AGGATCATG.CACTGTATC
AGGATCATG.CTTGCACAA	AGGATCATG.CTTGCACAA
AGGATCATG.TATCTGTCA	AGGATCATG.TATCTGTCA
AGGATCATG.TGACAAGTT	AGGATCATG.TGACAAGTT
AGGATCTCA.AAGCTTGCA	AGGATCTCA.AAGCTTGCA
AGGATCTCA.CTCGTTCAC	AGGATCTCA.CTCGTTCAC
AGGATCTCA.TGATTCACC	AGGATCTCA.TGATTCACC
AGGATCTCA.TGCCACCGA	AGGATCTCA.TGCCACCGA
AGGATGCGT.AAGGATCGT	AGGATGCGT.AAGGATCGT
AGGATGCGT.AATGCGTGC	AGGATGCGT.AATGCGTGC
AGGATGCGT.GTATGCCTT	AGGATGCGT.GTATGCCTT
AGGATTACT.ACCATGTCT	AGGATTACT.ACCATGTCT
AGGATTACT.ATGCGTGGA	AGGATTACT.ATGCGTGGA
AGGATTACT.TGCAGCCTT	AGGATTACT.TGCAGCCTT
AGGATTGAG.AAGCAATCG	AGGATTGAG.AAGCAATCG
AGGATTGAG.CAGTAATGT	AGGATTGAG.CAGTAATGT
AGGATTGAG.TCACACTGC	AGGATTGAG.TCACACTGC
AGGATTGAG.TTCATCCAA	AGGATTGAG.TTCATCCAA
AGGTACCAA.AAGCTGGTC	AGGTACCAA.AAGCTGGTC
AGGTACCAA.ATCCGACCA	AGGTACCAA.ATCCGACCA
AGGTACCAA.TTCCAGATT	AGGTACCAA.TTCCAGATT
AGGTATTCC.ATTCCGTAC	AGGTATTCC.ATTCCGTAC
AGGTATTCC.CACGATAGA	AGGTATTCC.CACGATAGA
AGGTATTCC.CTCCACGTC	AGGTATTCC.CTCCACGTC
AGGTCACGT.GCAGCTTGA	AGGTCACGT.GCAGCTTGA
AGGTCAGCA.AAGCATTGC	AGGTCAGCA.AAGCATTGC
AGGTCAGCA.ATGAACTAG	AGGTCAGCA.ATGAACTAG
AGGTCAGCA.CCTCAGGTG	AGGTCAGCA.CCTCAGGTG
AGGTCAGCA.TCTCAGGAT	AGGTCAGCA.TCTCAGGAT
AGGTCAGCA.TTACACCTT	AGGTCAGCA.TTACACCTT
AGGTCCGTC.ATATGTCCA	AGGTCCGTC.ATATGTCCA
AGGTGCGAG.AGAAGTCCT	AGGTGCGAG.AGAAGTCCT
AGGTGCGAG.CGAACAGAG	AGGTGCGAG.CGAACAGAG
AGGTGCGAG.GCTGGTAAC	AGGTGCGAG.GCTGGTAAC
AGGTGTACA.AACGGAGAT	AGGTGTACA.AACGGAGAT
AGGTGTACA.ACCATCTAA	AGGTGTACA.ACCATCTAA
AGGTGTACA.ACGAGAGCA	AGGTGTACA.ACGAGAGCA
AGGTGTACA.CAGCAGTAC	AGGTGTACA.CAGCAGTAC
AGGTGTACA.CCGGTTCTA	AGGTGTACA.CCGGTTCTA
AGTAACGTA.ACTCGCTGT	AGTAACGTA.ACTCGCTGT
AGTAACGTA.ATGTCGCCT	AGTAACGTA.ATGTCGCCT
AGTAACGTA.GAGCACATT	AGTAACGTA.GAGCACATT
AGTAACGTA.GCCGAGTCT	AGTAACGTA.GCCGAGTCT
AGTAACGTA.TGTCGTACA	AGTAACGTA.TGTCGTACA
AGTAAGCCA.CATACGCAG	AGTAAGCCA.CATACGCAG
AGTAAGCCA.CCTGCGTTA	AGTAAGCCA.CCTGCGTTA
AGTAAGCCA.TCTTAGCGA	AGTAAGCCA.TCTTAGCGA
AGTAATCAG.CACGATAGA	AGTAATCAG.CACGATAGA
AGTAATCAG.GTAACGCGA	AGTAATCAG.GTAACGCGA
AGTAATGGT.ATATAGCGT	AGTAATGGT.ATATAGCGT
AGTAATGGT.CGTGACCAG	AGTAATGGT.CGTGACCAG
AGTAATGGT.TGAACTTGC	AGTAATGGT.TGAACTTGC
AGTAATGGT.TTAGCGTCT	AGTAATGGT.TTAGCGTCT
AGTACGAAT.ACGATGACC	AGTACGAAT.ACGATGACC
AGTACGAAT.AGTAACGTA	AGTACGAAT.AGTAACGTA
AGTACGAAT.CCGCTCATG	AGTACGAAT.CCGCTCATG
AGTACGAAT.CCTTATCCG	AGTACGAAT.CCTTATCCG
AGTACGAAT.GACCAACAG	AGTACGAAT.GACCAACAG
AGTACGAAT.GTAACGCGA	AGTACGAAT.GTAACGCGA
AGTACGAAT.TTGTTAGAG	AGTACGAAT.TTGTTAGAG
AGTACTACA.AATGCACTT	AGTACTACA.AATGCACTT
AGTACTACA.ATCTAGGTT	AGTACTACA.ATCTAGGTT
AGTACTACA.ATTCACCTC	AGTACTACA.ATTCACCTC
AGTACTACA.CTACGGTAT	AGTACTACA.CTACGGTAT
AGTACTACA.GCCACATGG	AGTACTACA.GCCACATGG
AGTACTACA.GCGAGTCTA	AGTACTACA.GCGAGTCTA
AGTACTACA.GCTTAGAAC	AGTACTACA.GCTTAGAAC
AGTACTACA.GGTAGACAT	AGTACTACA.GGTAGACAT
AGTACTACA.GTAGCTACA	AGTACTACA.GTAGCTACA
AGTACTCTC.TGCGCACTG	AGTACTCTC.TGCGCACTG
AGTAGAGGA.CAAGAGGAG	AGTAGAGGA.CAAGAGGAG
AGTAGAGGA.GCCATTAAG	AGTAGAGGA.GCCATTAAG
AGTAGAGGA.GGTTCAGAC	AGTAGAGGA.GGTTCAGAC
AGTATGACG.ACTGCTAGT	AGTATGACG.ACTGCTAGT
AGTATGACG.ATAAGTTCG	AGTATGACG.ATAAGTTCG
AGTATGACG.GACTATTGA	AGTATGACG.GACTATTGA
AGTATGACG.GATGTTACA	AGTATGACG.GATGTTACA
AGTATGACG.GTCGTTGCG	AGTATGACG.GTCGTTGCG
AGTCAGTTG.ATATCAGCC	AGTCAGTTG.ATATCAGCC
AGTCAGTTG.GGTGATAGG	AGTCAGTTG.GGTGATAGG
AGTCAGTTG.GTATGCCTT	AGTCAGTTG.GTATGCCTT
AGTCATACT.ACTCCGGTT	AGTCATACT.ACTCCGGTT
AGTCATACT.CACATGTGC	AGTCATACT.CACATGTGC
AGTCATACT.CACTCACTA	AGTCATACT.CACTCACTA
AGTCATACT.CAGAAGTGA	AGTCATACT.CAGAAGTGA
AGTCATACT.CTGGACACT	AGTCATACT.CTGGACACT
AGTCCAGTG.CAAGCCTCG	AGTCCAGTG.CAAGCCTCG
AGTCCAGTG.CCTGCTCCA	AGTCCAGTG.CCTGCTCCA
AGTCCAGTG.TGAACGTCA	AGTCCAGTG.TGAACGTCA
AGTCCAGTG.TGAGATCAT	AGTCCAGTG.TGAGATCAT
AGTCCGTGT.ACCTGCAGA	AGTCCGTGT.ACCTGCAGA
AGTCCGTGT.CCTCAGGTG	AGTCCGTGT.CCTCAGGTG
AGTCCGTGT.TAGCGCAGC	AGTCCGTGT.TAGCGCAGC
AGTCGATCA.ACACAGAAC	AGTCGATCA.ACACAGAAC
AGTCGATCA.CCGATCAGC	AGTCGATCA.CCGATCAGC
AGTCGATCA.CTGTCACTT	AGTCGATCA.CTGTCACTT
AGTCGATCA.GCACGCATT	AGTCGATCA.GCACGCATT
AGTCGATCA.GCAGCTCTT	AGTCGATCA.GCAGCTCTT
AGTCGCCGA.ATTATGCAG	AGTCGCCGA.ATTATGCAG
AGTCGCCGA.CACTAGACT	AGTCGCCGA.CACTAGACT
AGTCGCCGA.GAATCAACC	AGTCGCCGA.GAATCAACC
AGTCGCCGA.TTGTCAACC	AGTCGCCGA.TTGTCAACC
AGTCGCGAC.AGCGTAGAA	AGTCGCGAC.AGCGTAGAA
AGTCGCGAC.CCACAAGGT	AGTCGCGAC.CCACAAGGT
AGTCGCGAC.GGTGAGTTC	AGTCGCGAC.GGTGAGTTC
AGTCGCGAC.GTGAACCAC	AGTCGCGAC.GTGAACCAC
AGTCGCGAC.TGTCTACAC	AGTCGCGAC.TGTCTACAC
AGTCGTCCG.ACGAGCTTC	AGTCGTCCG.ACGAGCTTC
AGTCGTCCG.CCTGCTCCA	AGTCGTCCG.CCTGCTCCA
AGTCGTCCG.CTCAGCTGG	AGTCGTCCG.CTCAGCTGG
AGTCGTCCG.TATCGGAAC	AGTCGTCCG.TATCGGAAC
AGTCTAAGC.TTCCGCCAG	AGTCTAAGC.TTCCGCCAG
AGTCTGGAA.ACTCCAACT	AGTCTGGAA.ACTCCAACT
AGTCTGGAA.TACCTATCC	AGTCTGGAA.TACCTATCC
AGTCTGGAA.TAGCTGTTG	AGTCTGGAA.TAGCTGTTG
AGTGAACGG.CGACCTGTA	AGTGAACGG.CGACCTGTA
AGTGACGAT.AGATATGGA	AGTGACGAT.AGATATGGA
AGTGACGAT.CATTATGTC	AGTGACGAT.CATTATGTC
AGTGAGAGA.ACAAGAATG	AGTGAGAGA.ACAAGAATG
AGTGAGAGA.ATGCGCTAC	AGTGAGAGA.ATGCGCTAC
AGTGAGAGA.CTCAGGTAC	AGTGAGAGA.CTCAGGTAC
AGTGAGAGA.CTTCTATGA	AGTGAGAGA.CTTCTATGA
AGTGAGAGA.GAGTGCATA	AGTGAGAGA.GAGTGCATA
AGTGAGAGA.GTCTTCATA	AGTGAGAGA.GTCTTCATA
AGTGAGAGA.TAGACCATG	AGTGAGAGA.TAGACCATG
AGTGAGAGA.TCCGGAGCT	AGTGAGAGA.TCCGGAGCT
AGTGATGCG.CCACGGATC	AGTGATGCG.CCACGGATC
AGTGGAATG.ACGTGTAGT	AGTGGAATG.ACGTGTAGT
