TTGTAATGC.GATGTCTAG	TTGTAATGC.GATGTCTAG
TTGTAATGC.GATTAGTGT	TTGTAATGC.GATTAGTGT
TTGTATCAC.ATCCGTCTC	TTGTATCAC.ATCCGTCTC
TTGTATCAC.CATCTCGAT	TTGTATCAC.CATCTCGAT
TTGTATCAC.CCACGAAGG	TTGTATCAC.CCACGAAGG
TTGTATCAC.CCATAATCG	TTGTATCAC.CCATAATCG
TTGTATCAC.CGCTTGTAG	TTGTATCAC.CGCTTGTAG
TTGTATCAC.GATGCGACG	TTGTATCAC.GATGCGACG
TTGTATCAC.GTTAGTCAA	TTGTATCAC.GTTAGTCAA
TTGTATCAC.TACTCGACC	TTGTATCAC.TACTCGACC
TTGTCAACC.ACAGCGGTC	TTGTCAACC.ACAGCGGTC
TTGTCAACC.AGAAGTCCT	TTGTCAACC.AGAAGTCCT
TTGTCAACC.CAATCTCCG	TTGTCAACC.CAATCTCCG
TTGTCAACC.CGACAGACC	TTGTCAACC.CGACAGACC
TTGTCAACC.CTCAGGTAC	TTGTCAACC.CTCAGGTAC
TTGTCAACC.CTTCTATGA	TTGTCAACC.CTTCTATGA
TTGTCAACC.GCCTTGTGA	TTGTCAACC.GCCTTGTGA
TTGTCAACC.GTAACAGTC	TTGTCAACC.GTAACAGTC
TTGTTAGAG.ACCTGCAGA	TTGTTAGAG.ACCTGCAGA
TTGTTAGAG.CCAGTCTCA	TTGTTAGAG.CCAGTCTCA
TTGTTAGAG.CCAGTTACG	TTGTTAGAG.CCAGTTACG
