CTACGGTAT.TAGGAGCTA	CTACGGTAT.TAGGAGCTA
CTACGGTAT.TTCGTGATG	CTACGGTAT.TTCGTGATG
CTACGTTGG.CCAGGAGTT	CTACGTTGG.CCAGGAGTT
CTACGTTGG.TGCCGCTAC	CTACGTTGG.TGCCGCTAC
CTACTGTCA.GTCCTAGTT	CTACTGTCA.GTCCTAGTT
CTACTGTCA.GTTACTACT	CTACTGTCA.GTTACTACT
CTACTGTCA.TTACCTCTC	CTACTGTCA.TTACCTCTC
CTAGACATG.TTCTGGTGC	CTAGACATG.TTCTGGTGC
CTAGAGGTA.CAATCAAGT	CTAGAGGTA.CAATCAAGT
CTAGGTACT.ATCACCGCA	CTAGGTACT.ATCACCGCA
CTAGTATAG.CTACGAGAA	CTAGTATAG.CTACGAGAA
CTAGTATAG.GCCACGAGT	CTAGTATAG.GCCACGAGT
CTAGTATAG.GCCGTTGTT	CTAGTATAG.GCCGTTGTT
CTAGTATAG.GGATACCTA	CTAGTATAG.GGATACCTA
CTAGTCGTC.ACTCCTGAG	CTAGTCGTC.ACTCCTGAG
CTAGTCGTC.AGCACACCT	CTAGTCGTC.AGCACACCT
CTAGTCGTC.CCTGCGTTA	CTAGTCGTC.CCTGCGTTA
CTAGTCGTC.CGGTCGACA	CTAGTCGTC.CGGTCGACA
CTAGTCGTC.TCGTAATAG	CTAGTCGTC.TCGTAATAG
CTAGTGCTG.AACAATGCA	CTAGTGCTG.AACAATGCA
CTAGTGCTG.AGGTATTCC	CTAGTGCTG.AGGTATTCC
CTAGTGCTG.GCTTCACTC	CTAGTGCTG.GCTTCACTC
CTAGTGCTG.TATTGACTG	CTAGTGCTG.TATTGACTG
CTAGTGCTG.TTACTTACG	CTAGTGCTG.TTACTTACG
CTAGTTCCA.GAACCAGTT	CTAGTTCCA.GAACCAGTT
CTAGTTCCA.TGGAGAACC	CTAGTTCCA.TGGAGAACC
CTATACTAG.CCATACGAT	CTATACTAG.CCATACGAT
CTATACTAG.CCGATACCG	CTATACTAG.CCGATACCG
CTATACTAG.TGTCATAGC	CTATACTAG.TGTCATAGC
CTATACTAG.TGTCCATAG	CTATACTAG.TGTCCATAG
CTATAGCTC.CCGATGTTC	CTATAGCTC.CCGATGTTC
CTATAGCTC.CGGTCGACA	CTATAGCTC.CGGTCGACA
CTATAGCTC.CGTTCCATT	CTATAGCTC.CGTTCCATT
CTATAGCTC.GGACGAGCA	CTATAGCTC.GGACGAGCA
CTATAGCTC.GGATCGTTC	CTATAGCTC.GGATCGTTC
CTATCCATC.CAGATCGAC	CTATCCATC.CAGATCGAC
CTATCTTGA.ATGGTTCGA	CTATCTTGA.ATGGTTCGA
CTATCTTGA.ATTCGAAGA	CTATCTTGA.ATTCGAAGA
CTATCTTGA.CTGCTTAGG	CTATCTTGA.CTGCTTAGG
CTATCTTGA.GTCTGACGT	CTATCTTGA.GTCTGACGT
CTATCTTGA.TAGAGACTA	CTATCTTGA.TAGAGACTA
CTATCTTGA.TAGGAGCTA	CTATCTTGA.TAGGAGCTA
CTATCTTGA.TGCTCAGCG	CTATCTTGA.TGCTCAGCG
CTATTAAGG.AACCATGGT	CTATTAAGG.AACCATGGT
CTATTAAGG.CACGGAAGT	CTATTAAGG.CACGGAAGT
CTATTAAGG.CTCATGCCA	CTATTAAGG.CTCATGCCA
CTATTAAGG.TTCCTTGAC	CTATTAAGG.TTCCTTGAC
CTATTCCGT.CAGTAATGT	CTATTCCGT.CAGTAATGT
CTATTCCGT.CATGGTCGA	CTATTCCGT.CATGGTCGA
CTATTCCGT.GATGTAAGG	CTATTCCGT.GATGTAAGG
CTATTCCGT.TAACACATC	CTATTCCGT.TAACACATC
CTCAGCTGG.CACGACTCA	CTCAGCTGG.CACGACTCA
CTCAGGTAC.AACGCATTG	CTCAGGTAC.AACGCATTG
CTCAGGTAC.ACCATTCAC	CTCAGGTAC.ACCATTCAC
CTCAGGTAC.CACCTAGCG	CTCAGGTAC.CACCTAGCG
CTCAGGTAC.CAGCTGGAG	CTCAGGTAC.CAGCTGGAG
CTCAGTGAT.AGAGAGTGG	CTCAGTGAT.AGAGAGTGG
CTCAGTGAT.ATTGACACG	CTCAGTGAT.ATTGACACG
CTCAGTGAT.CATCCTCTC	CTCAGTGAT.CATCCTCTC
CTCAGTGAT.CCGTCAGGT	CTCAGTGAT.CCGTCAGGT
CTCAGTGAT.GACTCAGTG	CTCAGTGAT.GACTCAGTG
CTCATGCCA.CTAGGTACT	CTCATGCCA.CTAGGTACT
CTCATGCCA.GCGCTACCT	CTCATGCCA.GCGCTACCT
CTCATTAGT.CCGTAGTTG	CTCATTAGT.CCGTAGTTG
CTCATTAGT.CCTCGGTCA	CTCATTAGT.CCTCGGTCA
CTCATTAGT.CGGTGTTAC	CTCATTAGT.CGGTGTTAC
CTCATTAGT.TATACGTGG	CTCATTAGT.TATACGTGG
CTCATTAGT.TATCACCTG	CTCATTAGT.TATCACCTG
CTCATTAGT.TCTGCGCTG	CTCATTAGT.TCTGCGCTG
CTCATTAGT.TGACCTCCT	CTCATTAGT.TGACCTCCT
CTCCACGTC.CCTTGCTTG	CTCCACGTC.CCTTGCTTG
CTCCACGTC.GTGAGGACG	CTCCACGTC.GTGAGGACG
CTCCACGTC.TAAGCACTA	CTCCACGTC.TAAGCACTA
CTCCAGCGT.AGTGACGAT	CTCCAGCGT.AGTGACGAT
CTCCGCATT.ACTAAGTTC	CTCCGCATT.ACTAAGTTC
CTCCGCATT.CTTGTAACG	CTCCGCATT.CTTGTAACG
CTCCGCATT.GAGACGATC	CTCCGCATT.GAGACGATC
CTCCGCATT.GATTCTCGG	CTCCGCATT.GATTCTCGG
CTCCGCATT.GTCTGAGCC	CTCCGCATT.GTCTGAGCC
CTCCGCATT.TGCAGCCTT	CTCCGCATT.TGCAGCCTT
CTCCTATCT.AACGCTCAA	CTCCTATCT.AACGCTCAA
CTCCTATCT.ATGAGCAGG	CTCCTATCT.ATGAGCAGG
CTCCTATCT.CAGTAATGT	CTCCTATCT.CAGTAATGT
CTCCTATCT.CCGGTTGAG	CTCCTATCT.CCGGTTGAG
CTCCTGACG.CTAACCGGT	CTCCTGACG.CTAACCGGT
CTCCTGACG.GTCGTTAGA	CTCCTGACG.GTCGTTAGA
CTCCTGACG.TTCCGAGCG	CTCCTGACG.TTCCGAGCG
CTCGAACTG.ACACACGTC	CTCGAACTG.ACACACGTC
CTCGAACTG.TTAACGTTC	CTCGAACTG.TTAACGTTC
CTCGACGAT.CTGCATGTT	CTCGACGAT.CTGCATGTT
CTCGACGAT.GCATACTCC	CTCGACGAT.GCATACTCC
CTCGACGAT.TAGGTCAAC	CTCGACGAT.TAGGTCAAC
CTCGACGAT.TGTAGGTTA	CTCGACGAT.TGTAGGTTA
CTCGACTGC.CATGTGAAC	CTCGACTGC.CATGTGAAC
CTCGACTGC.GAACGCTGT	CTCGACTGC.GAACGCTGT
CTCGACTGC.GAAGGATCA	CTCGACTGC.GAAGGATCA
CTCGACTGC.GCTGTTCGG	CTCGACTGC.GCTGTTCGG
CTCGACTGC.GTCAATACA	CTCGACTGC.GTCAATACA
CTCGACTGC.GTTAGATTG	CTCGACTGC.GTTAGATTG
CTCGCAAGA.AACTCCATG	CTCGCAAGA.AACTCCATG
CTCGCAAGA.CTAGACATG	CTCGCAAGA.CTAGACATG
CTCGCAAGA.CTGAGTAGC	CTCGCAAGA.CTGAGTAGC
CTCGCAAGA.GACATATGT	CTCGCAAGA.GACATATGT
CTCGCAAGA.TAGTAGTCT	CTCGCAAGA.TAGTAGTCT
CTCGCTACG.AACGTCGAG	CTCGCTACG.AACGTCGAG
CTCGCTACG.AACTCCATG	CTCGCTACG.AACTCCATG
CTCGCTACG.ATAGCTTGC	CTCGCTACG.ATAGCTTGC
CTCGCTACG.CATAGAGAT	CTCGCTACG.CATAGAGAT
CTCGCTACG.CATGCCAGT	CTCGCTACG.CATGCCAGT
CTCGCTACG.GCCTAACGG	CTCGCTACG.GCCTAACGG
CTCGTCTTG.GATGTCTAG	CTCGTCTTG.GATGTCTAG
CTCGTGTCC.ATGCTTCAG	CTCGTGTCC.ATGCTTCAG
CTCGTGTCC.CCATACGAT	CTCGTGTCC.CCATACGAT
CTCGTGTCC.CCATATGCC	CTCGTGTCC.CCATATGCC
CTCGTGTCC.CGCGTACTA	CTCGTGTCC.CGCGTACTA
CTCGTGTCC.GCAATGAGA	CTCGTGTCC.GCAATGAGA
CTCGTGTCC.TTCAGTGCC	CTCGTGTCC.TTCAGTGCC
CTCGTTCAC.CAATGCATT	CTCGTTCAC.CAATGCATT
CTCGTTCAC.TAAGCACTA	CTCGTTCAC.TAAGCACTA
CTCGTTCAC.TCAGACAAG	CTCGTTCAC.TCAGACAAG
CTCTAAGAG.TCCGATAAC	CTCTAAGAG.TCCGATAAC
CTCTACGCA.AATGCTGAT	CTCTACGCA.AATGCTGAT
CTCTACGCA.CATCAATAG	CTCTACGCA.CATCAATAG
CTCTACGCA.GGACACTGG	CTCTACGCA.GGACACTGG
CTCTAGTAA.ACAGGAACT	CTCTAGTAA.ACAGGAACT
CTCTAGTAA.ACCTAGCAC	CTCTAGTAA.ACCTAGCAC
CTCTAGTAA.AGCGGAACA	CTCTAGTAA.AGCGGAACA
CTCTAGTAA.CTTGTAACG	CTCTAGTAA.CTTGTAACG
CTCTAGTAA.GCCGAACCA	CTCTAGTAA.GCCGAACCA
CTCTAGTAA.GTAGCCTTG	CTCTAGTAA.GTAGCCTTG
CTCTAGTAA.TAACACATC	CTCTAGTAA.TAACACATC
CTCTCAGTC.GATGTAAGG	CTCTCAGTC.GATGTAAGG
CTCTCAGTC.TCAGAGTCA	CTCTCAGTC.TCAGAGTCA
CTCTCGATA.CTCAGTGAT	CTCTCGATA.CTCAGTGAT
CTCTCGATA.GTAATATCG	CTCTCGATA.GTAATATCG
CTCTCGATA.TGCCGAACT	CTCTCGATA.TGCCGAACT
CTCTCGATA.TTCGCATCC	CTCTCGATA.TTCGCATCC
CTCTGCAAG.ACATCGTCC	CTCTGCAAG.ACATCGTCC
CTCTGCAAG.ACGTACTGC	CTCTGCAAG.ACGTACTGC
CTCTGCAAG.GATCTTCGC	CTCTGCAAG.GATCTTCGC
CTCTGCAAG.GGTGGAGCT	CTCTGCAAG.GGTGGAGCT
CTCTGCAAG.TCTCGTATC	CTCTGCAAG.TCTCGTATC
CTCTGCGGT.CCATAAGTA	CTCTGCGGT.CCATAAGTA
CTCTGCGGT.CCGGTGGTT	CTCTGCGGT.CCGGTGGTT
CTCTGCGGT.GACCGTAGT	CTCTGCGGT.GACCGTAGT
CTCTGCGGT.GAGATACAC	CTCTGCGGT.GAGATACAC
CTCTGTCAA.CCGCAGCTA	CTCTGTCAA.CCGCAGCTA
CTCTGTCAA.GGTAGACAT	CTCTGTCAA.GGTAGACAT
CTCTTCAGC.ATAGAGCAG	CTCTTCAGC.ATAGAGCAG
CTCTTCAGC.CTTCACTGT	CTCTTCAGC.CTTCACTGT
CTCTTCAGC.GCCTTAGAG	CTCTTCAGC.GCCTTAGAG
CTGACAGCA.AATTGGTGA	CTGACAGCA.AATTGGTGA
CTGACAGCA.AGTTGCCTT	CTGACAGCA.AGTTGCCTT
CTGACAGCA.CATTGCAGA	CTGACAGCA.CATTGCAGA
CTGACAGCA.CTATAGCTC	CTGACAGCA.CTATAGCTC
CTGACAGCA.TACGTTACC	CTGACAGCA.TACGTTACC
CTGACAGCA.TTACGCTCG	CTGACAGCA.TTACGCTCG
CTGACGATG.ACGAGAGCA	CTGACGATG.ACGAGAGCA
CTGACGATG.AGGTCCGTC	CTGACGATG.AGGTCCGTC
CTGACGATG.GAACATGAC	CTGACGATG.GAACATGAC
CTGACGATG.GAATCACAT	CTGACGATG.GAATCACAT
CTGACGATG.GCACCATCG	CTGACGATG.GCACCATCG
CTGACGATG.TCTCAGGAT	CTGACGATG.TCTCAGGAT
CTGACGATG.TTCACTCCT	CTGACGATG.TTCACTCCT
CTGACGGAT.CAGCAGTAC	CTGACGGAT.CAGCAGTAC
CTGACGGAT.GACGTGGTC	CTGACGGAT.GACGTGGTC
CTGACGGAT.GGACAGATT	CTGACGGAT.GGACAGATT
CTGACGGAT.TAGCCTTGT	CTGACGGAT.TAGCCTTGT
CTGAGGTTA.ATCGGTGGT	CTGAGGTTA.ATCGGTGGT
CTGAGGTTA.TAGATCTGT	CTGAGGTTA.TAGATCTGT
CTGAGGTTA.TGCAGATGC	CTGAGGTTA.TGCAGATGC
CTGAGTAGC.CTACGTTGG	CTGAGTAGC.CTACGTTGG
CTGAGTCCA.CGATTCGAG	CTGAGTCCA.CGATTCGAG
CTGAGTCCA.CTGAGGTTA	CTGAGTCCA.CTGAGGTTA
CTGATCAAG.ACCTAGCAC	CTGATCAAG.ACCTAGCAC
CTGATCAAG.ATCGCCTCT	CTGATCAAG.ATCGCCTCT
CTGATCAAG.CTATAGCTC	CTGATCAAG.CTATAGCTC
CTGATCAAG.CTCTCGATA	CTGATCAAG.CTCTCGATA
CTGATCAAG.GCGACACAG	CTGATCAAG.GCGACACAG
CTGATCAAG.GGTACGAGC	CTGATCAAG.GGTACGAGC
CTGATCAAG.TGTGCAGTA	CTGATCAAG.TGTGCAGTA
CTGATCCGA.ACGCTCTTA	CTGATCCGA.ACGCTCTTA
CTGATCCGA.AGACGCCTG	CTGATCCGA.AGACGCCTG
CTGATCCGA.TCGTTCTCC	CTGATCCGA.TCGTTCTCC
CTGATCCGA.TTCCATACC	CTGATCCGA.TTCCATACC
CTGATGCAC.AGACTTCGT	CTGATGCAC.AGACTTCGT
CTGATGCAC.GCTCAATGA	CTGATGCAC.GCTCAATGA
CTGATGCAC.TCTATTAGG	CTGATGCAC.TCTATTAGG
CTGATGCAC.TGCGATACT	CTGATGCAC.TGCGATACT
CTGCAGAGC.AGCATTCCA	CTGCAGAGC.AGCATTCCA
CTGCAGAGC.ATGCTGTCG	CTGCAGAGC.ATGCTGTCG
CTGCAGAGC.CGCCTGCAA	CTGCAGAGC.CGCCTGCAA
CTGCATGTT.ATAGCTTGC	CTGCATGTT.ATAGCTTGC
CTGCATGTT.CAAGCGCAT	CTGCATGTT.CAAGCGCAT
CTGCGATTC.ACAAGAATG	CTGCGATTC.ACAAGAATG
CTGCGATTC.TCAGTGCAA	CTGCGATTC.TCAGTGCAA
CTGCGTCAC.AATTGGATC	CTGCGTCAC.AATTGGATC
CTGCGTCAC.ACGTATGTC	CTGCGTCAC.ACGTATGTC
CTGCGTCAC.CTTGGTCAT	CTGCGTCAC.CTTGGTCAT
CTGCGTCAC.TTGACCTGA	CTGCGTCAC.TTGACCTGA
CTGCTGCTT.ATAAGACAG	CTGCTGCTT.ATAAGACAG
CTGCTGCTT.GAATTGTTG	CTGCTGCTT.GAATTGTTG
CTGCTTAGG.CAAGAACCG	CTGCTTAGG.CAAGAACCG
CTGCTTAGG.CAGGATCAA	CTGCTTAGG.CAGGATCAA
CTGCTTAGG.GCGAAGCTC	CTGCTTAGG.GCGAAGCTC
CTGGACACT.AGCCGGATC	CTGGACACT.AGCCGGATC
CTGGACACT.ATTCACCTC	CTGGACACT.ATTCACCTC
CTGGACACT.CATCCACCG	CTGGACACT.CATCCACCG
CTGGACTAA.ACTCCGGTT	CTGGACTAA.ACTCCGGTT
CTGGACTAA.ATCAGTCGA	CTGGACTAA.ATCAGTCGA
CTGGACTAA.CATCCTCTC	CTGGACTAA.CATCCTCTC
CTGGACTAA.CGGATTCTC	CTGGACTAA.CGGATTCTC
CTGGACTAA.GAGAATCAG	CTGGACTAA.GAGAATCAG
CTGGACTAA.TCTGCGCTG	CTGGACTAA.TCTGCGCTG
CTGGACTAA.TGAACCAAT	CTGGACTAA.TGAACCAAT
CTGGTAATC.ATATAGCGT	CTGGTAATC.ATATAGCGT
CTGGTAATC.CCATTACAG	CTGGTAATC.CCATTACAG
CTGGTAATC.TGCTCACAC	CTGGTAATC.TGCTCACAC
CTGGTAATC.TTGCCAGAT	CTGGTAATC.TTGCCAGAT
CTGGTACAT.ACACACCGT	CTGGTACAT.ACACACCGT
CTGGTACAT.ATCCAGCTG	CTGGTACAT.ATCCAGCTG
CTGGTACAT.CAACCTGGT	CTGGTACAT.CAACCTGGT
CTGGTACAT.CACCTCAAC	CTGGTACAT.CACCTCAAC
CTGGTACAT.GTACAATGC	CTGGTACAT.GTACAATGC
CTGGTACAT.GTTAGTCAA	CTGGTACAT.GTTAGTCAA
CTGGTACAT.TCTCCGCGT	CTGGTACAT.TCTCCGCGT
CTGGTCGGT.ACGATGGAA	CTGGTCGGT.ACGATGGAA
CTGGTCGGT.TAGTAGTCT	CTGGTCGGT.TAGTAGTCT
CTGGTCGGT.TCGTCATTC	CTGGTCGGT.TCGTCATTC
CTGGTGACA.GACATAACG	CTGGTGACA.GACATAACG
CTGGTGACA.GACGCTTGC	CTGGTGACA.GACGCTTGC
CTGGTGACA.GCTAGCTCC	CTGGTGACA.GCTAGCTCC
CTGGTGACA.GTCATTCTA	CTGGTGACA.GTCATTCTA
CTGGTGACA.TACACGGTC	CTGGTGACA.TACACGGTC
CTGGTGACA.TAGCCAGTG	CTGGTGACA.TAGCCAGTG
CTGGTGACA.TAGGAGCTA	CTGGTGACA.TAGGAGCTA
CTGTAGAAG.AACGATGAC	CTGTAGAAG.AACGATGAC
CTGTAGAAG.CCGCTATCC	CTGTAGAAG.CCGCTATCC
CTGTAGAAG.GAGAACAGG	CTGTAGAAG.GAGAACAGG
CTGTAGAAG.GGATCAATG	CTGTAGAAG.GGATCAATG
CTGTAGAAG.GGATTACGC	CTGTAGAAG.GGATTACGC
CTGTAGAAG.TTCCTTGAC	CTGTAGAAG.TTCCTTGAC
CTGTCACTT.GTCAGTTGT	CTGTCACTT.GTCAGTTGT
CTGTCACTT.TACTACTGT	CTGTCACTT.TACTACTGT
CTGTCACTT.TCTAGGATG	CTGTCACTT.TCTAGGATG
CTGTCACTT.TGATAGAGG	CTGTCACTT.TGATAGAGG
CTGTCACTT.TGGTGGTAA	CTGTCACTT.TGGTGGTAA
CTGTCTAGT.AGGATGCGT	CTGTCTAGT.AGGATGCGT
CTGTCTAGT.CCTGACCTC	CTGTCTAGT.CCTGACCTC
CTGTCTAGT.CTGGTCGGT	CTGTCTAGT.CTGGTCGGT
CTGTCTAGT.TGAGAGGAC	CTGTCTAGT.TGAGAGGAC
CTGTGCTCA.CCGATACCG	CTGTGCTCA.CCGATACCG
CTGTGCTCA.GTCAGTTGT	CTGTGCTCA.GTCAGTTGT
CTGTGCTCA.GTCCTTCAT	CTGTGCTCA.GTCCTTCAT
CTGTGGTGG.AAGACTGGT	CTGTGGTGG.AAGACTGGT
CTGTGGTGG.ATATGCAGC	CTGTGGTGG.ATATGCAGC
CTGTGGTGG.ATGCTCACC	CTGTGGTGG.ATGCTCACC
CTGTGGTGG.GCCACGAGT	CTGTGGTGG.GCCACGAGT
CTGTGGTGG.GTGGTACGG	CTGTGGTGG.GTGGTACGG
CTGTGGTGG.TGATAGAGG	CTGTGGTGG.TGATAGAGG
CTGTTACCA.CACGATAGA	CTGTTACCA.CACGATAGA
CTGTTACCA.CGTCGTCAA	CTGTTACCA.CGTCGTCAA
CTGTTACCA.CTCCGCATT	CTGTTACCA.CTCCGCATT
CTGTTACCA.TACAGTTAG	CTGTTACCA.TACAGTTAG
CTTAACAGC.CACGTCATA	CTTAACAGC.CACGTCATA
CTTAACAGC.GTCAACTGA	CTTAACAGC.GTCAACTGA
CTTAAGTTG.TGTATGTAG	CTTAAGTTG.TGTATGTAG
CTTAATCGT.AGATATGGA	CTTAATCGT.AGATATGGA
CTTAATCGT.AGTGTCTCT	CTTAATCGT.AGTGTCTCT
CTTAATCGT.TCCAGCAGC	CTTAATCGT.TCCAGCAGC
CTTACATGC.CAGTAATGT	CTTACATGC.CAGTAATGT
CTTACATGC.CCAGTTACG	CTTACATGC.CCAGTTACG
CTTACATGC.CCGCACTCA	CTTACATGC.CCGCACTCA
CTTACATGC.CGGTTCTAT	CTTACATGC.CGGTTCTAT
CTTACATGC.GACTTCACC	CTTACATGC.GACTTCACC
CTTACATGC.GATGTAAGG	CTTACATGC.GATGTAAGG
CTTACATGC.GGATAGTCA	CTTACATGC.GGATAGTCA
CTTACATGC.GTCTTCATA	CTTACATGC.GTCTTCATA
CTTACATGC.TAGTAGTCT	CTTACATGC.TAGTAGTCT
CTTACATGC.TCGGTATCA	CTTACATGC.TCGGTATCA
CTTACATGC.TGCGTAATC	CTTACATGC.TGCGTAATC
CTTACCTAG.AAGTTGCCA	CTTACCTAG.AAGTTGCCA
CTTACCTAG.AATGCGTGC	CTTACCTAG.AATGCGTGC
CTTACCTAG.GTAACAGTC	CTTACCTAG.GTAACAGTC
CTTAGAAGG.GACTGCCTG	CTTAGAAGG.GACTGCCTG
CTTAGAAGG.GTTGACCAT	CTTAGAAGG.GTTGACCAT
CTTAGGACT.ACGTTCAAT	CTTAGGACT.ACGTTCAAT
CTTAGGACT.CAACACTCC	CTTAGGACT.CAACACTCC
CTTAGGACT.CTCGTTCAC	CTTAGGACT.CTCGTTCAC
CTTAGGACT.TGCCGAACT	CTTAGGACT.TGCCGAACT
CTTATCTCA.ATCCTCCGA	CTTATCTCA.ATCCTCCGA
CTTATCTCA.CACTTCCTT	CTTATCTCA.CACTTCCTT
CTTATCTCA.CCAGGAGTT	CTTATCTCA.CCAGGAGTT
CTTATCTCA.TACCTCCTC	CTTATCTCA.TACCTCCTC
CTTATCTCA.TATCAGTGC	CTTATCTCA.TATCAGTGC
CTTATCTCA.TGATAGAGG	CTTATCTCA.TGATAGAGG
CTTATTGAG.AAGTAGGAC	CTTATTGAG.AAGTAGGAC
CTTATTGAG.ATCTGCGTA	CTTATTGAG.ATCTGCGTA
CTTATTGAG.ATGAGCAGG	CTTATTGAG.ATGAGCAGG
CTTATTGAG.CTTGCACAA	CTTATTGAG.CTTGCACAA
CTTCACTGT.ACGAATCGC	CTTCACTGT.ACGAATCGC
CTTCACTGT.AGTCGCGAC	CTTCACTGT.AGTCGCGAC
CTTCACTGT.CATAGAGAT	CTTCACTGT.CATAGAGAT
CTTCACTGT.TAGAGCCAG	CTTCACTGT.TAGAGCCAG
CTTCCGGTA.ACAATAGGT	CTTCCGGTA.ACAATAGGT
CTTCCGGTA.ATCACTTCC	CTTCCGGTA.ATCACTTCC
CTTCCGGTA.GCTGATGTC	CTTCCGGTA.GCTGATGTC
CTTCCGTGG.ACTCCGGTT	CTTCCGTGG.ACTCCGGTT
CTTCCGTGG.AGTGACGAT	CTTCCGTGG.AGTGACGAT
CTTCCGTGG.CAAGCGCAT	CTTCCGTGG.CAAGCGCAT
CTTCCGTGG.CACATATCA	CTTCCGTGG.CACATATCA
CTTCCGTGG.CATCCTCTC	CTTCCGTGG.CATCCTCTC
CTTCCGTGG.CTCTAAGAG	CTTCCGTGG.CTCTAAGAG
CTTCCGTGG.GAATTCAGT	CTTCCGTGG.GAATTCAGT
CTTCCGTGG.TACGTTACC	CTTCCGTGG.TACGTTACC
CTTCCTGAT.ATAGCCTAA	CTTCCTGAT.ATAGCCTAA
CTTCCTGAT.CAACGATCG	CTTCCTGAT.CAACGATCG
CTTCCTGAT.CCGCAGAAT	CTTCCTGAT.CCGCAGAAT
CTTCCTGAT.GCAACTCGC	CTTCCTGAT.GCAACTCGC
CTTCCTGAT.TGATGACAG	CTTCCTGAT.TGATGACAG
CTTCGACTG.AGCTCTCCG	CTTCGACTG.AGCTCTCCG
CTTCGACTG.TCTAATACC	CTTCGACTG.TCTAATACC
CTTCGTGCA.ATACGAGGT	CTTCGTGCA.ATACGAGGT
CTTCGTGCA.TCACATACT	CTTCGTGCA.TCACATACT
CTTCTATGA.AAGAGAACT	CTTCTATGA.AAGAGAACT
CTTCTATGA.AGCATTCCA	CTTCTATGA.AGCATTCCA
CTTCTATGA.CGCGCACAT	CTTCTATGA.CGCGCACAT
CTTCTATGA.CTCGTGTCC	CTTCTATGA.CTCGTGTCC
CTTCTATGA.GTGTTGGAA	CTTCTATGA.GTGTTGGAA
CTTCTATGA.TCATGCTCA	CTTCTATGA.TCATGCTCA
CTTCTCATC.AGAGGTGAA	CTTCTCATC.AGAGGTGAA
CTTCTCATC.CCACGTTCT	CTTCTCATC.CCACGTTCT
CTTCTCATC.CCGCTCATG	CTTCTCATC.CCGCTCATG
CTTCTCATC.CTCTGCAAG	CTTCTCATC.CTCTGCAAG
CTTCTCATC.TCGGTATCA	CTTCTCATC.TCGGTATCA
CTTCTGAGT.CTTGCACAA	CTTCTGAGT.CTTGCACAA
CTTCTGAGT.TAGCACTAT	CTTCTGAGT.TAGCACTAT
CTTGATCTA.AGAAGTCCT	CTTGATCTA.AGAAGTCCT
CTTGATCTA.CACACCTGT	CTTGATCTA.CACACCTGT
CTTGATCTA.GATGCGGTT	CTTGATCTA.GATGCGGTT
CTTGCACAA.AGAAGAGTC	CTTGCACAA.AGAAGAGTC
CTTGCACAA.GGTCGGTCT	CTTGCACAA.GGTCGGTCT
CTTGCACAA.TCAAGGTCG	CTTGCACAA.TCAAGGTCG
CTTGCGACC.AGTTGCCTT	CTTGCGACC.AGTTGCCTT
CTTGCGACC.CTCGTCTTG	CTTGCGACC.CTCGTCTTG
CTTGCGACC.GTACCACAA	CTTGCGACC.GTACCACAA
CTTGGATCA.ACTCACGAA	CTTGGATCA.ACTCACGAA
CTTGGATCA.ACTGTAATC	CTTGGATCA.ACTGTAATC
CTTGGATCA.AGATGAAGA	CTTGGATCA.AGATGAAGA
CTTGGATCA.ATAGCACGG	CTTGGATCA.ATAGCACGG
CTTGGTCAT.CCAGTCTCA	CTTGGTCAT.CCAGTCTCA
CTTGGTCAT.CGTTCCATT	CTTGGTCAT.CGTTCCATT
CTTGTAACG.ATCCAGCTG	CTTGTAACG.ATCCAGCTG
CTTGTAACG.CACTGTATC	CTTGTAACG.CACTGTATC
CTTGTAACG.CTTCACTGT	CTTGTAACG.CTTCACTGT
CTTGTAACG.GTAGAGAGC	CTTGTAACG.GTAGAGAGC
CTTGTAACG.TTGCCAGAT	CTTGTAACG.TTGCCAGAT
GAACAACCA.TACTCGACC	GAACAACCA.TACTCGACC
GAACATGAC.AAGGTCTGA	GAACATGAC.AAGGTCTGA
GAACATGAC.ACTATCCTG	GAACATGAC.ACTATCCTG
GAACATGAC.CTATCCATC	GAACATGAC.CTATCCATC
GAACATGAC.CTGACGATG	GAACATGAC.CTGACGATG
GAACATGAC.GTGTCACAC	GAACATGAC.GTGTCACAC
GAACATGAC.TTCGGAGTC	GAACATGAC.TTCGGAGTC
GAACCAGTT.CACAGCGAA	GAACCAGTT.CACAGCGAA
GAACCAGTT.CGAGCTTAC	GAACCAGTT.CGAGCTTAC
GAACCAGTT.CTTAGGACT	GAACCAGTT.CTTAGGACT
GAACCAGTT.TCGCTGATT	GAACCAGTT.TCGCTGATT
GAACCAGTT.TTGCTCTGC	GAACCAGTT.TTGCTCTGC
GAACCTTCA.CCGGTTGAG	GAACCTTCA.CCGGTTGAG
GAACCTTCA.GACATATGT	GAACCTTCA.GACATATGT
GAACCTTCA.TAGCTAAGA	GAACCTTCA.TAGCTAAGA
GAACGCTGT.AACTAACTG	GAACGCTGT.AACTAACTG
GAACGCTGT.GTAGCATAC	GAACGCTGT.GTAGCATAC
GAACTATGG.AGATGTTGG	GAACTATGG.AGATGTTGG
GAACTATGG.GGATAATAC	GAACTATGG.GGATAATAC
GAACTATGG.TGAGAGGAC	GAACTATGG.TGAGAGGAC
GAACTCGTA.CGAGCTTAC	GAACTCGTA.CGAGCTTAC
GAACTCGTA.CTCGTGTCC	GAACTCGTA.CTCGTGTCC
GAACTCGTA.CTTCCGGTA	GAACTCGTA.CTTCCGGTA
GAACTCGTA.GACCAGAGA	GAACTCGTA.GACCAGAGA
GAACTCGTA.GGAGTACAG	GAACTCGTA.GGAGTACAG
GAACTCGTA.GTCACAGAG	GAACTCGTA.GTCACAGAG
GAACTCGTA.TAGCACTAT	GAACTCGTA.TAGCACTAT
GAACTCGTA.TATGCCTTC	GAACTCGTA.TATGCCTTC
GAACTCGTA.TGAGTGACT	GAACTCGTA.TGAGTGACT
GAACTGCAA.AAGTAGGAC	GAACTGCAA.AAGTAGGAC
GAACTGCAA.CACGTCATA	GAACTGCAA.CACGTCATA
GAACTGCAA.CTGTGGTGG	GAACTGCAA.CTGTGGTGG
GAACTGCAA.GCGAAGCTC	GAACTGCAA.GCGAAGCTC
GAACTGCAA.TAACATTGG	GAACTGCAA.TAACATTGG
GAACTGCAA.TCAAGCGTA	GAACTGCAA.TCAAGCGTA
GAACTGCAA.TTGGAGAAC	GAACTGCAA.TTGGAGAAC
GAAGAGCAC.ATTAGCGGT	GAAGAGCAC.ATTAGCGGT
GAAGAGCAC.CCAATATAC	GAAGAGCAC.CCAATATAC
GAAGAGCAC.TAGATCTGT	GAAGAGCAC.TAGATCTGT
GAAGAGCAC.TGTTACTGA	GAAGAGCAC.TGTTACTGA
GAAGGATCA.CCGATGTTC	GAAGGATCA.CCGATGTTC
GAAGGATCA.TGTATGTAG	GAAGGATCA.TGTATGTAG
GAAGTGTGA.TCACACTGC	GAAGTGTGA.TCACACTGC
GAATAAGAG.CAATTGTCT	GAATAAGAG.CAATTGTCT
GAATAAGAG.CTTACCTAG	GAATAAGAG.CTTACCTAG
GAATAAGAG.GCCTGCATC	GAATAAGAG.GCCTGCATC
GAATAAGAG.GGAGTACAG	GAATAAGAG.GGAGTACAG
GAATAAGAG.GGTACTTCC	GAATAAGAG.GGTACTTCC
GAATCAACC.ACTCTGCTC	GAATCAACC.ACTCTGCTC
GAATCAACC.AGACATCCA	GAATCAACC.AGACATCCA
GAATCAACC.ATCGGTGGT	GAATCAACC.ATCGGTGGT
GAATCAACC.CTGCGTCAC	GAATCAACC.CTGCGTCAC
GAATCAACC.GACACCGAT	GAATCAACC.GACACCGAT
GAATCAACC.GTAGAGAGC	GAATCAACC.GTAGAGAGC
GAATCACAT.AATCCGCTG	GAATCACAT.AATCCGCTG
GAATCACAT.AGGATCTCA	GAATCACAT.AGGATCTCA
GAATCACAT.CACACCACA	GAATCACAT.CACACCACA
GAATCACAT.CTCTGCGGT	GAATCACAT.CTCTGCGGT
GAATCACAT.GGTTCAGAC	GAATCACAT.GGTTCAGAC
GAATCGAGA.AGAGAGTGG	GAATCGAGA.AGAGAGTGG
GAATCGAGA.ATACTTGCT	GAATCGAGA.ATACTTGCT
GAATCGAGA.CCATAAGTA	GAATCGAGA.CCATAAGTA
GAATCGAGA.GCGTATAGG	GAATCGAGA.GCGTATAGG
GAATCGAGA.TGAAGACCA	GAATCGAGA.TGAAGACCA
GAATTCAGT.AAGAGAGAG	GAATTCAGT.AAGAGAGAG
GAATTCAGT.CAGCGTAAG	GAATTCAGT.CAGCGTAAG
GAATTCAGT.GATTCTCGG	GAATTCAGT.GATTCTCGG
GAATTGTTG.AGAAGTAAC	GAATTGTTG.AGAAGTAAC
GAATTGTTG.CGGTCGACA	GAATTGTTG.CGGTCGACA
GAATTGTTG.GAATTGTTG	GAATTGTTG.GAATTGTTG
GAATTGTTG.TCTACATCC	GAATTGTTG.TCTACATCC
GAATTGTTG.TCTCATCGG	GAATTGTTG.TCTCATCGG
GACAATGTT.AGCTCGTCT	GACAATGTT.AGCTCGTCT
GACAATGTT.CTCGTTCAC	GACAATGTT.CTCGTTCAC
GACACCGAT.CAGCTCTTC	GACACCGAT.CAGCTCTTC
GACACCGAT.GTAAGTGAG	GACACCGAT.GTAAGTGAG
GACACCGAT.TGCAACTCT	GACACCGAT.TGCAACTCT
GACACGCAA.AAGCACAAC	GACACGCAA.AAGCACAAC
GACACGCAA.CTACGTTGG	GACACGCAA.CTACGTTGG
GACACGCAA.GGTGAGTTC	GACACGCAA.GGTGAGTTC
GACACGCAA.GTCTTCATA	GACACGCAA.GTCTTCATA
GACACGCAA.GTTCAGAAG	GACACGCAA.GTTCAGAAG
GACACGCAA.TAAGTGTAG	GACACGCAA.TAAGTGTAG
GACAGGTTA.CCTGTCATT	GACAGGTTA.CCTGTCATT
GACAGGTTA.CTCTGCAAG	GACAGGTTA.CTCTGCAAG
GACAGGTTA.TCCTATTCC	GACAGGTTA.TCCTATTCC
GACAGGTTA.TGCTCCTCC	GACAGGTTA.TGCTCCTCC
GACAGGTTA.TGTGGTCCT	GACAGGTTA.TGTGGTCCT
GACATAACG.CCGTAGTTG	GACATAACG.CCGTAGTTG
GACATAACG.GTCACAGAG	GACATAACG.GTCACAGAG
GACATAACG.TCAGAGCGT	GACATAACG.TCAGAGCGT
GACATATGT.AATAACTCC	GACATATGT.AATAACTCC
GACATATGT.ACCGCTGTG	GACATATGT.ACCGCTGTG
GACATATGT.ACGCGACAG	GACATATGT.ACGCGACAG
GACATATGT.CTCATTAGT	GACATATGT.CTCATTAGT
GACATATGT.GTCAACTGA	GACATATGT.GTCAACTGA
GACATATGT.TACAACACC	GACATATGT.TACAACACC
GACATATGT.TGAGCTAGA	GACATATGT.TGAGCTAGA
GACCAACAG.ACCGCTGTG	GACCAACAG.ACCGCTGTG
GACCAACAG.CGACCTAGC	GACCAACAG.CGACCTAGC
GACCAACAG.CTATCCATC	GACCAACAG.CTATCCATC
GACCAACAG.GCGTGATAC	GACCAACAG.GCGTGATAC
GACCAACAG.TCCTGAGAC	GACCAACAG.TCCTGAGAC
GACCACTCG.GAGATGTAT	GACCACTCG.GAGATGTAT
GACCACTCG.TACGAACTC	GACCACTCG.TACGAACTC
GACCACTCG.TTCCAGATT	GACCACTCG.TTCCAGATT
GACCAGAGA.AACGAGGTG	GACCAGAGA.AACGAGGTG
GACCAGAGA.CCTATTCAA	GACCAGAGA.CCTATTCAA
GACCAGAGA.TAGCGAGAA	GACCAGAGA.TAGCGAGAA
GACCAGAGA.TCAAGGAGT	GACCAGAGA.TCAAGGAGT
GACCAGAGA.TGATTATCG	GACCAGAGA.TGATTATCG
GACCGTAGT.CATCCTCTC	GACCGTAGT.CATCCTCTC
GACCGTAGT.CTATAGCTC	GACCGTAGT.CTATAGCTC
GACCGTAGT.GAATTCAGT	GACCGTAGT.GAATTCAGT
GACCTTGTG.GACAGGTTA	GACCTTGTG.GACAGGTTA
GACCTTGTG.GAGTCCAAT	GACCTTGTG.GAGTCCAAT
GACCTTGTG.TTCGCATCC	GACCTTGTG.TTCGCATCC
GACCTTGTG.TTGATCGTA	GACCTTGTG.TTGATCGTA
GACGCCGTA.CAGTTACTG	GACGCCGTA.CAGTTACTG
GACGCCGTA.GCAACACCT	GACGCCGTA.GCAACACCT
GACGCTTGC.ACGCTCTTA	GACGCTTGC.ACGCTCTTA
GACGCTTGC.CGGAACGAG	GACGCTTGC.CGGAACGAG
GACGCTTGC.CTTAGAAGG	GACGCTTGC.CTTAGAAGG
GACGCTTGC.CTTCTCATC	GACGCTTGC.CTTCTCATC
GACGCTTGC.TTGATGAGT	GACGCTTGC.TTGATGAGT
GACGGACTA.ACTTCGCAG	GACGGACTA.ACTTCGCAG
GACGGACTA.AGCGGTAAG	GACGGACTA.AGCGGTAAG
GACGGACTA.CATGACGTT	GACGGACTA.CATGACGTT
GACGGACTA.GACATATGT	GACGGACTA.GACATATGT
GACGGACTA.TGTAACAGT	GACGGACTA.TGTAACAGT
GACGGACTA.TGTCCATAG	GACGGACTA.TGTCCATAG
GACGGACTA.TTCACTCCT	GACGGACTA.TTCACTCCT
GACGGTGCT.AGCGGAACA	GACGGTGCT.AGCGGAACA
GACGGTGCT.AGTTGAGCG	GACGGTGCT.AGTTGAGCG
GACGGTGCT.GCCGAACCA	GACGGTGCT.GCCGAACCA
GACGTAGCA.CAGTAATGT	GACGTAGCA.CAGTAATGT
GACGTAGCA.CCTCTTGTA	GACGTAGCA.CCTCTTGTA
GACGTAGCA.GATCGCACT	GACGTAGCA.GATCGCACT
GACGTAGCA.GGATAGTCA	GACGTAGCA.GGATAGTCA
GACGTAGCA.GTCCGCTCA	GACGTAGCA.GTCCGCTCA
GACGTAGCA.TCGGTATCA	GACGTAGCA.TCGGTATCA
GACGTAGCA.TGAGATCAT	GACGTAGCA.TGAGATCAT
GACGTAGCA.TGATCTCGG	GACGTAGCA.TGATCTCGG
