ATAGCCTAA.GGATGCTCG	ATAGCCTAA.GGATGCTCG
ATAGCCTAA.GGTCCTAAG	ATAGCCTAA.GGTCCTAAG
ATAGCCTAA.GTACCTAAC	ATAGCCTAA.GTACCTAAC
ATAGCCTAA.TCGTAATAG	ATAGCCTAA.TCGTAATAG
ATAGCCTAA.TGCCAGACG	ATAGCCTAA.TGCCAGACG
ATAGCTTGC.TGCGCACTG	ATAGCTTGC.TGCGCACTG
ATAGTCAGT.ATCGCCTCT	ATAGTCAGT.ATCGCCTCT
ATAGTCAGT.ATCGGTGGT	ATAGTCAGT.ATCGGTGGT
ATAGTCAGT.CAGCTAGTT	ATAGTCAGT.CAGCTAGTT
ATAGTCAGT.TCAACACTC	ATAGTCAGT.TCAACACTC
ATAGTCAGT.TCCTTCAAC	ATAGTCAGT.TCCTTCAAC
ATAGTCAGT.TGAGTGACT	ATAGTCAGT.TGAGTGACT
ATAGTCAGT.TGCGACGTT	ATAGTCAGT.TGCGACGTT
ATAGTCTCC.ACGGTGTAC	ATAGTCTCC.ACGGTGTAC
ATAGTCTCC.ACTGGACCA	ATAGTCTCC.ACTGGACCA
ATAGTCTCC.ATATCAGCC	ATAGTCTCC.ATATCAGCC
ATAGTCTCC.GTCTGAGCC	ATAGTCTCC.GTCTGAGCC
ATAGTCTCC.TTGAGACGG	ATAGTCTCC.TTGAGACGG
ATAGTGGTT.ACTACCATC	ATAGTGGTT.ACTACCATC
ATAGTGGTT.AGTGAACGG	ATAGTGGTT.AGTGAACGG
ATAGTGGTT.CCTCGACCT	ATAGTGGTT.CCTCGACCT
ATAGTGGTT.GCACATGTT	ATAGTGGTT.GCACATGTT
ATAGTGGTT.GCGATGGTG	ATAGTGGTT.GCGATGGTG
ATAGTGGTT.GTATGATCT	ATAGTGGTT.GTATGATCT
ATATAGCGT.TCCACCGGT	ATATAGCGT.TCCACCGGT
ATATAGCGT.TGTGGTCCT	ATATAGCGT.TGTGGTCCT
ATATCAGCC.ACGTACTGC	ATATCAGCC.ACGTACTGC
ATATCAGCC.TCAGAGCGT	ATATCAGCC.TCAGAGCGT
ATATCCGAT.AAGTTGCCA	ATATCCGAT.AAGTTGCCA
ATATCCGAT.CAGCTGGAG	ATATCCGAT.CAGCTGGAG
ATATGCAGC.ATCACTTCC	ATATGCAGC.ATCACTTCC
ATATGCAGC.CTAGACATG	ATATGCAGC.CTAGACATG
ATATGCAGC.GCGGAGATT	ATATGCAGC.GCGGAGATT
ATATGCAGC.GGTAGACAT	ATATGCAGC.GGTAGACAT
ATATGTCCA.GGAAGAAGC	ATATGTCCA.GGAAGAAGC
ATATGTCCA.GGTAAGGAT	ATATGTCCA.GGTAAGGAT
ATATGTCCA.TCAGGTGCA	ATATGTCCA.TCAGGTGCA
ATATGTCCA.TCGGATGTT	ATATGTCCA.TCGGATGTT
ATATTCGCA.ACACATCTG	ATATTCGCA.ACACATCTG
ATATTCGCA.ATCGGTGGT	ATATTCGCA.ATCGGTGGT
ATATTCGCA.GAGATGTAT	ATATTCGCA.GAGATGTAT
ATATTCGCA.TCCGATAAC	ATATTCGCA.TCCGATAAC
ATATTCGCA.TTATGAGGA	ATATTCGCA.TTATGAGGA
ATATTCGCA.TTCTGAATG	ATATTCGCA.TTCTGAATG
ATCAAGAGA.AACAGATCG	ATCAAGAGA.AACAGATCG
ATCAAGAGA.GTGCTAAGC	ATCAAGAGA.GTGCTAAGC
ATCAAGCAT.CATGGTCGA	ATCAAGCAT.CATGGTCGA
ATCAAGCAT.CTTCACTGT	ATCAAGCAT.CTTCACTGT
ATCACCGCA.CGGAATGCA	ATCACCGCA.CGGAATGCA
ATCACCGCA.GATGTAAGG	ATCACCGCA.GATGTAAGG
ATCACCGCA.TGCATACAT	ATCACCGCA.TGCATACAT
ATCACTTCC.CGTCAGCAC	ATCACTTCC.CGTCAGCAC
ATCACTTCC.CTCCGCATT	ATCACTTCC.CTCCGCATT
ATCACTTCC.TTGTCAACC	ATCACTTCC.TTGTCAACC
ATCAGAAGC.ACATGGATT	ATCAGAAGC.ACATGGATT
ATCAGAAGC.AGCTCTCCG	ATCAGAAGC.AGCTCTCCG
ATCAGAAGC.GTAGCTACA	ATCAGAAGC.GTAGCTACA
ATCAGTCGA.ATCGCCTCT	ATCAGTCGA.ATCGCCTCT
ATCAGTCGA.GCTTCACTC	ATCAGTCGA.GCTTCACTC
ATCATAGAC.AGCCTCGCA	ATCATAGAC.AGCCTCGCA
ATCATAGAC.AGTACTCTC	ATCATAGAC.AGTACTCTC
ATCATAGAC.AGTTATCGC	ATCATAGAC.AGTTATCGC
ATCATAGAC.CAGCTAGTT	ATCATAGAC.CAGCTAGTT
ATCATAGAC.CCACAAGGT	ATCATAGAC.CCACAAGGT
ATCATAGAC.CGAATCCTG	ATCATAGAC.CGAATCCTG
ATCATAGAC.GGACGAGCA	ATCATAGAC.GGACGAGCA
ATCATGTTC.CAGTATGAT	ATCATGTTC.CAGTATGAT
ATCATGTTC.CTTCGTGCA	ATCATGTTC.CTTCGTGCA
ATCATGTTC.TATCTAGGT	ATCATGTTC.TATCTAGGT
ATCATTACG.ACAGTATTG	ATCATTACG.ACAGTATTG
ATCATTACG.GCGGAGATT	ATCATTACG.GCGGAGATT
ATCATTACG.TATTGACTG	ATCATTACG.TATTGACTG
ATCCAATGA.AGCACCGTG	ATCCAATGA.AGCACCGTG
ATCCAATGA.AGTACGAAT	ATCCAATGA.AGTACGAAT
ATCCAATGA.CTTCTATGA	ATCCAATGA.CTTCTATGA
ATCCAATGA.GCGCTTCTC	ATCCAATGA.GCGCTTCTC
ATCCAATGA.TAGAGCCAG	ATCCAATGA.TAGAGCCAG
ATCCACAGT.CGCATCTAC	ATCCACAGT.CGCATCTAC
ATCCACAGT.GGTAGACAT	ATCCACAGT.GGTAGACAT
ATCCACAGT.GTACCTAAC	ATCCACAGT.GTACCTAAC
ATCCAGCTG.TATGCCTTC	ATCCAGCTG.TATGCCTTC
ATCCATTAG.ACACGTTGC	ATCCATTAG.ACACGTTGC
ATCCATTAG.ATTAGCCAC	ATCCATTAG.ATTAGCCAC
ATCCGACCA.CTTCCGTGG	ATCCGACCA.CTTCCGTGG
ATCCGACCA.GTCCGTAAG	ATCCGACCA.GTCCGTAAG
ATCCGACCA.TATTCAACG	ATCCGACCA.TATTCAACG
ATCCGGTCC.CTCTCAGTC	ATCCGGTCC.CTCTCAGTC
ATCCGGTCC.TACCAGCCA	ATCCGGTCC.TACCAGCCA
ATCCGTCTC.CACTGGTCC	ATCCGTCTC.CACTGGTCC
ATCCGTCTC.TGGTCGCTA	ATCCGTCTC.TGGTCGCTA
ATCCTCCGA.ATTGGTTCC	ATCCTCCGA.ATTGGTTCC
ATCCTCCGA.CGACCACTT	ATCCTCCGA.CGACCACTT
ATCCTCCGA.GGTCCTGGT	ATCCTCCGA.GGTCCTGGT
ATCCTGCCT.CGCTGTAGT	ATCCTGCCT.CGCTGTAGT
ATCCTGCCT.GTGTCACAC	ATCCTGCCT.GTGTCACAC
ATCCTGCCT.GTTCAGAAG	ATCCTGCCT.GTTCAGAAG
ATCCTGCCT.TACAACACC	ATCCTGCCT.TACAACACC
ATCGAATCG.AGAGAGTGG	ATCGAATCG.AGAGAGTGG
ATCGAATCG.ATGCAGTTC	ATCGAATCG.ATGCAGTTC
ATCGAATCG.CAGGTTGTC	ATCGAATCG.CAGGTTGTC
ATCGAATCG.CCGAATATG	ATCGAATCG.CCGAATATG
ATCGAATCG.CTAATACGC	ATCGAATCG.CTAATACGC
ATCGAATCG.TCTGATGAA	ATCGAATCG.TCTGATGAA
ATCGATCCT.ACATGGATT	ATCGATCCT.ACATGGATT
ATCGATCCT.ATCACTTCC	ATCGATCCT.ATCACTTCC
ATCGATCCT.CATGACGTT	ATCGATCCT.CATGACGTT
ATCGATCCT.TCCACGTGC	ATCGATCCT.TCCACGTGC
ATCGATCCT.TTCAGTGCC	ATCGATCCT.TTCAGTGCC
ATCGCCTCT.ATGCTTCAG	ATCGCCTCT.ATGCTTCAG
ATCGCCTCT.CTCTTCAGC	ATCGCCTCT.CTCTTCAGC
ATCGGTGGT.AAGGTGCTG	ATCGGTGGT.AAGGTGCTG
ATCGGTGGT.CTTGATCTA	ATCGGTGGT.CTTGATCTA
ATCGGTGGT.GTCTGAGCC	ATCGGTGGT.GTCTGAGCC
ATCGGTGGT.TGGTGGTAA	ATCGGTGGT.TGGTGGTAA
ATCGTAGTG.CTCTAGTAA	ATCGTAGTG.CTCTAGTAA
ATCGTAGTG.GACGGTGCT	ATCGTAGTG.GACGGTGCT
ATCTAGGTT.TGCGTAATC	ATCTAGGTT.TGCGTAATC
ATCTCGAAC.ATCACTTCC	ATCTCGAAC.ATCACTTCC
ATCTCGAAC.ATCAGAAGC	ATCTCGAAC.ATCAGAAGC
ATCTCGAAC.CCATGCGTC	ATCTCGAAC.CCATGCGTC
ATCTCGAAC.TATGAGACC	ATCTCGAAC.TATGAGACC
ATCTCGAAC.TCCTGTCCG	ATCTCGAAC.TCCTGTCCG
ATCTCGAAC.TCGTGACGT	ATCTCGAAC.TCGTGACGT
ATCTCTGCT.CGCAATCGA	ATCTCTGCT.CGCAATCGA
ATCTCTGCT.CTCCTATCT	ATCTCTGCT.CTCCTATCT
ATCTCTGCT.GTCCTAGTT	ATCTCTGCT.GTCCTAGTT
ATCTCTGCT.TATACCACT	ATCTCTGCT.TATACCACT
ATCTCTGCT.TCTGTGAAG	ATCTCTGCT.TCTGTGAAG
ATCTGCGTA.ACTCCGTCG	ATCTGCGTA.ACTCCGTCG
ATCTGCGTA.CCACGCCAT	ATCTGCGTA.CCACGCCAT
ATCTGCGTA.GGAATTCAC	ATCTGCGTA.GGAATTCAC
ATCTGCGTA.TCCTGTCCG	ATCTGCGTA.TCCTGTCCG
ATCTGCGTA.TGCGTCTTA	ATCTGCGTA.TGCGTCTTA
ATCTGGTAG.ACCATGTCT	ATCTGGTAG.ACCATGTCT
ATCTGGTAG.CTAACCGGT	ATCTGGTAG.CTAACCGGT
ATCTGGTAG.GAAGGATCA	ATCTGGTAG.GAAGGATCA
ATCTGGTAG.GATAAGCTG	ATCTGGTAG.GATAAGCTG
ATCTGGTAG.TCCACGTGC	ATCTGGTAG.TCCACGTGC
ATCTTACAG.AGCCACTTC	ATCTTACAG.AGCCACTTC
ATCTTACAG.TGAACGTCA	ATCTTACAG.TGAACGTCA
ATGAACTAG.AGACGGAGG	ATGAACTAG.AGACGGAGG
ATGAACTAG.AGGTCCGTC	ATGAACTAG.AGGTCCGTC
ATGAACTAG.GGTCCTAAG	ATGAACTAG.GGTCCTAAG
ATGAACTAG.TATGTACCT	ATGAACTAG.TATGTACCT
ATGACACAA.CATCCACCG	ATGACACAA.CATCCACCG
ATGAGATCC.AATTAGAGG	ATGAGATCC.AATTAGAGG
ATGAGATCC.CACCTCAAC	ATGAGATCC.CACCTCAAC
ATGAGCAGG.GCCGCTATC	ATGAGCAGG.GCCGCTATC
ATGAGGTAT.ACGCACACT	ATGAGGTAT.ACGCACACT
ATGAGGTAT.CATGGTTAC	ATGAGGTAT.CATGGTTAC
ATGAGGTAT.GTGATGTGC	ATGAGGTAT.GTGATGTGC
ATGAGTGTG.CGCAACCTC	ATGAGTGTG.CGCAACCTC
ATGATAGCT.GCCATTAAG	ATGATAGCT.GCCATTAAG
ATGCAGTTC.AAGCATTGC	ATGCAGTTC.AAGCATTGC
ATGCAGTTC.CGATAGGTG	ATGCAGTTC.CGATAGGTG
ATGCAGTTC.CTAACCGGT	ATGCAGTTC.CTAACCGGT
ATGCAGTTC.GGTCGGATA	ATGCAGTTC.GGTCGGATA
ATGCAGTTC.TCGGTATCA	ATGCAGTTC.TCGGTATCA
ATGCCTGTC.AATGCAGCG	ATGCCTGTC.AATGCAGCG
ATGCCTGTC.ACCTGCAGA	ATGCCTGTC.ACCTGCAGA
ATGCCTGTC.AGGATGCGT	ATGCCTGTC.AGGATGCGT
ATGCCTGTC.AGTTGTGTA	ATGCCTGTC.AGTTGTGTA
ATGCCTGTC.CACAACCAG	ATGCCTGTC.CACAACCAG
ATGCCTGTC.GAATTCAGT	ATGCCTGTC.GAATTCAGT
ATGCCTTCA.CTTCTCATC	ATGCCTTCA.CTTCTCATC
ATGCGCCGT.AGTGAACGG	ATGCGCCGT.AGTGAACGG
ATGCGCCGT.GCAATGAGA	ATGCGCCGT.GCAATGAGA
ATGCGCCGT.TCCAGCAGC	ATGCGCCGT.TCCAGCAGC
ATGCGCTAC.ATCAAGAGA	ATGCGCTAC.ATCAAGAGA
ATGCGCTAC.ATGCAGTTC	ATGCGCTAC.ATGCAGTTC
ATGCGCTAC.TCCTATTCC	ATGCGCTAC.TCCTATTCC
ATGCGTGGA.CGTGAGACT	ATGCGTGGA.CGTGAGACT
ATGCGTGGA.GACTAGCAT	ATGCGTGGA.GACTAGCAT
ATGCGTGGA.TGCCGAACT	ATGCGTGGA.TGCCGAACT
ATGCTCACC.GCCATCGCT	ATGCTCACC.GCCATCGCT
ATGCTCACC.GTCAGTTGT	ATGCTCACC.GTCAGTTGT
ATGCTGTCG.AGCACACCT	ATGCTGTCG.AGCACACCT
ATGCTGTCG.CAAGCGCAT	ATGCTGTCG.CAAGCGCAT
ATGCTGTCG.GTAGCATAC	ATGCTGTCG.GTAGCATAC
ATGCTTCAG.AAGCTGGTC	ATGCTTCAG.AAGCTGGTC
ATGCTTCAG.CAGCGTAAG	ATGCTTCAG.CAGCGTAAG
ATGCTTCAG.CCGGTGGTT	ATGCTTCAG.CCGGTGGTT
ATGCTTCAG.GTAGCTACA	ATGCTTCAG.GTAGCTACA
ATGGACGTT.CATCTCGAT	ATGGACGTT.CATCTCGAT
ATGGAGAGT.TGGATTAGC	ATGGAGAGT.TGGATTAGC
ATGGAGGAA.AAGGATACG	ATGGAGGAA.AAGGATACG
ATGGAGGAA.TCCTTAGGT	ATGGAGGAA.TCCTTAGGT
ATGGATATC.CACAACGCT	ATGGATATC.CACAACGCT
ATGGATATC.CCATGATGT	ATGGATATC.CCATGATGT
ATGGATATC.TAGATAGCC	ATGGATATC.TAGATAGCC
ATGGTTCGA.AACTTGTCG	ATGGTTCGA.AACTTGTCG
ATGGTTCGA.AGTGACGAT	ATGGTTCGA.AGTGACGAT
ATGGTTCGA.CCGCTCATG	ATGGTTCGA.CCGCTCATG
ATGGTTCGA.GCAGATCCG	ATGGTTCGA.GCAGATCCG
ATGGTTCGA.TATGAGACC	ATGGTTCGA.TATGAGACC
ATGGTTCGA.TCCGATAAC	ATGGTTCGA.TCCGATAAC
ATGGTTCGA.TTGCTCTGC	ATGGTTCGA.TTGCTCTGC
ATGTCCTCC.GAATAAGAG	ATGTCCTCC.GAATAAGAG
ATGTCCTCC.GCGTCGTCT	ATGTCCTCC.GCGTCGTCT
ATGTCCTCC.TTGATCGTA	ATGTCCTCC.TTGATCGTA
ATGTCGCCT.ACCATACTT	ATGTCGCCT.ACCATACTT
ATGTCGCCT.ACGACGATT	ATGTCGCCT.ACGACGATT
ATGTCGCCT.GCATACATG	ATGTCGCCT.GCATACATG
ATGTCGCCT.GCCGCTATC	ATGTCGCCT.GCCGCTATC
ATGTCGCCT.GTATCCTGC	ATGTCGCCT.GTATCCTGC
ATGTGACGA.ATGTGAGAC	ATGTGACGA.ATGTGAGAC
ATGTGACGA.TTACGCTCG	ATGTGACGA.TTACGCTCG
ATTAAGACC.CTGAGGTTA	ATTAAGACC.CTGAGGTTA
ATTAAGACC.GATGCTCCT	ATTAAGACC.GATGCTCCT
ATTAAGACC.GCAGATCCG	ATTAAGACC.GCAGATCCG
ATTAAGACC.GTAACCATA	ATTAAGACC.GTAACCATA
ATTAAGACC.TCGATTCAG	ATTAAGACC.TCGATTCAG
ATTAAGACC.TGGAAGATT	ATTAAGACC.TGGAAGATT
ATTAGCACA.CTTGGATCA	ATTAGCACA.CTTGGATCA
ATTAGCACA.GCGCTCTAT	ATTAGCACA.GCGCTCTAT
ATTAGCACA.GTTGCATGG	ATTAGCACA.GTTGCATGG
ATTAGCACA.TGTGTAGAG	ATTAGCACA.TGTGTAGAG
ATTAGCCAC.ACATTGACA	ATTAGCCAC.ACATTGACA
ATTAGCCAC.ACTGGACCA	ATTAGCCAC.ACTGGACCA
ATTAGCGGT.CAGTGCCAT	ATTAGCGGT.CAGTGCCAT
ATTAGCGGT.CCTGTCATT	ATTAGCGGT.CCTGTCATT
ATTAGCGGT.GAGATACAC	ATTAGCGGT.GAGATACAC
ATTATGCAG.CGTCTGCTG	ATTATGCAG.CGTCTGCTG
ATTATGCAG.CGTGAGACT	ATTATGCAG.CGTGAGACT
ATTATGCAG.TATCATGCT	ATTATGCAG.TATCATGCT
ATTCACCTC.GAGATGTAT	ATTCACCTC.GAGATGTAT
ATTCATGTG.AGTTGAGCG	ATTCATGTG.AGTTGAGCG
ATTCATGTG.GCGAGCAAG	ATTCATGTG.GCGAGCAAG
ATTCATGTG.GTAGACTCT	ATTCATGTG.GTAGACTCT
ATTCATGTG.TCGGAACGA	ATTCATGTG.TCGGAACGA
ATTCCTACG.ACGTTCAAT	ATTCCTACG.ACGTTCAAT
ATTCCTACG.AGGTATTCC	ATTCCTACG.AGGTATTCC
ATTCGAAGA.ACCACGGAT	ATTCGAAGA.ACCACGGAT
ATTCGAAGA.TAGGAGGAT	ATTCGAAGA.TAGGAGGAT
ATTCTCTGG.AACGAGAAT	ATTCTCTGG.AACGAGAAT
ATTCTCTGG.CACTCACTA	ATTCTCTGG.CACTCACTA
ATTGACACG.AACACACTC	ATTGACACG.AACACACTC
ATTGACACG.AGTATGACG	ATTGACACG.AGTATGACG
ATTGACACG.ATTCGAAGA	ATTGACACG.ATTCGAAGA
ATTGACACG.CCGACTGTT	ATTGACACG.CCGACTGTT
ATTGACACG.CTGCTGCTT	ATTGACACG.CTGCTGCTT
ATTGACACG.GTAGACTCT	ATTGACACG.GTAGACTCT
ATTGACACG.TCCAGCAGC	ATTGACACG.TCCAGCAGC
ATTGATCAC.AAGTTGCCA	ATTGATCAC.AAGTTGCCA
ATTGATCAC.ATGCGCCGT	ATTGATCAC.ATGCGCCGT
ATTGATCAC.CAAGAACCG	ATTGATCAC.CAAGAACCG
ATTGATCAC.CGTGCCTAT	ATTGATCAC.CGTGCCTAT
ATTGATCAC.TGTTAAGCC	ATTGATCAC.TGTTAAGCC
ATTGATTGG.ACCGTCACG	ATTGATTGG.ACCGTCACG
ATTGATTGG.ACGTGAATC	ATTGATTGG.ACGTGAATC
ATTGATTGG.TGCTTACGG	ATTGATTGG.TGCTTACGG
ATTGCCGAC.CCGATACCG	ATTGCCGAC.CCGATACCG
ATTGCCGAC.CTGACGGAT	ATTGCCGAC.CTGACGGAT
ATTGCCGAC.CTTCGTGCA	ATTGCCGAC.CTTCGTGCA
ATTGCCGAC.GAATCAACC	ATTGCCGAC.GAATCAACC
ATTGCCGAC.GGTGATAGG	ATTGCCGAC.GGTGATAGG
ATTGCCGAC.TGCGACGTT	ATTGCCGAC.TGCGACGTT
ATTGCGCTA.CACTTGGAT	ATTGCGCTA.CACTTGGAT
ATTGCGCTA.CCATAGCCA	ATTGCGCTA.CCATAGCCA
ATTGCGCTA.CCTCGGTCA	ATTGCGCTA.CCTCGGTCA
ATTGCGCTA.CGACCACTT	ATTGCGCTA.CGACCACTT
ATTGGTTCC.AGCATTGTT	ATTGGTTCC.AGCATTGTT
ATTGGTTCC.ATATCAGCC	ATTGGTTCC.ATATCAGCC
ATTGGTTCC.ATCAGGATG	ATTGGTTCC.ATCAGGATG
ATTGGTTCC.CGCAACCTC	ATTGGTTCC.CGCAACCTC
ATTGGTTCC.TTCAGTGCC	ATTGGTTCC.TTCAGTGCC
CAACACCTA.GGTGGAGCT	CAACACCTA.GGTGGAGCT
CAACACCTA.GTATGTATC	CAACACCTA.GTATGTATC
CAACACCTA.TGTGAGTAT	CAACACCTA.TGTGAGTAT
CAACACTCC.CCATATGCC	CAACACTCC.CCATATGCC
CAACACTCC.TACGGTCGT	CAACACTCC.TACGGTCGT
CAACCGGTC.AAGTTGCCA	CAACCGGTC.AAGTTGCCA
CAACCGGTC.AATACTCCG	CAACCGGTC.AATACTCCG
CAACCGGTC.ATGCCTGTC	CAACCGGTC.ATGCCTGTC
CAACCGGTC.GCAATCACG	CAACCGGTC.GCAATCACG
CAACCGGTC.TAGCCAGTG	CAACCGGTC.TAGCCAGTG
CAACCGGTC.TCCAATCAT	CAACCGGTC.TCCAATCAT
CAACCTGGT.ATAGAGCAG	CAACCTGGT.ATAGAGCAG
CAACCTGGT.GAATCACAT	CAACCTGGT.GAATCACAT
CAACCTGGT.GTACCACAA	CAACCTGGT.GTACCACAA
CAACGATCG.ACATGGATT	CAACGATCG.ACATGGATT
CAACGATCG.CCAGTCTCA	CAACGATCG.CCAGTCTCA
CAACGCACA.ATAATGTGG	CAACGCACA.ATAATGTGG
CAACGCACA.ATAGTCTCC	CAACGCACA.ATAGTCTCC
CAACGCACA.TACATGCAC	CAACGCACA.TACATGCAC
CAACTAATC.ATGCAGTTC	CAACTAATC.ATGCAGTTC
CAACTAATC.CAGCTGGAG	CAACTAATC.CAGCTGGAG
CAACTAATC.TCAGAGCGT	CAACTAATC.TCAGAGCGT
CAACTCCAG.AGCCGGATC	CAACTCCAG.AGCCGGATC
CAACTCCAG.ATGTGACGA	CAACTCCAG.ATGTGACGA
CAACTCCAG.ATTCGAAGA	CAACTCCAG.ATTCGAAGA
CAACTCCAG.CCATAATCG	CAACTCCAG.CCATAATCG
CAACTCCAG.GCTCAGCCA	CAACTCCAG.GCTCAGCCA
CAACTCCAG.GTACCTAAC	CAACTCCAG.GTACCTAAC
CAAGAACCG.ACAGTATTG	CAAGAACCG.ACAGTATTG
CAAGAACCG.CAAGAGAGT	CAAGAACCG.CAAGAGAGT
CAAGAACCG.CAATCAAGT	CAAGAACCG.CAATCAAGT
CAAGAACCG.CGTATCGAA	CAAGAACCG.CGTATCGAA
CAAGAACCG.CTGTACGAC	CAAGAACCG.CTGTACGAC
CAAGAACCG.GATGCGACG	CAAGAACCG.GATGCGACG
CAAGAACCG.TTGCAGTCA	CAAGAACCG.TTGCAGTCA
CAAGAGAGT.ACCATTCAC	CAAGAGAGT.ACCATTCAC
CAAGAGAGT.CTAGGTACT	CAAGAGAGT.CTAGGTACT
CAAGAGAGT.GTTATCGAT	CAAGAGAGT.GTTATCGAT
CAAGAGGAG.AATCGTGTT	CAAGAGGAG.AATCGTGTT
CAAGAGGAG.CACACCTGT	CAAGAGGAG.CACACCTGT
CAAGAGGAG.CACTGGTCC	CAAGAGGAG.CACTGGTCC
CAAGAGGAG.CCGTCCACT	CAAGAGGAG.CCGTCCACT
CAAGAGGAG.GAAGGATCA	CAAGAGGAG.GAAGGATCA
CAAGAGGAG.GCATGTAAG	CAAGAGGAG.GCATGTAAG
CAAGAGGAG.TAGCCAGTG	CAAGAGGAG.TAGCCAGTG
CAAGCCTCG.GAACCAGTT	CAAGCCTCG.GAACCAGTT
CAAGCCTCG.TCCGGAGCT	CAAGCCTCG.TCCGGAGCT
CAAGCGCAT.AATACCTTG	CAAGCGCAT.AATACCTTG
CAAGCGCAT.AATGCTATC	CAAGCGCAT.AATGCTATC
CAAGCGCAT.AGATGAGAT	CAAGCGCAT.AGATGAGAT
CAAGCGCAT.AGTCTGGAA	CAAGCGCAT.AGTCTGGAA
CAAGCGCAT.GTGCTAAGC	CAAGCGCAT.GTGCTAAGC
CAAGCGCAT.TAGTGATCC	CAAGCGCAT.TAGTGATCC
CAAGCTGCA.AGCATTGTT	CAAGCTGCA.AGCATTGTT
CAAGCTGCA.GTAATCAGC	CAAGCTGCA.GTAATCAGC
CAAGGTGTG.ACTATCCTG	CAAGGTGTG.ACTATCCTG
CAAGTACGA.AGAGCGGAG	CAAGTACGA.AGAGCGGAG
CAAGTACGA.CTTACCTAG	CAAGTACGA.CTTACCTAG
CAAGTACGA.TCACATACT	CAAGTACGA.TCACATACT
CAAGTCACT.AGACGCTAT	CAAGTCACT.AGACGCTAT
CAAGTCACT.GCAGCTTGA	CAAGTCACT.GCAGCTTGA
CAAGTCACT.GGAGAATGA	CAAGTCACT.GGAGAATGA
CAAGTCACT.GGATCAATG	CAAGTCACT.GGATCAATG
CAAGTCGAA.ATATCCGAT	CAAGTCGAA.ATATCCGAT
CAAGTCGAA.CCACACAGA	CAAGTCGAA.CCACACAGA
CAAGTCGAA.CTATTCCGT	CAAGTCGAA.CTATTCCGT
CAATACCAC.AACGCATTG	CAATACCAC.AACGCATTG
CAATACCAC.AAGTTCTCT	CAATACCAC.AAGTTCTCT
CAATACCAC.ACGTTCAAT	CAATACCAC.ACGTTCAAT
CAATACCAC.AGAGGTGAA	CAATACCAC.AGAGGTGAA
CAATCAAGT.AGTGTGCAC	CAATCAAGT.AGTGTGCAC
CAATCAAGT.CTTGTAACG	CAATCAAGT.CTTGTAACG
CAATCAAGT.TAGTCAGAC	CAATCAAGT.TAGTCAGAC
CAATCATAC.CACCTACGC	CAATCATAC.CACCTACGC
CAATCATAC.CTGCATGTT	CAATCATAC.CTGCATGTT
CAATCATAC.GGAGTACAG	CAATCATAC.GGAGTACAG
CAATCATAC.GTTGCATGG	CAATCATAC.GTTGCATGG
CAATCATAC.TCGTGCCAC	CAATCATAC.TCGTGCCAC
CAATCTCCG.ATGAGATCC	CAATCTCCG.ATGAGATCC
CAATCTCCG.CCGCATCCT	CAATCTCCG.CCGCATCCT
CAATCTCCG.CCTAGAGTA	CAATCTCCG.CCTAGAGTA
CAATGCATT.ACTCCAACT	CAATGCATT.ACTCCAACT
CAATGCATT.CGCTTATGA	CAATGCATT.CGCTTATGA
CAATGTGCT.CTTCACTGT	CAATGTGCT.CTTCACTGT
CAATGTGCT.GCACTGGAT	CAATGTGCT.GCACTGGAT
CAATGTGCT.GCATGTGGT	CAATGTGCT.GCATGTGGT
CAATGTGCT.GCTACCGAG	CAATGTGCT.GCTACCGAG
CAATGTGCT.GGAACCTAG	CAATGTGCT.GGAACCTAG
CAATGTGCT.TCACGCGAC	CAATGTGCT.TCACGCGAC
CAATTGTCT.CCGCTCATG	CAATTGTCT.CCGCTCATG
CAATTGTCT.CGACAGACC	CAATTGTCT.CGACAGACC
CAATTGTCT.GGAAGAAGC	CAATTGTCT.GGAAGAAGC
CAATTGTCT.GTTATCGAT	CAATTGTCT.GTTATCGAT
CACAACCAG.CCAACGGAA	CACAACCAG.CCAACGGAA
CACAACCAG.CGACCTAGC	CACAACCAG.CGACCTAGC
CACAACCAG.GCCGTGAAC	CACAACCAG.GCCGTGAAC
CACAACCAG.TATTGCTAC	CACAACCAG.TATTGCTAC
CACAACCAG.TGAACGGTT	CACAACCAG.TGAACGGTT
CACAACCAG.TGATGGACA	CACAACCAG.TGATGGACA
CACAACCAG.TTCACTCCT	CACAACCAG.TTCACTCCT
CACAACGCT.GACATAACG	CACAACGCT.GACATAACG
CACAACGCT.GGATCGTTC	CACAACGCT.GGATCGTTC
CACAACGCT.TAGGATTAG	CACAACGCT.TAGGATTAG
CACAATAAC.ACCGACGGT	CACAATAAC.ACCGACGGT
CACAATAAC.ACGATGGAA	CACAATAAC.ACGATGGAA
CACAATAAC.AGTCGTCCG	CACAATAAC.AGTCGTCCG
CACAATAAC.ATACAACCG	CACAATAAC.ATACAACCG
CACAATAAC.GCGAAGCTC	CACAATAAC.GCGAAGCTC
CACACCACA.AGTAGAGGA	CACACCACA.AGTAGAGGA
CACACCACA.AGTCAGTTG	CACACCACA.AGTCAGTTG
CACACCACA.ATCGTAGTG	CACACCACA.ATCGTAGTG
CACACCACA.TACCTCCTC	CACACCACA.TACCTCCTC
CACACCTGT.GGATACAAT	CACACCTGT.GGATACAAT
CACACCTGT.TATTCAACG	CACACCTGT.TATTCAACG
CACAGCGAA.ACTTAGCTT	CACAGCGAA.ACTTAGCTT
CACAGCGAA.AGGAGCAAT	CACAGCGAA.AGGAGCAAT
CACAGCGAA.AGTGTGCAC	CACAGCGAA.AGTGTGCAC
CACAGCGAA.TCCAATCAT	CACAGCGAA.TCCAATCAT
CACATATCA.AGAATCAGA	CACATATCA.AGAATCAGA
CACATATCA.GATATGGAC	CACATATCA.GATATGGAC
CACATGTGC.AGGATGCGT	CACATGTGC.AGGATGCGT
CACATGTGC.CAGATCATT	CACATGTGC.CAGATCATT
CACATGTGC.GCAACTCGC	CACATGTGC.GCAACTCGC
CACATGTGC.TCAATGGAC	CACATGTGC.TCAATGGAC
CACATTCTG.ATACGAGGT	CACATTCTG.ATACGAGGT
CACATTCTG.ATTGATTGG	CACATTCTG.ATTGATTGG
CACATTCTG.GCGGACGAA	CACATTCTG.GCGGACGAA
CACCAAGAT.ACTCCGGTT	CACCAAGAT.ACTCCGGTT
CACCAAGAT.CCTCTGCAT	CACCAAGAT.CCTCTGCAT
CACCAAGAT.CGCCTGCAA	CACCAAGAT.CGCCTGCAA
CACCAAGAT.TCCACGTGC	CACCAAGAT.TCCACGTGC
CACCAAGAT.TGCCTTCAG	CACCAAGAT.TGCCTTCAG
CACCAGAAG.GAACGCTGT	CACCAGAAG.GAACGCTGT
CACCAGAAG.GTCTGACGT	CACCAGAAG.GTCTGACGT
CACCTACGC.AACAGCAGT	CACCTACGC.AACAGCAGT
CACCTACGC.CGCAACCTC	CACCTACGC.CGCAACCTC
CACCTACGC.GGAGTTAGC	CACCTACGC.GGAGTTAGC
CACCTACGC.TCTCAGGAT	CACCTACGC.TCTCAGGAT
CACCTAGCG.GGTAGTGTT	CACCTAGCG.GGTAGTGTT
CACCTCAAC.ATATAGCGT	CACCTCAAC.ATATAGCGT
CACCTCAAC.CAGCTGGAG	CACCTCAAC.CAGCTGGAG
CACCTCAAC.GTAGTTGGT	CACCTCAAC.GTAGTTGGT
CACCTCAAC.TTATTCGAC	CACCTCAAC.TTATTCGAC
CACCTCGGA.CACGACTCA	CACCTCGGA.CACGACTCA
CACCTCGGA.GATTGAGTA	CACCTCGGA.GATTGAGTA
CACCTCGGA.GCCTGGAAT	CACCTCGGA.GCCTGGAAT
CACCTCGGA.TACTCGACC	CACCTCGGA.TACTCGACC
CACCTCGGA.TAGGATTAG	CACCTCGGA.TAGGATTAG
CACCTTCCT.CACTACAGG	CACCTTCCT.CACTACAGG
CACCTTCCT.CGTGAGACT	CACCTTCCT.CGTGAGACT
CACCTTCCT.GCGATGGTG	CACCTTCCT.GCGATGGTG
CACGACTCA.AGTAAGCCA	CACGACTCA.AGTAAGCCA
CACGACTCA.GGATACCTA	CACGACTCA.GGATACCTA
CACGACTCA.TATCATGCT	CACGACTCA.TATCATGCT
CACGACTCA.TCCGGAGCT	CACGACTCA.TCCGGAGCT
CACGACTCA.TGCATCGGA	CACGACTCA.TGCATCGGA
CACGATAGA.CAGCGTAAG	CACGATAGA.CAGCGTAAG
CACGCGTAA.GCGGTAGTC	CACGCGTAA.GCGGTAGTC
CACGGAAGT.ACAGAGATG	CACGGAAGT.ACAGAGATG
CACGGAAGT.ACGTATGTC	CACGGAAGT.ACGTATGTC
CACGGAAGT.CCGGTTCTA	CACGGAAGT.CCGGTTCTA
CACGGAAGT.CTCTGTCAA	CACGGAAGT.CTCTGTCAA
CACGGAAGT.GGATACCTA	CACGGAAGT.GGATACCTA
CACGGAAGT.GTATGCCTT	CACGGAAGT.GTATGCCTT
CACGGAAGT.GTGTTGGAA	CACGGAAGT.GTGTTGGAA
CACGGATAG.ACAGGTATC	CACGGATAG.ACAGGTATC
CACGGATAG.AGATATGGA	CACGGATAG.AGATATGGA
CACGGATAG.ATAGTCAGT	CACGGATAG.ATAGTCAGT
CACGGATAG.CCAACAACA	CACGGATAG.CCAACAACA
CACGGATAG.GATCTAGAG	CACGGATAG.GATCTAGAG
CACGGATAG.GCCTTATCT	CACGGATAG.GCCTTATCT
CACGGATAG.TTCGCATCC	CACGGATAG.TTCGCATCC
CACGTAGAC.GGACGAGCA	CACGTAGAC.GGACGAGCA
CACGTAGAC.GGTGTGACC	CACGTAGAC.GGTGTGACC
CACGTAGAC.TAATGTAGC	CACGTAGAC.TAATGTAGC
CACGTAGAC.TCACCGAGG	CACGTAGAC.TCACCGAGG
CACGTCATA.ACTCCAACT	CACGTCATA.ACTCCAACT
CACGTCATA.ATCTCGAAC	CACGTCATA.ATCTCGAAC
CACGTCATA.CCACTGAAG	CACGTCATA.CCACTGAAG
CACGTCATA.CTATCTTGA	CACGTCATA.CTATCTTGA
CACGTCATA.TAGAGCGTC	CACGTCATA.TAGAGCGTC
CACTACAGG.CATCGCTGG	CACTACAGG.CATCGCTGG
CACTACAGG.GTTAGTCAA	CACTACAGG.GTTAGTCAA
CACTACAGG.TAAGGTGAT	CACTACAGG.TAAGGTGAT
CACTAGACT.ACAGCGGTC	CACTAGACT.ACAGCGGTC
CACTAGACT.GCACTGGAT	CACTAGACT.GCACTGGAT
CACTCACTA.CTTGTAACG	CACTCACTA.CTTGTAACG
CACTCACTA.GCGCATTAC	CACTCACTA.GCGCATTAC
CACTCACTA.TACAACACC	CACTCACTA.TACAACACC
CACTGCTTA.CGACCACTT	CACTGCTTA.CGACCACTT
CACTGCTTA.GAAGGATCA	CACTGCTTA.GAAGGATCA
CACTGCTTA.GGTTGAAGG	CACTGCTTA.GGTTGAAGG
CACTGCTTA.TAACGGATA	CACTGCTTA.TAACGGATA
CACTGGTCC.ACACAGAAC	CACTGGTCC.ACACAGAAC
CACTGGTCC.ACGCAAGAT	CACTGGTCC.ACGCAAGAT
CACTGGTCC.GGTTGCTAT	CACTGGTCC.GGTTGCTAT
CACTGGTCC.TAGTGATCC	CACTGGTCC.TAGTGATCC
CACTGGTCC.TCGCTGTAA	CACTGGTCC.TCGCTGTAA
CACTGTATC.CCTCGACCT	CACTGTATC.CCTCGACCT
CACTGTATC.CCTCGGTCA	CACTGTATC.CCTCGGTCA
CACTGTATC.GAACCAGTT	CACTGTATC.GAACCAGTT
CACTGTATC.GCCACGAGT	CACTGTATC.GCCACGAGT
CACTGTATC.GGATTACGC	CACTGTATC.GGATTACGC
CACTGTATC.GTAATCAGC	CACTGTATC.GTAATCAGC
CACTGTATC.TCCGATAAC	CACTGTATC.TCCGATAAC
CACTGTATC.TTGAGCTCT	CACTGTATC.TTGAGCTCT
CACTTCCTT.GCGGTAAGT	CACTTCCTT.GCGGTAAGT
CACTTCCTT.GGATTCGTC	CACTTCCTT.GGATTCGTC
CACTTGGAT.CATACGCAG	CACTTGGAT.CATACGCAG
CAGAAGTGA.CCACGAAGG	CAGAAGTGA.CCACGAAGG
CAGAAGTGA.CCGCATCCT	CAGAAGTGA.CCGCATCCT
CAGAAGTGA.GTAGACTCT	CAGAAGTGA.GTAGACTCT
CAGAAGTGA.GTCCTTCAT	CAGAAGTGA.GTCCTTCAT
CAGAGCACC.GGACACTGG	CAGAGCACC.GGACACTGG
CAGAGCACC.GTGATGTGC	CAGAGCACC.GTGATGTGC
CAGAGCACC.TCACGCGAC	CAGAGCACC.TCACGCGAC
CAGAGCACC.TGTAGGTTA	CAGAGCACC.TGTAGGTTA
CAGAGCACC.TGTGTAGAG	CAGAGCACC.TGTGTAGAG
CAGAGCACC.TTCAACTAC	CAGAGCACC.TTCAACTAC
CAGATCATT.CATAAGATC	CAGATCATT.CATAAGATC
CAGATCATT.CCGCATCCT	CAGATCATT.CCGCATCCT
CAGATCATT.CTATCCATC	CAGATCATT.CTATCCATC
CAGATCATT.GTAGAGAGC	CAGATCATT.GTAGAGAGC
CAGATCATT.TATCCTCAG	CAGATCATT.TATCCTCAG
CAGATCGAC.GACGTCAAT	CAGATCGAC.GACGTCAAT
CAGATCGAC.GGTAGTGTT	CAGATCGAC.GGTAGTGTT
CAGATCGAC.GTAACGCGA	CAGATCGAC.GTAACGCGA
CAGATCGAC.GTACGTCTA	CAGATCGAC.GTACGTCTA
CAGATCGAC.TCACTACGT	CAGATCGAC.TCACTACGT
CAGCACGTG.ATAGCTTGC	CAGCACGTG.ATAGCTTGC
CAGCAGTAC.ACTCCAACT	CAGCAGTAC.ACTCCAACT
CAGCAGTAC.CCGATACCG	CAGCAGTAC.CCGATACCG
CAGCAGTAC.CTGATGCAC	CAGCAGTAC.CTGATGCAC
CAGCAGTAC.GGATGCGAA	CAGCAGTAC.GGATGCGAA
