CTGAGTCCA.CTCTAGTAA	CTGAGTCCA.CTCTAGTAA
CTGAGTCCA.GTCAGTTGT	CTGAGTCCA.GTCAGTTGT
CTGAGTCCA.GTCCTAGTT	CTGAGTCCA.GTCCTAGTT
CTGATCAAG.CCGGTTCTA	CTGATCAAG.CCGGTTCTA
CTGATCAAG.CTGAGTCCA	CTGATCAAG.CTGAGTCCA
CTGATCAAG.GAACGCTGT	CTGATCAAG.GAACGCTGT
CTGATCAAG.GGACAGATT	CTGATCAAG.GGACAGATT
CTGATCCGA.AAGGAACAG	CTGATCCGA.AAGGAACAG
CTGATCCGA.AAGGATCGT	CTGATCCGA.AAGGATCGT
CTGATCCGA.AGCTTGGTG	CTGATCCGA.AGCTTGGTG
CTGATCCGA.ATGATAGCT	CTGATCCGA.ATGATAGCT
CTGATCCGA.CCAATGCCT	CTGATCCGA.CCAATGCCT
CTGATCCGA.TGGAAGATT	CTGATCCGA.TGGAAGATT
CTGATGCAC.ATGTCGCCT	CTGATGCAC.ATGTCGCCT
CTGATGCAC.GTATGATCT	CTGATGCAC.GTATGATCT
CTGCAAGCC.ATAAGACAG	CTGCAAGCC.ATAAGACAG
CTGCAAGCC.CGTATTCCT	CTGCAAGCC.CGTATTCCT
CTGCAAGCC.GGAAGGTAT	CTGCAAGCC.GGAAGGTAT
CTGCATGTT.CAAGCCTCG	CTGCATGTT.CAAGCCTCG
CTGCATGTT.CACCAGAAG	CTGCATGTT.CACCAGAAG
CTGCATGTT.CAGTGAGGA	CTGCATGTT.CAGTGAGGA
CTGCATGTT.GCACATGTT	CTGCATGTT.GCACATGTT
CTGCATGTT.GCTACCTTA	CTGCATGTT.GCTACCTTA
CTGCGATTC.ACAGCGTAT	CTGCGATTC.ACAGCGTAT
CTGCGATTC.CACAACGCT	CTGCGATTC.CACAACGCT
CTGCGATTC.CATTCAGTT	CTGCGATTC.CATTCAGTT
CTGCGTCAC.ATTAAGACC	CTGCGTCAC.ATTAAGACC
CTGCGTCAC.CCTAGCAAT	CTGCGTCAC.CCTAGCAAT
CTGCTGCTT.ATTCGAAGA	CTGCTGCTT.ATTCGAAGA
CTGCTGCTT.CACAACCAG	CTGCTGCTT.CACAACCAG
CTGCTGCTT.CGACGTGAT	CTGCTGCTT.CGACGTGAT
CTGCTGCTT.TGGTGCCTG	CTGCTGCTT.TGGTGCCTG
CTGCTTAGG.ATTAAGACC	CTGCTTAGG.ATTAAGACC
CTGCTTAGG.ATTCCTACG	CTGCTTAGG.ATTCCTACG
CTGCTTAGG.CTACCTGCG	CTGCTTAGG.CTACCTGCG
CTGCTTAGG.CTACTGTCA	CTGCTTAGG.CTACTGTCA
CTGCTTAGG.CTGGAGCGA	CTGCTTAGG.CTGGAGCGA
CTGCTTAGG.GCGTGATAC	CTGCTTAGG.GCGTGATAC
CTGCTTAGG.TTAACGTTC	CTGCTTAGG.TTAACGTTC
CTGCTTAGG.TTCATCCAA	CTGCTTAGG.TTCATCCAA
CTGGACACT.ATCCACAGT	CTGGACACT.ATCCACAGT
CTGGACACT.TAGGAGCTA	CTGGACACT.TAGGAGCTA
CTGGACTAA.GCGAAGCTC	CTGGACTAA.GCGAAGCTC
CTGGACTAA.GTTGACGTG	CTGGACTAA.GTTGACGTG
CTGGACTAA.TGTCTACAC	CTGGACTAA.TGTCTACAC
CTGGAGCGA.ATATCAGCC	CTGGAGCGA.ATATCAGCC
CTGGAGCGA.CTAACACTG	CTGGAGCGA.CTAACACTG
CTGGAGCGA.GCCTTATCT	CTGGAGCGA.GCCTTATCT
CTGGTAATC.AGTAACGTA	CTGGTAATC.AGTAACGTA
CTGGTAATC.AGTCATACT	CTGGTAATC.AGTCATACT
CTGGTAATC.GCGGTAAGT	CTGGTAATC.GCGGTAAGT
CTGGTAATC.TCGTACCTT	CTGGTAATC.TCGTACCTT
CTGGTACAT.AACTTCTGC	CTGGTACAT.AACTTCTGC
CTGGTACAT.GTAGAGAGC	CTGGTACAT.GTAGAGAGC
CTGGTACAT.TAGTAGTCT	CTGGTACAT.TAGTAGTCT
CTGGTCGGT.AAGGTCTGA	CTGGTCGGT.AAGGTCTGA
CTGGTCGGT.AATGCTATC	CTGGTCGGT.AATGCTATC
CTGGTCGGT.AGCCGGATC	CTGGTCGGT.AGCCGGATC
CTGGTCGGT.CTCCTATCT	CTGGTCGGT.CTCCTATCT
CTGGTCGGT.TCGGATGTT	CTGGTCGGT.TCGGATGTT
CTGGTGACA.AGTATGACG	CTGGTGACA.AGTATGACG
CTGGTGACA.TGGATTAGC	CTGGTGACA.TGGATTAGC
CTGTACGAC.CTGGACTAA	CTGTACGAC.CTGGACTAA
CTGTACGAC.GGAAGAAGC	CTGTACGAC.GGAAGAAGC
CTGTACGAC.TATGAGACC	CTGTACGAC.TATGAGACC
CTGTAGAAG.AGAGGTGAA	CTGTAGAAG.AGAGGTGAA
CTGTAGAAG.ATCCAATGA	CTGTAGAAG.ATCCAATGA
CTGTAGAAG.ATGACACAA	CTGTAGAAG.ATGACACAA
CTGTAGAAG.CATCTCGAT	CTGTAGAAG.CATCTCGAT
CTGTAGAAG.GGATACAAT	CTGTAGAAG.GGATACAAT
CTGTCACTT.ACCATCTAA	CTGTCACTT.ACCATCTAA
CTGTCACTT.GCAATGAGA	CTGTCACTT.GCAATGAGA
CTGTCTAGT.AAGCCACAC	CTGTCTAGT.AAGCCACAC
CTGTCTAGT.CGTTGATCC	CTGTCTAGT.CGTTGATCC
CTGTGCTCA.ATACTTGCT	CTGTGCTCA.ATACTTGCT
CTGTGCTCA.GTTGCTCAG	CTGTGCTCA.GTTGCTCAG
CTGTGCTCA.TACCTCACT	CTGTGCTCA.TACCTCACT
CTGTGCTCA.TCAGAGTCA	CTGTGCTCA.TCAGAGTCA
CTGTGGTGG.CGACCTGTA	CTGTGGTGG.CGACCTGTA
CTGTGGTGG.CTCATTAGT	CTGTGGTGG.CTCATTAGT
CTGTGGTGG.GGTAATCTA	CTGTGGTGG.GGTAATCTA
CTGTGGTGG.TTGCCGTAG	CTGTGGTGG.TTGCCGTAG
CTTAAGTTG.AAGTTCTCT	CTTAAGTTG.AAGTTCTCT
CTTAAGTTG.CACGGAAGT	CTTAAGTTG.CACGGAAGT
CTTAAGTTG.CTTCACTGT	CTTAAGTTG.CTTCACTGT
CTTAAGTTG.GAGTATCGC	CTTAAGTTG.GAGTATCGC
CTTAAGTTG.TGCCGAACT	CTTAAGTTG.TGCCGAACT
CTTAAGTTG.TTAGATCGG	CTTAAGTTG.TTAGATCGG
CTTAATCGT.ACACACGTC	CTTAATCGT.ACACACGTC
CTTAATCGT.ATTCACCTC	CTTAATCGT.ATTCACCTC
CTTAATCGT.CAGGTTGTC	CTTAATCGT.CAGGTTGTC
CTTAATCGT.CCGCACTCA	CTTAATCGT.CCGCACTCA
CTTAATCGT.GTCCTAGTT	CTTAATCGT.GTCCTAGTT
CTTAATCGT.GTTATCGAT	CTTAATCGT.GTTATCGAT
CTTACATGC.GATATATCC	CTTACATGC.GATATATCC
CTTACCTAG.CCTCGAGAG	CTTACCTAG.CCTCGAGAG
CTTACCTAG.GACGTTCAG	CTTACCTAG.GACGTTCAG
CTTACCTAG.GCGTTCAGA	CTTACCTAG.GCGTTCAGA
CTTAGAAGG.AGACGGAGG	CTTAGAAGG.AGACGGAGG
CTTAGAAGG.CAAGAACCG	CTTAGAAGG.CAAGAACCG
CTTAGAAGG.TGATGTGTG	CTTAGAAGG.TGATGTGTG
CTTAGAAGG.TTATTCGAC	CTTAGAAGG.TTATTCGAC
CTTAGGACT.AACGGAGAT	CTTAGGACT.AACGGAGAT
CTTAGGACT.GTGGTTACC	CTTAGGACT.GTGGTTACC
CTTAGGACT.TGGACGAGA	CTTAGGACT.TGGACGAGA
CTTAGGACT.TGGAGAGTG	CTTAGGACT.TGGAGAGTG
CTTAGGACT.TGTAGCAAG	CTTAGGACT.TGTAGCAAG
CTTATCTCA.CTGGACACT	CTTATCTCA.CTGGACACT
CTTATCTCA.TACTCGACC	CTTATCTCA.TACTCGACC
CTTATCTCA.TGATTCACC	CTTATCTCA.TGATTCACC
CTTATTGAG.TCGGATGTT	CTTATTGAG.TCGGATGTT
CTTCACTGT.AAGCAATCG	CTTCACTGT.AAGCAATCG
CTTCACTGT.ACCGTCCTA	CTTCACTGT.ACCGTCCTA
CTTCACTGT.AGGATTACT	CTTCACTGT.AGGATTACT
CTTCACTGT.GCAACACCT	CTTCACTGT.GCAACACCT
CTTCACTGT.TGCTCAGCG	CTTCACTGT.TGCTCAGCG
CTTCACTGT.TTCCAGATT	CTTCACTGT.TTCCAGATT
CTTCCGGTA.GTAGAGAGC	CTTCCGGTA.GTAGAGAGC
CTTCCGGTA.TAGTGATCC	CTTCCGGTA.TAGTGATCC
CTTCCGTGG.AACGTTCTT	CTTCCGTGG.AACGTTCTT
CTTCCGTGG.CCTGTATCT	CTTCCGTGG.CCTGTATCT
CTTCCTGAT.TAGCACACG	CTTCCTGAT.TAGCACACG
CTTCGACTG.ACCGATCGA	CTTCGACTG.ACCGATCGA
CTTCGACTG.GACACCGAT	CTTCGACTG.GACACCGAT
CTTCGTGCA.ACCGTCCTA	CTTCGTGCA.ACCGTCCTA
CTTCGTGCA.ATAGTCAGT	CTTCGTGCA.ATAGTCAGT
CTTCGTGCA.GTTGCTCAG	CTTCGTGCA.GTTGCTCAG
CTTCTATGA.CAGGAGCCT	CTTCTATGA.CAGGAGCCT
CTTCTATGA.GCTACAATG	CTTCTATGA.GCTACAATG
CTTCTATGA.TCAGTAAGC	CTTCTATGA.TCAGTAAGC
CTTCTATGA.TGTGTAGAG	CTTCTATGA.TGTGTAGAG
CTTCTCATC.CAAGTCGAA	CTTCTCATC.CAAGTCGAA
CTTCTCATC.CTCTCAGTC	CTTCTCATC.CTCTCAGTC
CTTCTCATC.GCTGACAGA	CTTCTCATC.GCTGACAGA
CTTCTGAGT.AGGTATTCC	CTTCTGAGT.AGGTATTCC
CTTCTGAGT.AGTAATGGT	CTTCTGAGT.AGTAATGGT
CTTCTGAGT.ATACCGCTT	CTTCTGAGT.ATACCGCTT
CTTCTGAGT.CAACTCCAG	CTTCTGAGT.CAACTCCAG
CTTCTGAGT.CAGGTTGTC	CTTCTGAGT.CAGGTTGTC
CTTCTGAGT.CGCTTGTAG	CTTCTGAGT.CGCTTGTAG
CTTCTGAGT.CGTGCCTAT	CTTCTGAGT.CGTGCCTAT
CTTGATCTA.AGTGTTCTG	CTTGATCTA.AGTGTTCTG
CTTGATCTA.CTACGTTGG	CTTGATCTA.CTACGTTGG
CTTGATCTA.CTCAGTGAT	CTTGATCTA.CTCAGTGAT
CTTGATCTA.TCTAGTGAC	CTTGATCTA.TCTAGTGAC
CTTGCACAA.ATAGCACGG	CTTGCACAA.ATAGCACGG
CTTGCACAA.ATCCGGTCC	CTTGCACAA.ATCCGGTCC
CTTGCACAA.CCATGCGTC	CTTGCACAA.CCATGCGTC
CTTGCACAA.CTCGTTCAC	CTTGCACAA.CTCGTTCAC
CTTGCGACC.ATCATAGAC	CTTGCGACC.ATCATAGAC
CTTGCGACC.CTGAGATAG	CTTGCGACC.CTGAGATAG
CTTGGATCA.GTGCGAGTA	CTTGGATCA.GTGCGAGTA
CTTGGATCA.TGCAGTCGG	CTTGGATCA.TGCAGTCGG
CTTGGATCA.TTCATTCGC	CTTGGATCA.TTCATTCGC
CTTGGTCAT.CACACCACA	CTTGGTCAT.CACACCACA
CTTGGTCAT.CCACATTAG	CTTGGTCAT.CCACATTAG
CTTGGTCAT.TACAACACC	CTTGGTCAT.TACAACACC
CTTGGTCAT.TCTAATACC	CTTGGTCAT.TCTAATACC
GAACAACCA.CAACCGGTC	GAACAACCA.CAACCGGTC
GAACAACCA.CGACCTAGC	GAACAACCA.CGACCTAGC
GAACAACCA.GTCAGCGTC	GAACAACCA.GTCAGCGTC
GAACAACCA.GTCCGCTCA	GAACAACCA.GTCCGCTCA
GAACAACCA.TCTCATCGG	GAACAACCA.TCTCATCGG
GAACATGAC.ATAACGACA	GAACATGAC.ATAACGACA
GAACATGAC.CCTAGCAAT	GAACATGAC.CCTAGCAAT
GAACATGAC.CTGTTACCA	GAACATGAC.CTGTTACCA
GAACATGAC.GAACTATGG	GAACATGAC.GAACTATGG
GAACATGAC.TCAGGACTG	GAACATGAC.TCAGGACTG
GAACCAGTT.GCGGAGATT	GAACCAGTT.GCGGAGATT
GAACCAGTT.TCGGTATCA	GAACCAGTT.TCGGTATCA
GAACCTTCA.CCGCAGAAT	GAACCTTCA.CCGCAGAAT
GAACGCTGT.GGTTGAAGG	GAACGCTGT.GGTTGAAGG
GAACTATGG.GTGTCCGTG	GAACTATGG.GTGTCCGTG
GAACTATGG.TACTCGCTG	GAACTATGG.TACTCGCTG
GAACTATGG.TCTATTAGG	GAACTATGG.TCTATTAGG
GAACTCGTA.GCCGTCTTC	GAACTCGTA.GCCGTCTTC
GAAGAGCAC.AAGTCATGA	GAAGAGCAC.AAGTCATGA
GAAGAGCAC.GTACGCGAT	GAAGAGCAC.GTACGCGAT
GAAGGATCA.AGCCAGGAC	GAAGGATCA.AGCCAGGAC
GAAGGATCA.GCTTAGAAC	GAAGGATCA.GCTTAGAAC
GAATAAGAG.ACACGTTGC	GAATAAGAG.ACACGTTGC
GAATAAGAG.CAACACCTA	GAATAAGAG.CAACACCTA
GAATAAGAG.CGATACTCT	GAATAAGAG.CGATACTCT
GAATCAACC.AATTGGATC	GAATCAACC.AATTGGATC
GAATCAACC.ACAGAGATG	GAATCAACC.ACAGAGATG
GAATCAACC.ATGGAGAGT	GAATCAACC.ATGGAGAGT
GAATCAACC.CCTGTTAGC	GAATCAACC.CCTGTTAGC
GAATCACAT.CCGATCAGC	GAATCACAT.CCGATCAGC
GAATCACAT.CCTCAGGTG	GAATCACAT.CCTCAGGTG
GAATCACAT.CTAACACTG	GAATCACAT.CTAACACTG
GAATCACAT.GGTGTGACC	GAATCACAT.GGTGTGACC
GAATCGAGA.TATCTGTCA	GAATCGAGA.TATCTGTCA
GAATCGAGA.TTCCTAAGG	GAATCGAGA.TTCCTAAGG
GAATTCAGT.ATCCTGCCT	GAATTCAGT.ATCCTGCCT
GAATTCAGT.TTATCCAAG	GAATTCAGT.TTATCCAAG
GAATTGTTG.ATGAGTGTG	GAATTGTTG.ATGAGTGTG
GAATTGTTG.ATGTCGCCT	GAATTGTTG.ATGTCGCCT
GAATTGTTG.GTAACTCAT	GAATTGTTG.GTAACTCAT
GAATTGTTG.TACCGATTG	GAATTGTTG.TACCGATTG
GAATTGTTG.TCAAGGAGT	GAATTGTTG.TCAAGGAGT
GAATTGTTG.TGAGAGGAC	GAATTGTTG.TGAGAGGAC
GACAATGTT.ACTCTAGGA	GACAATGTT.ACTCTAGGA
GACAATGTT.CATCCACCG	GACAATGTT.CATCCACCG
GACAATGTT.TAACGTGTC	GACAATGTT.TAACGTGTC
GACACCGAT.AGCTATATG	GACACCGAT.AGCTATATG
GACACCGAT.TGACAAGTT	GACACCGAT.TGACAAGTT
GACACGCAA.AGAGCGGAG	GACACGCAA.AGAGCGGAG
GACAGGTTA.AACGGAGAT	GACAGGTTA.AACGGAGAT
GACAGGTTA.CCTGTATCT	GACAGGTTA.CCTGTATCT
GACAGGTTA.TTCTCCACA	GACAGGTTA.TTCTCCACA
GACATAACG.GTGCTCTTG	GACATAACG.GTGCTCTTG
GACATATGT.CCTAGCAAT	GACATATGT.CCTAGCAAT
GACATATGT.GGATGCGAA	GACATATGT.GGATGCGAA
GACATATGT.TAGCCAGTG	GACATATGT.TAGCCAGTG
GACATATGT.TAGGAGCTA	GACATATGT.TAGGAGCTA
GACCAACAG.CCACCATGC	GACCAACAG.CCACCATGC
GACCAACAG.CGACCACTT	GACCAACAG.CGACCACTT
GACCAACAG.CTTGCACAA	GACCAACAG.CTTGCACAA
GACCAACAG.GTACCTAAC	GACCAACAG.GTACCTAAC
GACCAACAG.TGCCACCGA	GACCAACAG.TGCCACCGA
GACCAACAG.TGTGTAGAG	GACCAACAG.TGTGTAGAG
GACCACTCG.CCGATACCG	GACCACTCG.CCGATACCG
GACCACTCG.GGTCTCATG	GACCACTCG.GGTCTCATG
GACCACTCG.TATCCTCAG	GACCACTCG.TATCCTCAG
GACCAGAGA.ACATCGTCC	GACCAGAGA.ACATCGTCC
GACCAGAGA.ACGTGTAGT	GACCAGAGA.ACGTGTAGT
GACCAGAGA.ACTAAGTTC	GACCAGAGA.ACTAAGTTC
GACCAGAGA.ACTTAGCTT	GACCAGAGA.ACTTAGCTT
GACCAGAGA.TCATGCAGG	GACCAGAGA.TCATGCAGG
GACCGCTTC.CATAGGTGT	GACCGCTTC.CATAGGTGT
GACCGCTTC.GAACCAGTT	GACCGCTTC.GAACCAGTT
GACCGCTTC.GCTGATGTC	GACCGCTTC.GCTGATGTC
GACCGCTTC.TAGGATTAG	GACCGCTTC.TAGGATTAG
GACCGCTTC.TTGCTCTGC	GACCGCTTC.TTGCTCTGC
GACCGGTAG.AGAGCCGCA	GACCGGTAG.AGAGCCGCA
GACCGGTAG.ATACCGCTT	GACCGGTAG.ATACCGCTT
GACCGGTAG.ATAGTCAGT	GACCGGTAG.ATAGTCAGT
GACCGGTAG.CACCTCGGA	GACCGGTAG.CACCTCGGA
GACCGGTAG.CAGTACATC	GACCGGTAG.CAGTACATC
GACCGGTAG.TTGCCAGAT	GACCGGTAG.TTGCCAGAT
GACCGTAGT.AGTGAACGG	GACCGTAGT.AGTGAACGG
GACCGTAGT.AGTGACGAT	GACCGTAGT.AGTGACGAT
GACCGTAGT.GGTTCAGAC	GACCGTAGT.GGTTCAGAC
GACCTTGTG.CCTGTCGAC	GACCTTGTG.CCTGTCGAC
GACCTTGTG.CCTTCCTCA	GACCTTGTG.CCTTCCTCA
GACGCCGTA.CAACTAATC	GACGCCGTA.CAACTAATC
GACGCCGTA.GCACAACTC	GACGCCGTA.GCACAACTC
GACGCCGTA.GTTGCTCAG	GACGCCGTA.GTTGCTCAG
GACGCCGTA.TAACATTGG	GACGCCGTA.TAACATTGG
GACGCTTGC.ACTTCAGTA	GACGCTTGC.ACTTCAGTA
GACGCTTGC.ATCCAGCTG	GACGCTTGC.ATCCAGCTG
GACGCTTGC.ATTGACACG	GACGCTTGC.ATTGACACG
GACGCTTGC.GATGTAAGG	GACGCTTGC.GATGTAAGG
GACGCTTGC.GTACGCGAT	GACGCTTGC.GTACGCGAT
GACGCTTGC.TAAGCACTA	GACGCTTGC.TAAGCACTA
GACGCTTGC.TCTAGGATG	GACGCTTGC.TCTAGGATG
GACGGACTA.CCACGTTCT	GACGGACTA.CCACGTTCT
GACGGACTA.CCGCTCATG	GACGGACTA.CCGCTCATG
GACGGACTA.GTACCACAA	GACGGACTA.GTACCACAA
GACGGACTA.TCCTCTAGT	GACGGACTA.TCCTCTAGT
GACGGTGCT.CTCGTTCAC	GACGGTGCT.CTCGTTCAC
GACGGTGCT.CTGCTGCTT	GACGGTGCT.CTGCTGCTT
GACGGTGCT.GAACGCTGT	GACGGTGCT.GAACGCTGT
GACGGTGCT.GTAATATCG	GACGGTGCT.GTAATATCG
GACGTAGCA.AAGCAGCAT	GACGTAGCA.AAGCAGCAT
GACGTAGCA.GAATTGTTG	GACGTAGCA.GAATTGTTG
GACGTCAAT.ACAACGAGC	GACGTCAAT.ACAACGAGC
GACGTCAAT.CGTCTGTCC	GACGTCAAT.CGTCTGTCC
GACGTGGTC.AAGAGAGAG	GACGTGGTC.AAGAGAGAG
GACGTGGTC.CCAACGGAA	GACGTGGTC.CCAACGGAA
GACGTGGTC.GCCACGAGT	GACGTGGTC.GCCACGAGT
GACGTGGTC.GCGTGAGCT	GACGTGGTC.GCGTGAGCT
GACGTGGTC.GTCGTGTTA	GACGTGGTC.GTCGTGTTA
GACGTGGTC.TACACGGTC	GACGTGGTC.TACACGGTC
GACGTGGTC.TACGGTCGT	GACGTGGTC.TACGGTCGT
GACGTGGTC.TGACCTATG	GACGTGGTC.TGACCTATG
GACGTTCAG.ACTGGTGCT	GACGTTCAG.ACTGGTGCT
GACGTTCAG.GTCAGACCG	GACGTTCAG.GTCAGACCG
GACGTTCAG.TGATTGTGC	GACGTTCAG.TGATTGTGC
GACGTTCAG.TGGAGAGTG	GACGTTCAG.TGGAGAGTG
GACTAGCAT.CATTATGTC	GACTAGCAT.CATTATGTC
GACTAGCAT.GATGCGGTT	GACTAGCAT.GATGCGGTT
GACTAGCAT.TTGATCGTA	GACTAGCAT.TTGATCGTA
GACTCAGTG.AATCCTCGT	GACTCAGTG.AATCCTCGT
GACTCAGTG.AATGCACTT	GACTCAGTG.AATGCACTT
GACTCAGTG.AATGCTATC	GACTCAGTG.AATGCTATC
GACTCAGTG.ATGAGTGTG	GACTCAGTG.ATGAGTGTG
GACTCAGTG.CACCAGAAG	GACTCAGTG.CACCAGAAG
GACTCAGTG.GACGTCAAT	GACTCAGTG.GACGTCAAT
GACTCAGTG.GTCGACATT	GACTCAGTG.GTCGACATT
GACTCAGTG.TGGACTGCC	GACTCAGTG.TGGACTGCC
GACTCTCAC.AATCAGGAG	GACTCTCAC.AATCAGGAG
GACTCTCAC.AGAAGTCCT	GACTCTCAC.AGAAGTCCT
GACTCTCAC.AGCCTCGCA	GACTCTCAC.AGCCTCGCA
GACTCTCAC.CGTGGTACC	GACTCTCAC.CGTGGTACC
GACTCTCAC.TACTTACCA	GACTCTCAC.TACTTACCA
GACTCTCAC.TCCTTAGGT	GACTCTCAC.TCCTTAGGT
GACTCTCAC.TTCCTCGGT	GACTCTCAC.TTCCTCGGT
GACTCTGGT.ATGCCTGTC	GACTCTGGT.ATGCCTGTC
GACTCTGGT.CTCGAACTG	GACTCTGGT.CTCGAACTG
GACTCTGGT.GAACTATGG	GACTCTGGT.GAACTATGG
GACTGCGCA.ACGCAAGAT	GACTGCGCA.ACGCAAGAT
GACTGCGCA.ACTATCCTG	GACTGCGCA.ACTATCCTG
GACTGCGCA.CCTTGCTTG	GACTGCGCA.CCTTGCTTG
GACTGCGCA.TACCTCACT	GACTGCGCA.TACCTCACT
GACTTCACC.CAAGCGCAT	GACTTCACC.CAAGCGCAT
GACTTCACC.CCATGATGT	GACTTCACC.CCATGATGT
GACTTCACC.GATCGCGAA	GACTTCACC.GATCGCGAA
GACTTCACC.GCCTGGAAT	GACTTCACC.GCCTGGAAT
GACTTCACC.TAGTTGACG	GACTTCACC.TAGTTGACG
GACTTGATT.CCACATTAG	GACTTGATT.CCACATTAG
GACTTGATT.CTATCTTGA	GACTTGATT.CTATCTTGA
GACTTGATT.TCGTAATAG	GACTTGATT.TCGTAATAG
GACTTGATT.TGATGTGTG	GACTTGATT.TGATGTGTG
GAGAATCAG.CGCATAACT	GAGAATCAG.CGCATAACT
GAGAATCAG.TTGCCGTAG	GAGAATCAG.TTGCCGTAG
GAGACATTG.CTCCACGTC	GAGACATTG.CTCCACGTC
GAGACATTG.GATGCTCCT	GAGACATTG.GATGCTCCT
GAGACATTG.TTAGCGTCT	GAGACATTG.TTAGCGTCT
GAGACGATC.AGAAGTAAC	GAGACGATC.AGAAGTAAC
GAGACGATC.CCTTCCTCA	GAGACGATC.CCTTCCTCA
GAGACGATC.GGTCGGATA	GAGACGATC.GGTCGGATA
GAGACGATC.GTATCGTCG	GAGACGATC.GTATCGTCG
GAGACTCGA.GTACCACAA	GAGACTCGA.GTACCACAA
GAGACTCGA.GTGAGGACG	GAGACTCGA.GTGAGGACG
GAGACTCGA.TATCCTCAG	GAGACTCGA.TATCCTCAG
GAGATACAC.GTATGATCT	GAGATACAC.GTATGATCT
GAGATTCCT.AAGCAACTA	GAGATTCCT.AAGCAACTA
GAGATTCCT.ACCTTGAAG	GAGATTCCT.ACCTTGAAG
GAGATTCCT.ATCCGACCA	GAGATTCCT.ATCCGACCA
GAGATTCCT.CATAAGATC	GAGATTCCT.CATAAGATC
GAGATTCCT.CATAGAGAT	GAGATTCCT.CATAGAGAT
GAGATTCCT.TAGTAACGG	GAGATTCCT.TAGTAACGG
GAGATTCCT.TGCGACGTT	GAGATTCCT.TGCGACGTT
GAGCACATT.CAATACCAC	GAGCACATT.CAATACCAC
GAGCACATT.TCAACACTC	GAGCACATT.TCAACACTC
GAGCACATT.TGCGATACT	GAGCACATT.TGCGATACT
GAGCAGGAA.AGTTATCGC	GAGCAGGAA.AGTTATCGC
GAGCAGGAA.GAACCAGTT	GAGCAGGAA.GAACCAGTT
GAGCAGGAA.GAACGCTGT	GAGCAGGAA.GAACGCTGT
GAGCATACA.ACCGAGTAG	GAGCATACA.ACCGAGTAG
GAGCATACA.ACTCGTCTA	GAGCATACA.ACTCGTCTA
GAGCATACA.CCTTAACAT	GAGCATACA.CCTTAACAT
GAGCATACA.TCCTGTGGA	GAGCATACA.TCCTGTGGA
GAGCCATCC.CATCCAGGA	GAGCCATCC.CATCCAGGA
GAGCCATCC.GTGCTGACT	GAGCCATCC.GTGCTGACT
GAGCCATCC.TGCGTATCT	GAGCCATCC.TGCGTATCT
GAGCCGTTA.CATTGTTCA	GAGCCGTTA.CATTGTTCA
GAGCCGTTA.TAGACCTAC	GAGCCGTTA.TAGACCTAC
GAGCGACTC.ACACTGTGA	GAGCGACTC.ACACTGTGA
GAGCGACTC.ATCTAGGTT	GAGCGACTC.ATCTAGGTT
GAGCTCTCA.ACGGTGCCT	GAGCTCTCA.ACGGTGCCT
GAGCTCTCA.ACTACTCAT	GAGCTCTCA.ACTACTCAT
GAGCTCTCA.CTATACTAG	GAGCTCTCA.CTATACTAG
GAGCTCTCA.TCGAACGCT	GAGCTCTCA.TCGAACGCT
GAGCTCTCA.TTAGCGTCT	GAGCTCTCA.TTAGCGTCT
GAGGTCACG.GCGCTACCT	GAGGTCACG.GCGCTACCT
GAGGTCACG.TACAAGAGG	GAGGTCACG.TACAAGAGG
GAGGTCACG.TTCAACTAC	GAGGTCACG.TTCAACTAC
GAGGTCCTT.CAAGAGAGT	GAGGTCCTT.CAAGAGAGT
GAGGTCCTT.CCGATGTTC	GAGGTCCTT.CCGATGTTC
GAGGTCCTT.CGATTGAAC	GAGGTCCTT.CGATTGAAC
GAGGTCCTT.GCTACAATG	GAGGTCCTT.GCTACAATG
GAGGTCCTT.GCTCCTAGC	GAGGTCCTT.GCTCCTAGC
GAGGTCCTT.GGTTGAAGG	GAGGTCCTT.GGTTGAAGG
GAGGTGAGC.CTGTAGAAG	GAGGTGAGC.CTGTAGAAG
GAGGTGAGC.TCATCTGTC	GAGGTGAGC.TCATCTGTC
GAGGTGAGC.TTCCAGGAG	GAGGTGAGC.TTCCAGGAG
GAGTATCGC.GTGGTACGG	GAGTATCGC.GTGGTACGG
GAGTCACCA.AACTTGTCG	GAGTCACCA.AACTTGTCG
GAGTCACCA.ACGGACCAT	GAGTCACCA.ACGGACCAT
GAGTCACCA.AGAGGACGT	GAGTCACCA.AGAGGACGT
GAGTCCAAT.ACGTCGCTC	GAGTCCAAT.ACGTCGCTC
GAGTCCAAT.AGAGCGGAG	GAGTCCAAT.AGAGCGGAG
GAGTCCAAT.AGCAGACAA	GAGTCCAAT.AGCAGACAA
GAGTCCAAT.ATAGACCGA	GAGTCCAAT.ATAGACCGA
GAGTCCAAT.CTTGGTCAT	GAGTCCAAT.CTTGGTCAT
GAGTCCAAT.GCGTGAGCT	GAGTCCAAT.GCGTGAGCT
GAGTCCAAT.TACTTCCAG	GAGTCCAAT.TACTTCCAG
GAGTCGTAC.ACAGCGTAT	GAGTCGTAC.ACAGCGTAT
GAGTCTTCG.AATCAGGAG	GAGTCTTCG.AATCAGGAG
GAGTCTTCG.ATATAGCGT	GAGTCTTCG.ATATAGCGT
GAGTCTTCG.CACATATCA	GAGTCTTCG.CACATATCA
GAGTCTTCG.GCTCTGTGT	GAGTCTTCG.GCTCTGTGT
GAGTCTTCG.TATAATCGC	GAGTCTTCG.TATAATCGC
GAGTCTTCG.TTCCGAGCG	GAGTCTTCG.TTCCGAGCG
GAGTGCATA.GATGTCTAG	GAGTGCATA.GATGTCTAG
GAGTGCATA.TCGTAGGAA	GAGTGCATA.TCGTAGGAA
GAGTGCATA.TGACCTCCT	GAGTGCATA.TGACCTCCT
GAGTGCATA.TTCCAATTC	GAGTGCATA.TTCCAATTC
GAGTGTGCC.CACCAAGAT	GAGTGTGCC.CACCAAGAT
GAGTGTGCC.CTTATTGAG	GAGTGTGCC.CTTATTGAG
GAGTGTGCC.TGCACGATG	GAGTGTGCC.TGCACGATG
GAGTTAACT.ACCGACGGT	GAGTTAACT.ACCGACGGT
GAGTTAACT.CCTGACCTC	GAGTTAACT.CCTGACCTC
GAGTTAACT.CGCTTGTAG	GAGTTAACT.CGCTTGTAG
GAGTTAACT.GTAGCTACA	GAGTTAACT.GTAGCTACA
GAGTTAACT.TGAGTGACT	GAGTTAACT.TGAGTGACT
GAGTTATAG.ATGGAGGAA	GAGTTATAG.ATGGAGGAA
GAGTTATAG.GCGTCGTCT	GAGTTATAG.GCGTCGTCT
GAGTTATAG.TGCTATGAA	GAGTTATAG.TGCTATGAA
GAGTTATAG.TTCTGGTGC	GAGTTATAG.TTCTGGTGC
GATAACGTC.AGCCAGGAC	GATAACGTC.AGCCAGGAC
GATAACGTC.CGGTGTTAC	GATAACGTC.CGGTGTTAC
GATAACGTC.GTCCACAAC	GATAACGTC.GTCCACAAC
GATAACGTC.TGCTCACAC	GATAACGTC.TGCTCACAC
GATAAGCTG.ACGAGAGCA	GATAAGCTG.ACGAGAGCA
GATAAGCTG.ACGCGACAG	GATAAGCTG.ACGCGACAG
GATAAGCTG.AGTCGCCGA	GATAAGCTG.AGTCGCCGA
GATAAGCTG.CAGAGCACC	GATAAGCTG.CAGAGCACC
GATAAGCTG.CGCGCACAT	GATAAGCTG.CGCGCACAT
GATAAGCTG.TAGCGCAGC	GATAAGCTG.TAGCGCAGC
GATAAGCTG.TCACACTGC	GATAAGCTG.TCACACTGC
GATAAGCTG.TGAGCTAGA	GATAAGCTG.TGAGCTAGA
GATAAGCTG.TTGCAGTCA	GATAAGCTG.TTGCAGTCA
GATACACTA.CCATGATGT	GATACACTA.CCATGATGT
GATACACTA.CCTGTCATT	GATACACTA.CCTGTCATT
GATACACTA.TAGCAGAGT	GATACACTA.TAGCAGAGT
GATACACTA.TCCTCGTCG	GATACACTA.TCCTCGTCG
GATACCGGA.ATAGTGGTT	GATACCGGA.ATAGTGGTT
GATACCGGA.ATGCAGTTC	GATACCGGA.ATGCAGTTC
GATACCGGA.GATCTGTTC	GATACCGGA.GATCTGTTC
GATACTGTG.TTAGGAAGG	GATACTGTG.TTAGGAAGG
GATAGTTCT.CCGCTATCC	GATAGTTCT.CCGCTATCC
GATAGTTCT.CTTGGTCAT	GATAGTTCT.CTTGGTCAT
GATAGTTCT.GATTAGACA	GATAGTTCT.GATTAGACA
GATAGTTCT.TACTCGCTG	GATAGTTCT.TACTCGCTG
GATAGTTCT.TGCTATGAA	GATAGTTCT.TGCTATGAA
GATATATCC.ATCATGTTC	GATATATCC.ATCATGTTC
GATATATCC.CTAGTATAG	GATATATCC.CTAGTATAG
GATATATCC.CTTGATCTA	GATATATCC.CTTGATCTA
GATATATCC.GCATGTAAG	GATATATCC.GCATGTAAG
GATATATCC.TAACGGATA	GATATATCC.TAACGGATA
GATATATCC.TAGTGATCC	GATATATCC.TAGTGATCC
GATATGGAC.CACGCGTAA	GATATGGAC.CACGCGTAA
GATATGGAC.CTAGTCGTC	GATATGGAC.CTAGTCGTC
GATATGGAC.CTCTTCAGC	GATATGGAC.CTCTTCAGC
GATATGGAC.GCTTGGTTC	GATATGGAC.GCTTGGTTC
GATCCGCAC.AGACGCTAT	GATCCGCAC.AGACGCTAT
GATCCGCAC.TGGATAGGT	GATCCGCAC.TGGATAGGT
GATCGATAC.ATAAGACAG	GATCGATAC.ATAAGACAG
GATCGATAC.CCGATCAGC	GATCGATAC.CCGATCAGC
GATCGATAC.CTGATCCGA	GATCGATAC.CTGATCCGA
GATCGATAC.GAGCCATCC	GATCGATAC.GAGCCATCC
GATCGATAC.GTTATCGAT	GATCGATAC.GTTATCGAT
GATCGATAC.TCAGGACTG	GATCGATAC.TCAGGACTG
GATCGATAC.TTAAGTGGT	GATCGATAC.TTAAGTGGT
GATCGCACT.AGCATTCCA	GATCGCACT.AGCATTCCA
GATCGCACT.ATGCGCCGT	GATCGCACT.ATGCGCCGT
GATCGCACT.GCAATCACG	GATCGCACT.GCAATCACG
GATCGCACT.GTTGACCAT	GATCGCACT.GTTGACCAT
GATCGCGAA.AATCGCCAT	GATCGCGAA.AATCGCCAT
GATCGTTGA.ACGAGAGCA	GATCGTTGA.ACGAGAGCA
GATCGTTGA.CAATCTCCG	GATCGTTGA.CAATCTCCG
GATCGTTGA.CGCAATCGA	GATCGTTGA.CGCAATCGA
GATCGTTGA.CGGAAGACG	GATCGTTGA.CGGAAGACG
GATCGTTGA.GTGTTCCAG	GATCGTTGA.GTGTTCCAG
GATCTAGAG.CGGACAAGT	GATCTAGAG.CGGACAAGT
GATCTAGAG.GCGGAGATT	GATCTAGAG.GCGGAGATT
GATCTAGAG.TATCACCTG	GATCTAGAG.TATCACCTG
GATCTGAAT.AGCACCGTG	GATCTGAAT.AGCACCGTG
GATCTGAAT.ATAAGTTCG	GATCTGAAT.ATAAGTTCG
GATCTGAAT.TAACGTGTC	GATCTGAAT.TAACGTGTC
GATCTGTTC.ACCGTCACG	GATCTGTTC.ACCGTCACG
GATCTGTTC.ATATCAGCC	GATCTGTTC.ATATCAGCC
GATCTGTTC.CGTACATCT	GATCTGTTC.CGTACATCT
GATCTTCGC.ACCACGGAT	GATCTTCGC.ACCACGGAT
GATCTTCGC.AGCACACCT	GATCTTCGC.AGCACACCT
GATCTTCGC.CTTCGACTG	GATCTTCGC.CTTCGACTG
GATGCAGAA.ACATCGTCC	GATGCAGAA.ACATCGTCC
GATGCAGAA.CAAGTCACT	GATGCAGAA.CAAGTCACT
GATGCAGAA.GAACCTTCA	GATGCAGAA.GAACCTTCA
GATGCAGAA.GTGTCTGGA	GATGCAGAA.GTGTCTGGA
GATGCGACG.GTGGATAAG	GATGCGACG.GTGGATAAG
GATGCGGTT.CCATACGAT	GATGCGGTT.CCATACGAT
GATGCGGTT.GCGAAGACA	GATGCGGTT.GCGAAGACA
GATGCGGTT.TGGTCCTAG	GATGCGGTT.TGGTCCTAG
GATGCTCCT.AGATACGTT	GATGCTCCT.AGATACGTT
GATGCTCCT.CACAATAAC	GATGCTCCT.CACAATAAC
GATGCTCCT.CCAGCCAAT	GATGCTCCT.CCAGCCAAT
GATGTAAGG.CAGCTGGAG	GATGTAAGG.CAGCTGGAG
GATGTCTAG.CACCTACGC	GATGTCTAG.CACCTACGC
GATGTTACA.ATGTCCTCC	GATGTTACA.ATGTCCTCC
GATGTTACA.CATTATGTC	GATGTTACA.CATTATGTC
GATGTTACA.GTTCACTCC	GATGTTACA.GTTCACTCC
GATTAGACA.ATCATTACG	GATTAGACA.ATCATTACG
GATTAGACA.TCCAAGTAA	GATTAGACA.TCCAAGTAA
GATTAGACA.TGATTATCG	GATTAGACA.TGATTATCG
GATTAGTGT.AAGGATACG	GATTAGTGT.AAGGATACG
GATTAGTGT.GGTACTTCC	GATTAGTGT.GGTACTTCC
GATTAGTGT.TGGAGAGTG	GATTAGTGT.TGGAGAGTG
GATTATGCG.ACACTAACG	GATTATGCG.ACACTAACG
GATTATGCG.AGCAACATT	GATTATGCG.AGCAACATT
GATTATGCG.GCGTAACAA	GATTATGCG.GCGTAACAA
GATTATGCG.TAACTCCGA	GATTATGCG.TAACTCCGA
GATTATGCG.TCAAGGTCG	GATTATGCG.TCAAGGTCG
GATTCCTCT.AGTCTGGAA	GATTCCTCT.AGTCTGGAA
GATTCCTCT.GCGAAGCTC	GATTCCTCT.GCGAAGCTC
GATTGAGTA.AGCCGTTCT	GATTGAGTA.AGCCGTTCT
GATTGAGTA.CAAGCCTCG	GATTGAGTA.CAAGCCTCG
