GATTGAGTA.GTACGAACG	GATTGAGTA.GTACGAACG
GATTGAGTA.TAGCTGTTG	GATTGAGTA.TAGCTGTTG
GCAACACCT.AGGAATTGG	GCAACACCT.AGGAATTGG
GCAACACCT.CGGATTCTC	GCAACACCT.CGGATTCTC
GCAACACCT.TAGTCAGAC	GCAACACCT.TAGTCAGAC
GCAACCAAC.AGCGACACC	GCAACCAAC.AGCGACACC
GCAACCAAC.GAGACGATC	GCAACCAAC.GAGACGATC
GCAACCAAC.TAGACACGT	GCAACCAAC.TAGACACGT
GCAACTCGC.AACCATGGT	GCAACTCGC.AACCATGGT
GCAACTCGC.ACAGAGATG	GCAACTCGC.ACAGAGATG
GCAACTCGC.TGAGAATCC	GCAACTCGC.TGAGAATCC
GCAACTCGC.TGAGTGACT	GCAACTCGC.TGAGTGACT
GCAACTCGC.TTAGGAAGG	GCAACTCGC.TTAGGAAGG
GCAATCACG.CAACACCTA	GCAATCACG.CAACACCTA
GCAATCACG.GCTATGTAA	GCAATCACG.GCTATGTAA
GCAATGAGA.ACCACGGAT	GCAATGAGA.ACCACGGAT
GCAATGAGA.CCACTTCGC	GCAATGAGA.CCACTTCGC
GCACAACTC.ATCTTACAG	GCACAACTC.ATCTTACAG
GCACAACTC.CAATGTGCT	GCACAACTC.CAATGTGCT
GCACAACTC.CCGATACCG	GCACAACTC.CCGATACCG
GCACAACTC.CTCTAAGAG	GCACAACTC.CTCTAAGAG
GCACAACTC.CTTCCTGAT	GCACAACTC.CTTCCTGAT
GCACAACTC.CTTCGACTG	GCACAACTC.CTTCGACTG
GCACAACTC.TGAGCTAGA	GCACAACTC.TGAGCTAGA
GCACAGTAA.AGGAATTGG	GCACAGTAA.AGGAATTGG
GCACAGTAA.TAAGCACTA	GCACAGTAA.TAAGCACTA
GCACCATCG.ATGGAGAGT	GCACCATCG.ATGGAGAGT
GCACCATCG.CTTGGTCAT	GCACCATCG.CTTGGTCAT
GCACCATCG.GATTCCTCT	GCACCATCG.GATTCCTCT
GCACCATCG.GTGACTCTC	GCACCATCG.GTGACTCTC
GCACCATCG.TTCTGCCGA	GCACCATCG.TTCTGCCGA
GCACGCATT.ATTATGCAG	GCACGCATT.ATTATGCAG
GCACGCATT.CAAGCCTCG	GCACGCATT.CAAGCCTCG
GCACGCATT.GCGCTCTAT	GCACGCATT.GCGCTCTAT
GCACGCATT.TGGTAGCAG	GCACGCATT.TGGTAGCAG
GCACGTAGA.CAACCTGGT	GCACGTAGA.CAACCTGGT
GCACGTAGA.GATGCTCCT	GCACGTAGA.GATGCTCCT
GCACTGGAT.ACTTAGCTT	GCACTGGAT.ACTTAGCTT
GCACTGGAT.CTCCTATCT	GCACTGGAT.CTCCTATCT
GCACTGGAT.GCTACAATG	GCACTGGAT.GCTACAATG
GCACTGGAT.GGATACAAT	GCACTGGAT.GGATACAAT
GCAGATCCG.ACTATCCTG	GCAGATCCG.ACTATCCTG
GCAGATCCG.ATCTGCGTA	GCAGATCCG.ATCTGCGTA
GCAGATCCG.CCATAATCG	GCAGATCCG.CCATAATCG
GCAGCAGTG.ATCCGGTCC	GCAGCAGTG.ATCCGGTCC
GCAGCAGTG.CCTTGACGG	GCAGCAGTG.CCTTGACGG
GCAGCAGTG.TCTAGCTGG	GCAGCAGTG.TCTAGCTGG
GCAGCGATA.CAATTGTCT	GCAGCGATA.CAATTGTCT
GCAGCGATA.CACCTAGCG	GCAGCGATA.CACCTAGCG
GCAGCGATA.TCGATTCAG	GCAGCGATA.TCGATTCAG
GCAGCGATA.TTGATGCTG	GCAGCGATA.TTGATGCTG
GCAGCTCTT.AGGTCCGTC	GCAGCTCTT.AGGTCCGTC
GCAGCTCTT.CCTTCCTCA	GCAGCTCTT.CCTTCCTCA
GCAGCTCTT.GCCATCGCT	GCAGCTCTT.GCCATCGCT
GCAGCTCTT.GTGACGTAA	GCAGCTCTT.GTGACGTAA
GCAGCTTGA.CGATTCGAG	GCAGCTTGA.CGATTCGAG
GCAGGAGAA.AGCCGTTCT	GCAGGAGAA.AGCCGTTCT
GCAGGAGAA.CACCTACGC	GCAGGAGAA.CACCTACGC
GCAGGAGAA.CCGAATATG	GCAGGAGAA.CCGAATATG
GCAGGAGAA.TATGTATGC	GCAGGAGAA.TATGTATGC
GCAGGAGAA.TGTCGTACA	GCAGGAGAA.TGTCGTACA
GCAGGAGAA.TGTGTAGAG	GCAGGAGAA.TGTGTAGAG
GCATACATG.ACCATGTCT	GCATACATG.ACCATGTCT
GCATACATG.TGAGAATCC	GCATACATG.TGAGAATCC
GCATACATG.TGATGTGTG	GCATACATG.TGATGTGTG
GCATACATG.TGATTCACC	GCATACATG.TGATTCACC
GCATACATG.TTCACTCCT	GCATACATG.TTCACTCCT
GCATACTCC.CATTCCGAG	GCATACTCC.CATTCCGAG
GCATGTAAG.CACACCTGT	GCATGTAAG.CACACCTGT
GCATGTGGT.ATACAACCG	GCATGTGGT.ATACAACCG
GCATGTGGT.CATGCCAGT	GCATGTGGT.CATGCCAGT
GCATGTGGT.CGTGTCCGA	GCATGTGGT.CGTGTCCGA
GCATGTGGT.GCAGATCCG	GCATGTGGT.GCAGATCCG
GCATGTGGT.TATGTATGC	GCATGTGGT.TATGTATGC
GCATGTGGT.TCTTAAGTG	GCATGTGGT.TCTTAAGTG
GCATTGATC.AGGATTGAG	GCATTGATC.AGGATTGAG
GCATTGATC.CGAGCCGTT	GCATTGATC.CGAGCCGTT
GCATTGATC.CTAGTCGTC	GCATTGATC.CTAGTCGTC
GCATTGATC.GTAAGTGAG	GCATTGATC.GTAAGTGAG
GCCAACAAT.CACGGAAGT	GCCAACAAT.CACGGAAGT
GCCAACAAT.CGTGACCAG	GCCAACAAT.CGTGACCAG
GCCAATGAA.AGATCTTCA	GCCAATGAA.AGATCTTCA
GCCAATGAA.TCGTGACGT	GCCAATGAA.TCGTGACGT
GCCACATGG.ACTATTGTC	GCCACATGG.ACTATTGTC
GCCACATGG.AGCTTGGTG	GCCACATGG.AGCTTGGTG
GCCACATGG.AGGTGTACA	GCCACATGG.AGGTGTACA
GCCACATGG.CCGATGTTC	GCCACATGG.CCGATGTTC
GCCACATGG.CTGGACACT	GCCACATGG.CTGGACACT
GCCACATGG.CTTGGTCAT	GCCACATGG.CTTGGTCAT
GCCACATGG.GAGTCAAGG	GCCACATGG.GAGTCAAGG
GCCACATGG.GCACCATCG	GCCACATGG.GCACCATCG
GCCACGAGT.AATACGTCT	GCCACGAGT.AATACGTCT
GCCACGAGT.AATCGCCAT	GCCACGAGT.AATCGCCAT
GCCACGAGT.CTCTAAGAG	GCCACGAGT.CTCTAAGAG
GCCACGAGT.GCACTGGAT	GCCACGAGT.GCACTGGAT
GCCACGAGT.GGATGCTCG	GCCACGAGT.GGATGCTCG
GCCACGAGT.GTCTTCATA	GCCACGAGT.GTCTTCATA
GCCATACAA.AACGGAGAT	GCCATACAA.AACGGAGAT
GCCATACAA.ATATCAGCC	GCCATACAA.ATATCAGCC
GCCATACAA.CGGTTCTAT	GCCATACAA.CGGTTCTAT
GCCATACAA.CTTCGACTG	GCCATACAA.CTTCGACTG
GCCATACAA.GTCAAGATC	GCCATACAA.GTCAAGATC
GCCATACAA.TACCAGCCA	GCCATACAA.TACCAGCCA
GCCATCGCT.AATCCTCGT	GCCATCGCT.AATCCTCGT
GCCATCGCT.GAAGGATCA	GCCATCGCT.GAAGGATCA
GCCATTAAG.AGGTCACGT	GCCATTAAG.AGGTCACGT
GCCATTAAG.GAAGTGTGA	GCCATTAAG.GAAGTGTGA
GCCGAACCA.TGCGATACT	GCCGAACCA.TGCGATACT
GCCGAACCA.TGCTTACGG	GCCGAACCA.TGCTTACGG
GCCGAGTCT.CTCATTAGT	GCCGAGTCT.CTCATTAGT
GCCGAGTCT.GAGTTAACT	GCCGAGTCT.GAGTTAACT
GCCGAGTCT.GGTAGTGTT	GCCGAGTCT.GGTAGTGTT
GCCGAGTCT.GTCTTATGC	GCCGAGTCT.GTCTTATGC
GCCGCCTAA.ACTACCATC	GCCGCCTAA.ACTACCATC
GCCGCCTAA.CAACTAATC	GCCGCCTAA.CAACTAATC
GCCGCCTAA.GAGGTCACG	GCCGCCTAA.GAGGTCACG
GCCGCCTAA.GCGCTAGAA	GCCGCCTAA.GCGCTAGAA
GCCGCCTAA.GTGCTCTTG	GCCGCCTAA.GTGCTCTTG
GCCGCCTAA.TGCCTGGTT	GCCGCCTAA.TGCCTGGTT
GCCGCTATC.CCTCTGCAT	GCCGCTATC.CCTCTGCAT
GCCGCTATC.CTTCGTGCA	GCCGCTATC.CTTCGTGCA
GCCGCTATC.GTTAGATTG	GCCGCTATC.GTTAGATTG
GCCGCTATC.TGAGTGACT	GCCGCTATC.TGAGTGACT
GCCGTCTTC.ACCTGCAGA	GCCGTCTTC.ACCTGCAGA
GCCGTCTTC.AGAGAGTGG	GCCGTCTTC.AGAGAGTGG
GCCGTCTTC.AGAGCGCGA	GCCGTCTTC.AGAGCGCGA
GCCGTCTTC.CGACCTGTA	GCCGTCTTC.CGACCTGTA
GCCGTCTTC.CTTCACTGT	GCCGTCTTC.CTTCACTGT
GCCGTCTTC.TGCGCTGCA	GCCGTCTTC.TGCGCTGCA
GCCGTCTTC.TTCTGCCGA	GCCGTCTTC.TTCTGCCGA
GCCGTGAAC.ACCGGAGTA	GCCGTGAAC.ACCGGAGTA
GCCGTGAAC.AGGTCAGCA	GCCGTGAAC.AGGTCAGCA
GCCGTGAAC.ATAGCTTGC	GCCGTGAAC.ATAGCTTGC
GCCGTGAAC.GACGGTGCT	GCCGTGAAC.GACGGTGCT
GCCGTGAAC.TTCTGGTGC	GCCGTGAAC.TTCTGGTGC
GCCGTTGTT.AGTCGCCGA	GCCGTTGTT.AGTCGCCGA
GCCGTTGTT.GCCTTATCT	GCCGTTGTT.GCCTTATCT
GCCGTTGTT.TTAGTCGGA	GCCGTTGTT.TTAGTCGGA
GCCTAACGG.AAGCAGCAT	GCCTAACGG.AAGCAGCAT
GCCTAACGG.ACGATGACC	GCCTAACGG.ACGATGACC
GCCTAACGG.ACGTCGCTC	GCCTAACGG.ACGTCGCTC
GCCTAACGG.ATAATCGAG	GCCTAACGG.ATAATCGAG
GCCTAACGG.CATTCGAAT	GCCTAACGG.CATTCGAAT
GCCTAACGG.CCGCAGAAT	GCCTAACGG.CCGCAGAAT
GCCTAACGG.TACGACTTG	GCCTAACGG.TACGACTTG
GCCTGCATC.CACGACTCA	GCCTGCATC.CACGACTCA
GCCTGCATC.TGAGGTCTC	GCCTGCATC.TGAGGTCTC
GCCTGCATC.TTCCATACC	GCCTGCATC.TTCCATACC
GCCTGGAAT.CTAACTAAG	GCCTGGAAT.CTAACTAAG
GCCTGGAAT.GAGCAGGAA	GCCTGGAAT.GAGCAGGAA
GCCTGGAAT.GATCTAGAG	GCCTGGAAT.GATCTAGAG
GCCTGGAAT.GGTTCTATC	GCCTGGAAT.GGTTCTATC
GCCTGGAAT.TGTGAGTAT	GCCTGGAAT.TGTGAGTAT
GCCTTAGAG.AAGTTCTCT	GCCTTAGAG.AAGTTCTCT
GCCTTAGAG.AGAGGTGAA	GCCTTAGAG.AGAGGTGAA
GCCTTAGAG.GTGTCTGGA	GCCTTAGAG.GTGTCTGGA
GCCTTAGAG.TCGGATGTT	GCCTTAGAG.TCGGATGTT
GCCTTAGAG.TTCGCTGAG	GCCTTAGAG.TTCGCTGAG
GCCTTATCT.ACATCGTCC	GCCTTATCT.ACATCGTCC
GCCTTATCT.AGGTCAGCA	GCCTTATCT.AGGTCAGCA
GCCTTATCT.GCATACTCC	GCCTTATCT.GCATACTCC
GCCTTCCAT.AAGGATCGT	GCCTTCCAT.AAGGATCGT
GCCTTGTGA.AGTTGCCTT	GCCTTGTGA.AGTTGCCTT
GCCTTGTGA.CAGGAGCCT	GCCTTGTGA.CAGGAGCCT
GCCTTGTGA.TTCATTCGC	GCCTTGTGA.TTCATTCGC
GCGAACTCG.CTCGAACTG	GCGAACTCG.CTCGAACTG
GCGAACTCG.CTTCCTGAT	GCGAACTCG.CTTCCTGAT
GCGAACTCG.TAGACACGT	GCGAACTCG.TAGACACGT
GCGAAGACA.TACGAACTC	GCGAAGACA.TACGAACTC
GCGAAGACA.TTCGCATCC	GCGAAGACA.TTCGCATCC
GCGAAGCTC.CCGTCCACT	GCGAAGCTC.CCGTCCACT
GCGAAGCTC.TAGATAGCC	GCGAAGCTC.TAGATAGCC
GCGACAACC.AACAACCTA	GCGACAACC.AACAACCTA
GCGACAACC.GAAGTGTGA	GCGACAACC.GAAGTGTGA
GCGACAACC.TAGTCAGAC	GCGACAACC.TAGTCAGAC
GCGACACAG.CCGGTGGTT	GCGACACAG.CCGGTGGTT
GCGACACAG.CTTAATCGT	GCGACACAG.CTTAATCGT
GCGACACAG.GGACAGATT	GCGACACAG.GGACAGATT
GCGACCTGT.AACGGTAGC	GCGACCTGT.AACGGTAGC
GCGACCTGT.TACTAGTAG	GCGACCTGT.TACTAGTAG
GCGACCTGT.TCATCATCT	GCGACCTGT.TCATCATCT
GCGAGCAAG.AACGTTCTT	GCGAGCAAG.AACGTTCTT
GCGAGCAAG.TCATATCGC	GCGAGCAAG.TCATATCGC
GCGAGTCTA.CACCAGAAG	GCGAGTCTA.CACCAGAAG
GCGAGTCTA.CCATCTAGG	GCGAGTCTA.CCATCTAGG
GCGAGTCTA.CCTTAATTC	GCGAGTCTA.CCTTAATTC
GCGAGTCTA.GCTACCGAG	GCGAGTCTA.GCTACCGAG
GCGATATGA.AGTGAACGG	GCGATATGA.AGTGAACGG
GCGATATGA.GTGTTCCAG	GCGATATGA.GTGTTCCAG
GCGATATGA.TGAGATCAT	GCGATATGA.TGAGATCAT
GCGATATGA.TGCTCCTCC	GCGATATGA.TGCTCCTCC
GCGATATGA.TTATCCAAG	GCGATATGA.TTATCCAAG
GCGATATGA.TTCTGAATG	GCGATATGA.TTCTGAATG
GCGATATGA.TTCTGCCGA	GCGATATGA.TTCTGCCGA
GCGATGGTG.AGAAGTCCT	GCGATGGTG.AGAAGTCCT
GCGATGGTG.AGCTGCACT	GCGATGGTG.AGCTGCACT
GCGATGGTG.TGCCAGACG	GCGATGGTG.TGCCAGACG
GCGCATTAC.CACCTACGC	GCGCATTAC.CACCTACGC
GCGCATTAC.GCTGATGTC	GCGCATTAC.GCTGATGTC
GCGCTACCT.CGTACATCT	GCGCTACCT.CGTACATCT
GCGCTACCT.CGTCATGGA	GCGCTACCT.CGTCATGGA
GCGCTACCT.CTAACTAAG	GCGCTACCT.CTAACTAAG
GCGCTACCT.GATACTGTG	GCGCTACCT.GATACTGTG
GCGCTACCT.GATGTAAGG	GCGCTACCT.GATGTAAGG
GCGCTAGAA.AGGTATTCC	GCGCTAGAA.AGGTATTCC
GCGCTAGAA.CACTACAGG	GCGCTAGAA.CACTACAGG
GCGCTAGAA.CCTGCGTTA	GCGCTAGAA.CCTGCGTTA
GCGCTAGAA.CTGATCAAG	GCGCTAGAA.CTGATCAAG
GCGCTAGAA.CTTGCACAA	GCGCTAGAA.CTTGCACAA
GCGCTCTAT.AGTGAACGG	GCGCTCTAT.AGTGAACGG
GCGCTCTAT.CAATGTGCT	GCGCTCTAT.CAATGTGCT
GCGCTCTAT.CCTCTGCAT	GCGCTCTAT.CCTCTGCAT
GCGCTTCTC.ATACGAGGT	GCGCTTCTC.ATACGAGGT
GCGGACGAA.AAGCTTGCA	GCGGACGAA.AAGCTTGCA
GCGGACGAA.AGGTCCGTC	GCGGACGAA.AGGTCCGTC
GCGGAGATT.AACTTAGCT	GCGGAGATT.AACTTAGCT
GCGGTAAGT.CCATAATCG	GCGGTAAGT.CCATAATCG
GCGGTAAGT.TCAGGTGCA	GCGGTAAGT.TCAGGTGCA
GCGGTAAGT.TGAACCAAT	GCGGTAAGT.TGAACCAAT
GCGGTAAGT.TGATAGAGG	GCGGTAAGT.TGATAGAGG
GCGGTAAGT.TTCCTGCTA	GCGGTAAGT.TTCCTGCTA
GCGGTAGTC.CCGCAGCTA	GCGGTAGTC.CCGCAGCTA
GCGGTAGTC.GTGTCACAC	GCGGTAGTC.GTGTCACAC
GCGGTAGTC.TGGAACTAA	GCGGTAGTC.TGGAACTAA
GCGTAACAA.ATGCTCACC	GCGTAACAA.ATGCTCACC
GCGTAACAA.GCAGCGATA	GCGTAACAA.GCAGCGATA
GCGTAACAA.GCGTCGTCT	GCGTAACAA.GCGTCGTCT
GCGTATAGG.AGCAACATT	GCGTATAGG.AGCAACATT
GCGTATAGG.ATAGTCAGT	GCGTATAGG.ATAGTCAGT
GCGTATAGG.CAAGTCGAA	GCGTATAGG.CAAGTCGAA
GCGTCGTCT.ATGACACAA	GCGTCGTCT.ATGACACAA
GCGTCGTCT.CTGTCTAGT	GCGTCGTCT.CTGTCTAGT
GCGTCGTCT.GGTTCGCAA	GCGTCGTCT.GGTTCGCAA
GCGTGAGCT.AGCCGGATC	GCGTGAGCT.AGCCGGATC
GCGTGAGCT.GAGACGATC	GCGTGAGCT.GAGACGATC
GCGTGAGCT.GCTGGTAAC	GCGTGAGCT.GCTGGTAAC
GCGTGATAC.CCGTTAGAC	GCGTGATAC.CCGTTAGAC
GCGTGATAC.CGCAGTGTC	GCGTGATAC.CGCAGTGTC
GCGTGATAC.GAATCACAT	GCGTGATAC.GAATCACAT
GCGTGATAC.GCTGTTCGG	GCGTGATAC.GCTGTTCGG
GCGTGATAC.TACTAGTAG	GCGTGATAC.TACTAGTAG
GCGTGATAC.TAGTACGTA	GCGTGATAC.TAGTACGTA
GCGTTCAGA.ACAGAAGAG	GCGTTCAGA.ACAGAAGAG
GCGTTCAGA.ACGATGGAA	GCGTTCAGA.ACGATGGAA
GCGTTCAGA.ACGTGTAGT	GCGTTCAGA.ACGTGTAGT
GCTACAATG.ACGAGCTTC	GCTACAATG.ACGAGCTTC
GCTACAATG.AGATATGGA	GCTACAATG.AGATATGGA
GCTACAATG.CACAACCAG	GCTACAATG.CACAACCAG
GCTACAATG.CTGTGGTGG	GCTACAATG.CTGTGGTGG
GCTACCGAG.TGGTTATAC	GCTACCGAG.TGGTTATAC
GCTACCTTA.CAGTACATC	GCTACCTTA.CAGTACATC
GCTACCTTA.CTGACGGAT	GCTACCTTA.CTGACGGAT
GCTAGCTCC.ACTCATTCA	GCTAGCTCC.ACTCATTCA
GCTAGCTCC.GATTAGACA	GCTAGCTCC.GATTAGACA
GCTAGCTCC.GCGCTAGAA	GCTAGCTCC.GCGCTAGAA
GCTAGCTCC.GTCTCCAGG	GCTAGCTCC.GTCTCCAGG
GCTAGCTCC.GTTGACCAT	GCTAGCTCC.GTTGACCAT
GCTAGTGGA.TGGTCCTAG	GCTAGTGGA.TGGTCCTAG
GCTAGTGGA.TTCAGTGCC	GCTAGTGGA.TTCAGTGCC
GCTATGTAA.AGATGTTGG	GCTATGTAA.AGATGTTGG
GCTATGTAA.CCACGCCAT	GCTATGTAA.CCACGCCAT
GCTATGTAA.GCAACCAAC	GCTATGTAA.GCAACCAAC
GCTCAATGA.AACGAGAAT	GCTCAATGA.AACGAGAAT
GCTCAATGA.AGCGCATGA	GCTCAATGA.AGCGCATGA
GCTCAATGA.CTTCGACTG	GCTCAATGA.CTTCGACTG
GCTCAATGA.TGACCTCCT	GCTCAATGA.TGACCTCCT
GCTCAGCCA.CTCTAGTAA	GCTCAGCCA.CTCTAGTAA
GCTCAGCCA.TAGCAGAGT	GCTCAGCCA.TAGCAGAGT
GCTCAGCCA.TATTCAACG	GCTCAGCCA.TATTCAACG
GCTCCTAGC.AGTACGAAT	GCTCCTAGC.AGTACGAAT
GCTCCTAGC.CGCGTGAGA	GCTCCTAGC.CGCGTGAGA
GCTCCTAGC.TAAGTGTAG	GCTCCTAGC.TAAGTGTAG
GCTCCTAGC.TATACCACT	GCTCCTAGC.TATACCACT
GCTCTCCAA.GATTGAGTA	GCTCTCCAA.GATTGAGTA
GCTCTGTGT.ATTCGCTTA	GCTCTGTGT.ATTCGCTTA
GCTCTGTGT.CAGTGAGGA	GCTCTGTGT.CAGTGAGGA
GCTCTGTGT.CTGCAGAGC	GCTCTGTGT.CTGCAGAGC
GCTCTGTGT.GAATAAGAG	GCTCTGTGT.GAATAAGAG
GCTCTGTGT.TAGGTTAGT	GCTCTGTGT.TAGGTTAGT
GCTGACAGA.ACAAGTACA	GCTGACAGA.ACAAGTACA
GCTGACAGA.AGCAAGTCC	GCTGACAGA.AGCAAGTCC
GCTGACAGA.CCGGATTGC	GCTGACAGA.CCGGATTGC
GCTGACAGA.CGCGTGAGA	GCTGACAGA.CGCGTGAGA
GCTGACAGA.GCTAGCTCC	GCTGACAGA.GCTAGCTCC
GCTGACAGA.GGAACTGCT	GCTGACAGA.GGAACTGCT
GCTGAGCAG.CCGCAGAAT	GCTGAGCAG.CCGCAGAAT
GCTGAGCAG.CGTGCCTAT	GCTGAGCAG.CGTGCCTAT
GCTGAGCAG.GATACTGTG	GCTGAGCAG.GATACTGTG
GCTGAGCAG.GTCCTTCAT	GCTGAGCAG.GTCCTTCAT
GCTGGTAAC.GCCGCTATC	GCTGGTAAC.GCCGCTATC
GCTGGTTCG.GCCATTAAG	GCTGGTTCG.GCCATTAAG
GCTGGTTCG.GCGATGGTG	GCTGGTTCG.GCGATGGTG
GCTGGTTCG.GGTGAGTTC	GCTGGTTCG.GGTGAGTTC
GCTGTTCGG.ATATAGCGT	GCTGTTCGG.ATATAGCGT
GCTGTTCGG.CACTGGTCC	GCTGTTCGG.CACTGGTCC
GCTGTTCGG.CCACATTAG	GCTGTTCGG.CCACATTAG
GCTGTTCGG.CGACCATCA	GCTGTTCGG.CGACCATCA
GCTGTTCGG.CGTTGATCC	GCTGTTCGG.CGTTGATCC
GCTGTTCGG.TAGGTTAGT	GCTGTTCGG.TAGGTTAGT
GCTGTTCGG.TGAACCAAT	GCTGTTCGG.TGAACCAAT
GCTTACGTT.AGCCGGATC	GCTTACGTT.AGCCGGATC
GCTTACGTT.CACTTCCTT	GCTTACGTT.CACTTCCTT
GCTTACGTT.CATTGACAA	GCTTACGTT.CATTGACAA
GCTTACGTT.GTGTATCTG	GCTTACGTT.GTGTATCTG
GCTTACGTT.TCCGATAAC	GCTTACGTT.TCCGATAAC
GCTTACGTT.TTCTGGTGC	GCTTACGTT.TTCTGGTGC
GCTTACGTT.TTGTATCAC	GCTTACGTT.TTGTATCAC
GCTTACTAG.CTGAGTCCA	GCTTACTAG.CTGAGTCCA
GCTTAGAAC.CACAACGCT	GCTTAGAAC.CACAACGCT
GCTTAGAAC.CCTCCTTGT	GCTTAGAAC.CCTCCTTGT
GCTTAGAAC.GCAACCAAC	GCTTAGAAC.GCAACCAAC
GCTTCACTC.AATGCGTGC	GCTTCACTC.AATGCGTGC
GCTTCACTC.AGTAACGTA	GCTTCACTC.AGTAACGTA
GCTTCACTC.GCCAACAAT	GCTTCACTC.GCCAACAAT
GCTTCACTC.GCGTGAGCT	GCTTCACTC.GCGTGAGCT
GCTTCACTC.TCGATTCAG	GCTTCACTC.TCGATTCAG
GCTTCTGAA.AGTTATCGC	GCTTCTGAA.AGTTATCGC
GCTTCTGAA.CCATAATCG	GCTTCTGAA.CCATAATCG
GCTTCTGAA.CTAGAGGTA	GCTTCTGAA.CTAGAGGTA
GCTTCTGAA.CTGAGATAG	GCTTCTGAA.CTGAGATAG
GCTTCTGAA.GTAACGCGA	GCTTCTGAA.GTAACGCGA
GCTTCTGAA.GTCAAGATC	GCTTCTGAA.GTCAAGATC
GCTTCTGAA.TGACAAGTT	GCTTCTGAA.TGACAAGTT
GCTTGGTTC.AGTTCGATA	GCTTGGTTC.AGTTCGATA
GCTTGGTTC.ATCAGTCGA	GCTTGGTTC.ATCAGTCGA
GCTTGTCCT.ATCTGCGTA	GCTTGTCCT.ATCTGCGTA
GCTTGTCCT.TTCCTCGGT	GCTTGTCCT.TTCCTCGGT
GGAACCTAG.CGCAACCTC	GGAACCTAG.CGCAACCTC
GGAACCTAG.CTGGTCGGT	GGAACCTAG.CTGGTCGGT
GGAACCTAG.GCAGATCCG	GGAACCTAG.GCAGATCCG
GGAACCTAG.TGCAGTTCA	GGAACCTAG.TGCAGTTCA
GGAACTGCT.GACATATGT	GGAACTGCT.GACATATGT
GGAAGAAGC.TGAGCTAGA	GGAAGAAGC.TGAGCTAGA
GGAAGAAGC.TGCATACAT	GGAAGAAGC.TGCATACAT
GGAAGAAGC.TTGATGCTG	GGAAGAAGC.TTGATGCTG
GGAAGGTAT.AACGTTCTT	GGAAGGTAT.AACGTTCTT
GGAAGGTAT.AATCGCCAT	GGAAGGTAT.AATCGCCAT
GGAAGGTAT.AGTATGACG	GGAAGGTAT.AGTATGACG
GGAAGGTAT.ATTCGCTTA	GGAAGGTAT.ATTCGCTTA
GGAAGGTAT.CGAGTAGCA	GGAAGGTAT.CGAGTAGCA
GGAAGGTAT.GCCTTATCT	GGAAGGTAT.GCCTTATCT
GGAAGTATG.CAACACCTA	GGAAGTATG.CAACACCTA
GGAATTCAC.CTTATCTCA	GGAATTCAC.CTTATCTCA
GGAATTCAC.GTCGCAGGT	GGAATTCAC.GTCGCAGGT
GGAATTCAC.TCTCGATGC	GGAATTCAC.TCTCGATGC
GGAATTGGA.AGTCGCGAC	GGAATTGGA.AGTCGCGAC
GGAATTGGA.GTATACAGA	GGAATTGGA.GTATACAGA
GGAATTGGA.TGACTGAGA	GGAATTGGA.TGACTGAGA
GGAATTGGA.TGAGCAGAT	GGAATTGGA.TGAGCAGAT
GGACACTGG.ACGTTCAAT	GGACACTGG.ACGTTCAAT
GGACACTGG.ATCAGGATG	GGACACTGG.ATCAGGATG
GGACACTGG.CCACGCCAT	GGACACTGG.CCACGCCAT
GGACACTGG.CCTTAATTC	GGACACTGG.CCTTAATTC
GGACACTGG.GACGTCAAT	GGACACTGG.GACGTCAAT
GGACACTGG.GCCTTAGAG	GGACACTGG.GCCTTAGAG
GGACACTGG.TCGGACAGT	GGACACTGG.TCGGACAGT
GGACAGATT.AGAGCCGCA	GGACAGATT.AGAGCCGCA
GGACAGATT.AGATCTTCA	GGACAGATT.AGATCTTCA
GGACAGATT.CACTCACTA	GGACAGATT.CACTCACTA
GGACAGATT.CAGTCCTAA	GGACAGATT.CAGTCCTAA
GGACGAGCA.TCCGTATAC	GGACGAGCA.TCCGTATAC
GGACGAGCA.TTGAGCTCT	GGACGAGCA.TTGAGCTCT
GGAGAATGA.ATATGTCCA	GGAGAATGA.ATATGTCCA
GGAGAATGA.CATGACGTT	GGAGAATGA.CATGACGTT
GGAGAATGA.CATGGTCGA	GGAGAATGA.CATGGTCGA
GGAGAATGA.TCACACTGC	GGAGAATGA.TCACACTGC
GGAGAATGA.TTACACCTT	GGAGAATGA.TTACACCTT
GGAGACACA.CGACCATCA	GGAGACACA.CGACCATCA
GGAGACACA.GCACTGGAT	GGAGACACA.GCACTGGAT
GGAGACACA.TATGATGTG	GGAGACACA.TATGATGTG
GGAGATGAG.GAACTGCAA	GGAGATGAG.GAACTGCAA
GGAGATGAG.TAGTAGTCT	GGAGATGAG.TAGTAGTCT
GGAGATGAG.TGCGCACTG	GGAGATGAG.TGCGCACTG
GGAGCATCT.TACCTATCC	GGAGCATCT.TACCTATCC
GGAGCATCT.TACGACCAT	GGAGCATCT.TACGACCAT
GGAGCATCT.TGTATGTAG	GGAGCATCT.TGTATGTAG
GGAGCTCAA.ACGTATGTC	GGAGCTCAA.ACGTATGTC
GGAGCTCAA.CATTGCAGA	GGAGCTCAA.CATTGCAGA
GGAGTACAG.AGTGAGAGA	GGAGTACAG.AGTGAGAGA
GGAGTTAGC.GACGGTGCT	GGAGTTAGC.GACGGTGCT
GGATAATAC.AGGATTGAG	GGATAATAC.AGGATTGAG
GGATAATAC.CCTCGCGTT	GGATAATAC.CCTCGCGTT
GGATAATAC.CTTACCTAG	GGATAATAC.CTTACCTAG
GGATAATAC.GCAACTCGC	GGATAATAC.GCAACTCGC
GGATAATAC.GGAATTCAC	GGATAATAC.GGAATTCAC
GGATAATAC.GGTAGCATC	GGATAATAC.GGTAGCATC
GGATACAAT.AGAAGCTGC	GGATACAAT.AGAAGCTGC
GGATACAAT.CCACGAAGG	GGATACAAT.CCACGAAGG
GGATACAAT.GATCGCACT	GGATACAAT.GATCGCACT
GGATACAAT.GTGGAGGTC	GGATACAAT.GTGGAGGTC
GGATACAAT.TAGCACACG	GGATACAAT.TAGCACACG
GGATACAAT.TGCTCAGCG	GGATACAAT.TGCTCAGCG
GGATACCTA.AAGGTGCTG	GGATACCTA.AAGGTGCTG
GGATACCTA.CATGACGTT	GGATACCTA.CATGACGTT
GGATACCTA.GCTGACAGA	GGATACCTA.GCTGACAGA
GGATACCTA.TACCTATCC	GGATACCTA.TACCTATCC
GGATACCTA.TGAACTTGC	GGATACCTA.TGAACTTGC
GGATAGTCA.TGCAACTCT	GGATAGTCA.TGCAACTCT
GGATCAATG.ATTCACCTC	GGATCAATG.ATTCACCTC
GGATCAATG.CTCGTCTTG	GGATCAATG.CTCGTCTTG
GGATCAATG.GCAACACCT	GGATCAATG.GCAACACCT
GGATCAATG.GCAGGAGAA	GGATCAATG.GCAGGAGAA
GGATCAATG.GTCTGACGT	GGATCAATG.GTCTGACGT
GGATCAATG.TTGAGACGG	GGATCAATG.TTGAGACGG
GGATCAGGT.ACCATGTCT	GGATCAGGT.ACCATGTCT
GGATCAGGT.ATGCGGATT	GGATCAGGT.ATGCGGATT
GGATCAGGT.GCGAGCAAG	GGATCAGGT.GCGAGCAAG
GGATCAGGT.TCTATTAGG	GGATCAGGT.TCTATTAGG
GGATCGTTC.GGTCGGTCT	GGATCGTTC.GGTCGGTCT
GGATGCGAA.ATGGAGGAA	GGATGCGAA.ATGGAGGAA
GGATGCGAA.TTCGCATCC	GGATGCGAA.TTCGCATCC
GGATGCTCG.AGTCATACT	GGATGCTCG.AGTCATACT
GGATGCTCG.TAGGAGCTA	GGATGCTCG.TAGGAGCTA
GGATGCTCG.TCCACCGGT	GGATGCTCG.TCCACCGGT
GGATTACGC.AATTCGGAA	GGATTACGC.AATTCGGAA
GGATTACGC.CCGACTTGG	GGATTACGC.CCGACTTGG
GGATTACGC.GATCGCACT	GGATTACGC.GATCGCACT
GGATTACGC.GGAGCTCAA	GGATTACGC.GGAGCTCAA
GGATTACGC.GTGCCATGA	GGATTACGC.GTGCCATGA
GGATTCGTC.AATGCCTCA	GGATTCGTC.AATGCCTCA
GGATTCGTC.AGCCTCGCA	GGATTCGTC.AGCCTCGCA
GGATTCGTC.CAACGCACA	GGATTCGTC.CAACGCACA
GGATTCGTC.CGTGGTACC	GGATTCGTC.CGTGGTACC
GGATTCGTC.GCCGCTATC	GGATTCGTC.GCCGCTATC
GGATTCGTC.GTCTGAGCC	GGATTCGTC.GTCTGAGCC
GGATTCGTC.TCAATCTAG	GGATTCGTC.TCAATCTAG
GGTAACTAC.AGGAGGTGA	GGTAACTAC.AGGAGGTGA
GGTAACTAC.CAAGAGAGT	GGTAACTAC.CAAGAGAGT
GGTAAGGAT.AAGGATACG	GGTAAGGAT.AAGGATACG
GGTAAGGAT.GCGAAGCTC	GGTAAGGAT.GCGAAGCTC
GGTAAGGAT.GGTCGGTCT	GGTAAGGAT.GGTCGGTCT
GGTAAGTGA.AGCGCATGA	GGTAAGTGA.AGCGCATGA
GGTAAGTGA.CCTCGAGAG	GGTAAGTGA.CCTCGAGAG
GGTAAGTGA.CCTGACCTC	GGTAAGTGA.CCTGACCTC
GGTAAGTGA.GGAAGTATG	GGTAAGTGA.GGAAGTATG
GGTAATCTA.AAGACTGGT	GGTAATCTA.AAGACTGGT
GGTAATCTA.GTGCCATGA	GGTAATCTA.GTGCCATGA
GGTACGAGC.AAGTCATGA	GGTACGAGC.AAGTCATGA
GGTACGAGC.CGATCCAGA	GGTACGAGC.CGATCCAGA
GGTACGAGC.CGCCATTAC	GGTACGAGC.CGCCATTAC
GGTACGAGC.GAGACGATC	GGTACGAGC.GAGACGATC
GGTACGAGC.TAGCACACG	GGTACGAGC.TAGCACACG
GGTACTTCC.CTTGTAACG	GGTACTTCC.CTTGTAACG
GGTACTTCC.TACTCGACC	GGTACTTCC.TACTCGACC
GGTAGACAT.CAGTATGAT	GGTAGACAT.CAGTATGAT
GGTAGACAT.CTTATCTCA	GGTAGACAT.CTTATCTCA
GGTAGACAT.TACCGATTG	GGTAGACAT.TACCGATTG
GGTAGCATC.AGCGGTAAG	GGTAGCATC.AGCGGTAAG
GGTAGCATC.AGTGATGCG	GGTAGCATC.AGTGATGCG
GGTAGCATC.CATTGTTCA	GGTAGCATC.CATTGTTCA
GGTAGTGTT.CCAGTCTCA	GGTAGTGTT.CCAGTCTCA
GGTAGTGTT.CTGATCAAG	GGTAGTGTT.CTGATCAAG
GGTCCTAAG.ATACCGCTT	GGTCCTAAG.ATACCGCTT
GGTCCTGGT.GATGCGACG	GGTCCTGGT.GATGCGACG
GGTCGGATA.ATTGCGCTA	GGTCGGATA.ATTGCGCTA
GGTCGGATA.CCTTAATTC	GGTCGGATA.CCTTAATTC
GGTCGGATA.GTAGCCTTG	GGTCGGATA.GTAGCCTTG
GGTCGGATA.GTATACAGA	GGTCGGATA.GTATACAGA
GGTCGGATA.TGCATACAT	GGTCGGATA.TGCATACAT
GGTCGGTCT.GCTACCTTA	GGTCGGTCT.GCTACCTTA
GGTCGGTCT.GGAGACACA	GGTCGGTCT.GGAGACACA
GGTCGGTCT.TACAGGACT	GGTCGGTCT.TACAGGACT
GGTCTCATG.AAGGTGCTG	GGTCTCATG.AAGGTGCTG
GGTCTTGCA.CGTATAGCG	GGTCTTGCA.CGTATAGCG
GGTCTTGCA.GACTAGCAT	GGTCTTGCA.GACTAGCAT
GGTCTTGCA.GGTAGCATC	GGTCTTGCA.GGTAGCATC
GGTGAGCGT.CAGGAGCCT	GGTGAGCGT.CAGGAGCCT
GGTGAGTTC.CATAGGTGT	GGTGAGTTC.CATAGGTGT
GGTGAGTTC.GATGTCTAG	GGTGAGTTC.GATGTCTAG
GGTGAGTTC.GGTTAGATG	GGTGAGTTC.GGTTAGATG
GGTGAGTTC.TTCCTAAGG	GGTGAGTTC.TTCCTAAGG
GGTGATAGG.ACCTAGTTA	GGTGATAGG.ACCTAGTTA
GGTGCGTAG.CATGCCAGT	GGTGCGTAG.CATGCCAGT
GGTGGAGCT.AAGCCAAGT	GGTGGAGCT.AAGCCAAGT
GGTGGAGCT.ATCCTGCCT	GGTGGAGCT.ATCCTGCCT
GGTGGAGCT.CATGACGTT	GGTGGAGCT.CATGACGTT
GGTGGAGCT.CCGATGTTC	GGTGGAGCT.CCGATGTTC
GGTGGAGCT.GCCTTATCT	GGTGGAGCT.GCCTTATCT
GGTGGAGCT.GTGCACGAG	GGTGGAGCT.GTGCACGAG
GGTGTGACC.AATGCTGAT	GGTGTGACC.AATGCTGAT
GGTGTGACC.GTTAGATTG	GGTGTGACC.GTTAGATTG
GGTGTGACC.TATGTATGC	GGTGTGACC.TATGTATGC
GGTGTTCAT.ATCCTGCCT	GGTGTTCAT.ATCCTGCCT
GGTTAACAG.CTCAGGTAC	GGTTAACAG.CTCAGGTAC
GGTTAACAG.CTGGTACAT	GGTTAACAG.CTGGTACAT
GGTTAACAG.GATATGGAC	GGTTAACAG.GATATGGAC
GGTTACGCA.CAGCACGTG	GGTTACGCA.CAGCACGTG
GGTTACGCA.CTACTGTCA	GGTTACGCA.CTACTGTCA
GGTTACGCA.CTGGTACAT	GGTTACGCA.CTGGTACAT
GGTTAGATG.ATGGTTCGA	GGTTAGATG.ATGGTTCGA
GGTTAGATG.TACAACACC	GGTTAGATG.TACAACACC
GGTTCAGAC.GAATCACAT	GGTTCAGAC.GAATCACAT
GGTTCAGAC.GCCATCGCT	GGTTCAGAC.GCCATCGCT
GGTTCAGAC.GCTTAGAAC	GGTTCAGAC.GCTTAGAAC
GGTTCAGAC.TACGACTTG	GGTTCAGAC.TACGACTTG
GGTTCAGAC.TACGTTACC	GGTTCAGAC.TACGTTACC
GGTTCAGAC.TCTTGGTAG	GGTTCAGAC.TCTTGGTAG
GGTTCGCAA.ACAGGAACT	GGTTCGCAA.ACAGGAACT
GGTTCGCAA.ACCAGCGTT	GGTTCGCAA.ACCAGCGTT
GGTTCGCAA.ATCTGGTAG	GGTTCGCAA.ATCTGGTAG
