TCTGAGATA.ACTATTGTC	TCTGAGATA.ACTATTGTC
TCTGATGAA.CAGCAGTAC	TCTGATGAA.CAGCAGTAC
TCTGATGAA.CCACGTTCT	TCTGATGAA.CCACGTTCT
TCTGATGAA.TCAAGGAGT	TCTGATGAA.TCAAGGAGT
TCTGATGAA.TCGTAGGAA	TCTGATGAA.TCGTAGGAA
TCTGATGAA.TGATAGAGG	TCTGATGAA.TGATAGAGG
TCTGCAACA.ACCATACTT	TCTGCAACA.ACCATACTT
TCTGCAACA.CCGCATCCT	TCTGCAACA.CCGCATCCT
TCTGCAACA.GCGCTCTAT	TCTGCAACA.GCGCTCTAT
TCTGCAACA.GTCTTCTCG	TCTGCAACA.GTCTTCTCG
TCTGCGCTG.CTGAGTAGC	TCTGCGCTG.CTGAGTAGC
TCTGCGCTG.GATCTTCGC	TCTGCGCTG.GATCTTCGC
TCTGGAGGA.ACTCTCACA	TCTGGAGGA.ACTCTCACA
TCTGGAGGA.CGAATGAGT	TCTGGAGGA.CGAATGAGT
TCTGTGAAG.AAGGATACG	TCTGTGAAG.AAGGATACG
TCTGTGAAG.CAATCTCCG	TCTGTGAAG.CAATCTCCG
TCTGTGAAG.GGATCAGGT	TCTGTGAAG.GGATCAGGT
TCTTAAGTG.CGCTGTAGT	TCTTAAGTG.CGCTGTAGT
TCTTAAGTG.GTGGTACGG	TCTTAAGTG.GTGGTACGG
TCTTAGCGA.GGAGTTAGC	TCTTAGCGA.GGAGTTAGC
TCTTAGCGA.TACAACACC	TCTTAGCGA.TACAACACC
TCTTGGTAG.ATGAGGTAT	TCTTGGTAG.ATGAGGTAT
TCTTGGTAG.CAAGCGCAT	TCTTGGTAG.CAAGCGCAT
TGAACCAAT.ACCATACTT	TGAACCAAT.ACCATACTT
TGAACCAAT.CATCGAAGC	TGAACCAAT.CATCGAAGC
TGAACCAAT.GACGCTTGC	TGAACCAAT.GACGCTTGC
TGAACCAAT.GGAATTGGA	TGAACCAAT.GGAATTGGA
TGAACCAAT.TAGTGCACT	TGAACCAAT.TAGTGCACT
TGAACGGTT.AAGTCATGA	TGAACGGTT.AAGTCATGA
TGAACGGTT.GGTAATCTA	TGAACGGTT.GGTAATCTA
TGAACGGTT.TCAAGGTCG	TGAACGGTT.TCAAGGTCG
TGAACGGTT.TCGGATGTT	TGAACGGTT.TCGGATGTT
TGAACGTCA.AACACACTC	TGAACGTCA.AACACACTC
TGAACGTCA.CTAACCGGT	TGAACGTCA.CTAACCGGT
TGAACGTCA.GACCAACAG	TGAACGTCA.GACCAACAG
TGAACGTCA.GCAACACCT	TGAACGTCA.GCAACACCT
TGAACGTCA.GGATGCTCG	TGAACGTCA.GGATGCTCG
TGAACGTCA.GTTAATTCG	TGAACGTCA.GTTAATTCG
TGAACTTGC.AGGATGCGT	TGAACTTGC.AGGATGCGT
TGAACTTGC.CACAACCAG	TGAACTTGC.CACAACCAG
TGAAGACCA.CTGGTACAT	TGAAGACCA.CTGGTACAT
TGACAAGTT.ACACACCGT	TGACAAGTT.ACACACCGT
TGACAAGTT.ATGAACTAG	TGACAAGTT.ATGAACTAG
TGACAAGTT.GCTCAATGA	TGACAAGTT.GCTCAATGA
TGACAAGTT.GGATAGTCA	TGACAAGTT.GGATAGTCA
TGACAAGTT.TGCAGTCGG	TGACAAGTT.TGCAGTCGG
TGACAAGTT.TGGAGTGGA	TGACAAGTT.TGGAGTGGA
TGACAAGTT.TTACGCTCG	TGACAAGTT.TTACGCTCG
TGACCTATG.CCGCATCCT	TGACCTATG.CCGCATCCT
TGACCTCCT.CTCAGCTGG	TGACCTCCT.CTCAGCTGG
TGACCTCCT.GGTGTGACC	TGACCTCCT.GGTGTGACC
TGACCTCCT.TGGAGAACC	TGACCTCCT.TGGAGAACC
TGACCTCCT.TGGTGCCTG	TGACCTCCT.TGGTGCCTG
TGACGATGA.CCTTCGAGC	TGACGATGA.CCTTCGAGC
TGACGATGA.GCAGATCCG	TGACGATGA.GCAGATCCG
TGACGATGA.TGCAGCCTT	TGACGATGA.TGCAGCCTT
TGACGGTTG.AGTAACGTA	TGACGGTTG.AGTAACGTA
TGACGGTTG.TGCCACCGA	TGACGGTTG.TGCCACCGA
TGACTGAGA.AGCCTCGCA	TGACTGAGA.AGCCTCGCA
TGACTGAGA.CAACGATCG	TGACTGAGA.CAACGATCG
TGACTGAGA.CGTCTGTCC	TGACTGAGA.CGTCTGTCC
TGACTGAGA.TAGAGCCAG	TGACTGAGA.TAGAGCCAG
TGAGAATCC.AATGCTATC	TGAGAATCC.AATGCTATC
TGAGAATCC.AGAGCGGAG	TGAGAATCC.AGAGCGGAG
TGAGAATCC.GGTACGAGC	TGAGAATCC.GGTACGAGC
TGAGAATCC.GTGTTCCAG	TGAGAATCC.GTGTTCCAG
TGAGACAGC.AACGGAGAT	TGAGACAGC.AACGGAGAT
TGAGAGGAC.CGTATTCCT	TGAGAGGAC.CGTATTCCT
TGAGAGGAC.GGTAAGGAT	TGAGAGGAC.GGTAAGGAT
TGAGAGGAC.GGTACTTCC	TGAGAGGAC.GGTACTTCC
TGAGAGGAC.TGCCAGACG	TGAGAGGAC.TGCCAGACG
TGAGATCAT.GACATATGT	TGAGATCAT.GACATATGT
TGAGATCAT.GTGTCGAGC	TGAGATCAT.GTGTCGAGC
TGAGCAGAT.AGGTCCGTC	TGAGCAGAT.AGGTCCGTC
TGAGCAGAT.GGTCGGTCT	TGAGCAGAT.GGTCGGTCT
TGAGCAGAT.GTGGTTACC	TGAGCAGAT.GTGGTTACC
TGAGCAGAT.TAGCGCAGC	TGAGCAGAT.TAGCGCAGC
TGAGCTAGA.GAGTATCGC	TGAGCTAGA.GAGTATCGC
TGAGCTAGA.TGACCTCCT	TGAGCTAGA.TGACCTCCT
TGAGCTAGA.TGTCATAGC	TGAGCTAGA.TGTCATAGC
TGAGCTAGA.TTACGGACC	TGAGCTAGA.TTACGGACC
TGAGGTCTC.ATTAGCCAC	TGAGGTCTC.ATTAGCCAC
TGAGGTCTC.CGTACACAC	TGAGGTCTC.CGTACACAC
TGAGGTCTC.CGTCGTCAA	TGAGGTCTC.CGTCGTCAA
TGAGGTCTC.GCCGTTGTT	TGAGGTCTC.GCCGTTGTT
TGAGGTCTC.TCCAGCAGC	TGAGGTCTC.TCCAGCAGC
TGAGGTCTC.TGCTTACGG	TGAGGTCTC.TGCTTACGG
TGAGGTCTC.TGTCAACCT	TGAGGTCTC.TGTCAACCT
TGAGTGACT.AGCCACTTC	TGAGTGACT.AGCCACTTC
TGAGTGACT.TGGTTATAC	TGAGTGACT.TGGTTATAC
TGAGTTAAG.AATCCGCTG	TGAGTTAAG.AATCCGCTG
TGAGTTAAG.AGAAGCTGC	TGAGTTAAG.AGAAGCTGC
TGAGTTAAG.AGTTATCGC	TGAGTTAAG.AGTTATCGC
TGAGTTAAG.ATTAGCGGT	TGAGTTAAG.ATTAGCGGT
TGAGTTAAG.CCTTATCCG	TGAGTTAAG.CCTTATCCG
TGATACCGT.AAGACTGGT	TGATACCGT.AAGACTGGT
TGATACCGT.ACGTATGTC	TGATACCGT.ACGTATGTC
TGATACCGT.CACAATAAC	TGATACCGT.CACAATAAC
TGATACCGT.GCTGAGCAG	TGATACCGT.GCTGAGCAG
TGATAGAGG.AGCATTGTT	TGATAGAGG.AGCATTGTT
TGATAGAGG.CTCGCAAGA	TGATAGAGG.CTCGCAAGA
TGATAGAGG.TGATGACAG	TGATAGAGG.TGATGACAG
TGATAGAGG.TTACGGACC	TGATAGAGG.TTACGGACC
TGATCGGAA.AGCAGACAA	TGATCGGAA.AGCAGACAA
TGATCGGAA.AGGATGCGT	TGATCGGAA.AGGATGCGT
TGATCTCGG.AATCGTGTT	TGATCTCGG.AATCGTGTT
TGATCTCGG.ACGGACCAT	TGATCTCGG.ACGGACCAT
TGATCTCGG.AGATCGAGT	TGATCTCGG.AGATCGAGT
TGATCTCGG.AGATGAAGA	TGATCTCGG.AGATGAAGA
TGATCTCGG.ATATAGCGT	TGATCTCGG.ATATAGCGT
TGATCTCGG.CATGTGAAC	TGATCTCGG.CATGTGAAC
TGATCTCGG.CGACCTAGC	TGATCTCGG.CGACCTAGC
TGATCTCGG.TGCTCACAC	TGATCTCGG.TGCTCACAC
TGATGACAG.AGCAACATT	TGATGACAG.AGCAACATT
TGATGACAG.AGCCTCTAG	TGATGACAG.AGCCTCTAG
TGATGACAG.ATCAGGATG	TGATGACAG.ATCAGGATG
TGATGACAG.ATGAACTAG	TGATGACAG.ATGAACTAG
TGATGACAG.CTTCTCATC	TGATGACAG.CTTCTCATC
TGATGACAG.TCGACGTTG	TGATGACAG.TCGACGTTG
TGATGACAG.TTGATGAGT	TGATGACAG.TTGATGAGT
TGATGGACA.ATCTCGTGA	TGATGGACA.ATCTCGTGA
TGATGTGTG.CAGAGCACC	TGATGTGTG.CAGAGCACC
TGATGTGTG.CTCGTGTCC	TGATGTGTG.CTCGTGTCC
TGATTATCG.CACTACAGG	TGATTATCG.CACTACAGG
TGATTATCG.CTTCGTGCA	TGATTATCG.CTTCGTGCA
TGATTATCG.GACCGTAGT	TGATTATCG.GACCGTAGT
TGATTATCG.GCTGGTTCG	TGATTATCG.GCTGGTTCG
TGATTATCG.GTAGTGGAG	TGATTATCG.GTAGTGGAG
TGATTATCG.TGATGTGTG	TGATTATCG.TGATGTGTG
TGATTCACC.TGCTTACGG	TGATTCACC.TGCTTACGG
TGATTCACC.TGGAGAGTG	TGATTCACC.TGGAGAGTG
TGATTGCTG.GACCGGTAG	TGATTGCTG.GACCGGTAG
TGATTGTGC.AATCGTGTT	TGATTGTGC.AATCGTGTT
TGATTGTGC.CTTGATCTA	TGATTGTGC.CTTGATCTA
TGATTGTGC.GCTAGTGGA	TGATTGTGC.GCTAGTGGA
TGATTGTGC.TACTAGTAG	TGATTGTGC.TACTAGTAG
TGATTGTGC.TCATCATCT	TGATTGTGC.TCATCATCT
TGATTGTGC.TGTAACAGT	TGATTGTGC.TGTAACAGT
TGATTGTGC.TTACGCTCG	TGATTGTGC.TTACGCTCG
TGCAACTCT.AGTCGTCCG	TGCAACTCT.AGTCGTCCG
TGCAACTCT.CCGAGCTGA	TGCAACTCT.CCGAGCTGA
TGCAACTCT.CTCTGCGGT	TGCAACTCT.CTCTGCGGT
TGCACGATG.CATAAGATC	TGCACGATG.CATAAGATC
TGCAGATGC.ATGAGGTAT	TGCAGATGC.ATGAGGTAT
TGCAGATGC.CCGCTCATG	TGCAGATGC.CCGCTCATG
TGCAGATGC.CTCCGCATT	TGCAGATGC.CTCCGCATT
TGCAGATGC.GCCACGAGT	TGCAGATGC.GCCACGAGT
TGCAGATGC.TCACGACAA	TGCAGATGC.TCACGACAA
TGCAGATGC.TCGTAGGAA	TGCAGATGC.TCGTAGGAA
TGCAGCCTT.CGGAGACTT	TGCAGCCTT.CGGAGACTT
TGCAGCCTT.GACGGTGCT	TGCAGCCTT.GACGGTGCT
TGCAGCCTT.GTCAAGATC	TGCAGCCTT.GTCAAGATC
TGCAGTCGG.GCAGCTCTT	TGCAGTCGG.GCAGCTCTT
TGCAGTTCA.CATTATGTC	TGCAGTTCA.CATTATGTC
TGCAGTTCA.CGAATGAGT	TGCAGTTCA.CGAATGAGT
TGCAGTTCA.GCTGTTCGG	TGCAGTTCA.GCTGTTCGG
TGCAGTTCA.TCCACGTGC	TGCAGTTCA.TCCACGTGC
TGCAGTTCA.TCCTTCGTA	TGCAGTTCA.TCCTTCGTA
TGCATACAT.AACTTGTCG	TGCATACAT.AACTTGTCG
TGCATACAT.ACACTAACG	TGCATACAT.ACACTAACG
TGCATACAT.CATGTGAAC	TGCATACAT.CATGTGAAC
TGCATACAT.CCATAGCCA	TGCATACAT.CCATAGCCA
TGCATACAT.CGTTAATGG	TGCATACAT.CGTTAATGG
TGCATACAT.GGTTCGCAA	TGCATACAT.GGTTCGCAA
TGCATCGGA.ACCGGAAGG	TGCATCGGA.ACCGGAAGG
TGCATCGGA.ACGCTATGT	TGCATCGGA.ACGCTATGT
TGCATCGGA.AGGTCAGCA	TGCATCGGA.AGGTCAGCA
TGCATCGGA.CATCAATAG	TGCATCGGA.CATCAATAG
TGCATCGGA.CCACGGATC	TGCATCGGA.CCACGGATC
TGCATCGGA.CGGTTGCGA	TGCATCGGA.CGGTTGCGA
TGCATCGGA.CGTACATCT	TGCATCGGA.CGTACATCT
TGCATCGGA.CTCCTATCT	TGCATCGGA.CTCCTATCT
TGCATCGGA.TGTTAAGCC	TGCATCGGA.TGTTAAGCC
TGCCAATGG.AAGACGAAG	TGCCAATGG.AAGACGAAG
TGCCAATGG.GCGCTCTAT	TGCCAATGG.GCGCTCTAT
TGCCAATGG.GTAGTTGGT	TGCCAATGG.GTAGTTGGT
TGCCACCGA.AACTTAGCT	TGCCACCGA.AACTTAGCT
TGCCACCGA.ACGCGACAG	TGCCACCGA.ACGCGACAG
TGCCACCGA.GATTATGCG	TGCCACCGA.GATTATGCG
TGCCACCGA.GTAACGCGA	TGCCACCGA.GTAACGCGA
TGCCACCGA.GTCGACATT	TGCCACCGA.GTCGACATT
TGCCACCGA.TCAGTGCAA	TGCCACCGA.TCAGTGCAA
TGCCACCGA.TCCGATCTG	TGCCACCGA.TCCGATCTG
TGCCAGACG.CCACACAGA	TGCCAGACG.CCACACAGA
TGCCAGACG.GTAGAAGTT	TGCCAGACG.GTAGAAGTT
TGCCAGACG.TGATTCACC	TGCCAGACG.TGATTCACC
TGCCATCTC.AACAGCAGT	TGCCATCTC.AACAGCAGT
TGCCATCTC.ACGCAAGAT	TGCCATCTC.ACGCAAGAT
TGCCATCTC.CAACGTCTT	TGCCATCTC.CAACGTCTT
TGCCGAACT.TATACCACT	TGCCGAACT.TATACCACT
TGCCGAACT.TCGTGCCAC	TGCCGAACT.TCGTGCCAC
TGCCGAACT.TTCGCTGAG	TGCCGAACT.TTCGCTGAG
TGCCGAACT.TTGTCAACC	TGCCGAACT.TTGTCAACC
TGCCGACTA.ACCAGCGTT	TGCCGACTA.ACCAGCGTT
TGCCGACTA.TATACCACT	TGCCGACTA.TATACCACT
TGCCTGGTT.CTCCGCATT	TGCCTGGTT.CTCCGCATT
TGCCTGGTT.GTAGAGAGC	TGCCTGGTT.GTAGAGAGC
TGCCTGGTT.TAACACGAG	TGCCTGGTT.TAACACGAG
TGCCTGGTT.TGGAGAACC	TGCCTGGTT.TGGAGAACC
TGCCTGGTT.TGTCACATA	TGCCTGGTT.TGTCACATA
TGCCTTCAG.CACTGGTCC	TGCCTTCAG.CACTGGTCC
TGCGCACTG.CTCATTAGT	TGCGCACTG.CTCATTAGT
TGCGCTGCA.AGTGAACGG	TGCGCTGCA.AGTGAACGG
TGCGCTGCA.CACCAAGAT	TGCGCTGCA.CACCAAGAT
TGCGCTGCA.CCACACAGA	TGCGCTGCA.CCACACAGA
TGCGTAATC.ATGACACAA	TGCGTAATC.ATGACACAA
TGCGTAATC.GCCGTCTTC	TGCGTAATC.GCCGTCTTC
TGCGTAATC.TAGATAGCC	TGCGTAATC.TAGATAGCC
TGCGTATCT.GACACGCAA	TGCGTATCT.GACACGCAA
TGCGTATCT.TCCTATTCC	TGCGTATCT.TCCTATTCC
TGCGTCTTA.GTGTACCGT	TGCGTCTTA.GTGTACCGT
TGCGTGCCA.ACACACCGT	TGCGTGCCA.ACACACCGT
TGCGTGCCA.CACACCACA	TGCGTGCCA.CACACCACA
TGCGTGCCA.GTTACTACT	TGCGTGCCA.GTTACTACT
TGCGTGCCA.TGTGAGTAT	TGCGTGCCA.TGTGAGTAT
TGCGTGCCA.TGTTGTCGA	TGCGTGCCA.TGTTGTCGA
TGCTATGAA.ATGAACTAG	TGCTATGAA.ATGAACTAG
TGCTATGAA.CTGCATGTT	TGCTATGAA.CTGCATGTT
TGCTATGAA.TATTACAGC	TGCTATGAA.TATTACAGC
TGCTATGAA.TCGCTGATT	TGCTATGAA.TCGCTGATT
TGCTATGAA.TCTCCGCGT	TGCTATGAA.TCTCCGCGT
TGCTATGAA.TTCTGAATG	TGCTATGAA.TTCTGAATG
TGCTCACAC.ACCGAGTAG	TGCTCACAC.ACCGAGTAG
TGCTCACAC.ACGTCTATG	TGCTCACAC.ACGTCTATG
TGCTCACAC.AGGAATTGG	TGCTCACAC.AGGAATTGG
TGCTCACAC.GCATTGATC	TGCTCACAC.GCATTGATC
TGCTCACAC.TATTGCTAC	TGCTCACAC.TATTGCTAC
TGCTCACAC.TGCCTGGTT	TGCTCACAC.TGCCTGGTT
TGCTCACAC.TGCGCACTG	TGCTCACAC.TGCGCACTG
TGCTCAGCG.ATATCCGAT	TGCTCAGCG.ATATCCGAT
TGCTCAGCG.TCGAACGCT	TGCTCAGCG.TCGAACGCT
TGCTCCTCC.AGTAATGGT	TGCTCCTCC.AGTAATGGT
TGCTCCTCC.ATGGTTCGA	TGCTCCTCC.ATGGTTCGA
TGCTCCTCC.CACACCTGT	TGCTCCTCC.CACACCTGT
TGCTCCTCC.TATTCAACG	TGCTCCTCC.TATTCAACG
TGCTCCTCC.TATTGCTAC	TGCTCCTCC.TATTGCTAC
TGCTCCTCC.TGCATACAT	TGCTCCTCC.TGCATACAT
TGCTCCTCC.TTCGCATCC	TGCTCCTCC.TTCGCATCC
TGCTGCGTC.ATAAGTTCG	TGCTGCGTC.ATAAGTTCG
TGCTGCGTC.TATTACTCG	TGCTGCGTC.TATTACTCG
TGCTGCGTC.TCGCATTCG	TGCTGCGTC.TCGCATTCG
TGCTTACGG.CGCTTATGA	TGCTTACGG.CGCTTATGA
TGCTTACGG.GCTGAGCAG	TGCTTACGG.GCTGAGCAG
TGCTTACGG.GGACTCCTT	TGCTTACGG.GGACTCCTT
TGGAACTAA.ACACAGAAC	TGGAACTAA.ACACAGAAC
TGGAACTAA.AGTTCGATA	TGGAACTAA.AGTTCGATA
TGGAACTAA.ATTAGCCAC	TGGAACTAA.ATTAGCCAC
TGGAACTAA.GGATAATAC	TGGAACTAA.GGATAATAC
TGGAACTAA.TAGTAACGG	TGGAACTAA.TAGTAACGG
TGGAACTAA.TGAACTTGC	TGGAACTAA.TGAACTTGC
TGGAAGATT.ACTACCATC	TGGAAGATT.ACTACCATC
TGGAAGATT.ATTCCTACG	TGGAAGATT.ATTCCTACG
TGGAAGATT.CACCTTCCT	TGGAAGATT.CACCTTCCT
TGGAAGATT.CCAGTACTC	TGGAAGATT.CCAGTACTC
TGGAAGATT.CCGATACCG	TGGAAGATT.CCGATACCG
TGGAAGATT.CCTTAACAT	TGGAAGATT.CCTTAACAT
TGGAAGATT.GCACGCATT	TGGAAGATT.GCACGCATT
TGGAAGATT.GTAGCATAC	TGGAAGATT.GTAGCATAC
TGGAAGATT.GTGAATGCC	TGGAAGATT.GTGAATGCC
TGGAAGATT.TATGAAGAC	TGGAAGATT.TATGAAGAC
TGGAAGATT.TCGCATTCG	TGGAAGATT.TCGCATTCG
TGGAATCGT.AACTGATTC	TGGAATCGT.AACTGATTC
TGGAATCGT.ACCGCTGTG	TGGAATCGT.ACCGCTGTG
TGGAATCGT.ATTCCTACG	TGGAATCGT.ATTCCTACG
TGGAATCGT.CCACGCCAT	TGGAATCGT.CCACGCCAT
TGGACGAGA.ACACTGTGA	TGGACGAGA.ACACTGTGA
TGGACGAGA.TCCGATCTG	TGGACGAGA.TCCGATCTG
TGGACGAGA.TTCAGTGCC	TGGACGAGA.TTCAGTGCC
TGGACTGCC.CCTCGACCT	TGGACTGCC.CCTCGACCT
TGGACTGCC.GTCGCAGGT	TGGACTGCC.GTCGCAGGT
TGGAGAACC.GTATCGTCG	TGGAGAACC.GTATCGTCG
TGGAGAACC.GTGCGAGTA	TGGAGAACC.GTGCGAGTA
TGGAGTGGA.AGCCTCTAG	TGGAGTGGA.AGCCTCTAG
TGGATAGGT.GTAGAAGTT	TGGATAGGT.GTAGAAGTT
TGGATTAGC.AGATCTTCA	TGGATTAGC.AGATCTTCA
TGGATTAGC.CCATGCGTC	TGGATTAGC.CCATGCGTC
TGGATTAGC.CCTCGAGAG	TGGATTAGC.CCTCGAGAG
TGGATTAGC.GCTACAATG	TGGATTAGC.GCTACAATG
TGGATTAGC.TCAGTGTTC	TGGATTAGC.TCAGTGTTC
TGGATTAGC.TCATCAGAG	TGGATTAGC.TCATCAGAG
TGGATTAGC.TCATGCTCA	TGGATTAGC.TCATGCTCA
TGGTAACCA.CCAACAACA	TGGTAACCA.CCAACAACA
TGGTAACCA.CTCAGTGAT	TGGTAACCA.CTCAGTGAT
TGGTAACCA.TCAAGGAGT	TGGTAACCA.TCAAGGAGT
TGGTAACCA.TGTATCGTG	TGGTAACCA.TGTATCGTG
TGGTAGCAG.AATCTGACC	TGGTAGCAG.AATCTGACC
TGGTAGCAG.ACCATTCAC	TGGTAGCAG.ACCATTCAC
TGGTCCTAG.CAAGCCTCG	TGGTCCTAG.CAAGCCTCG
TGGTCCTAG.TCTTAAGTG	TGGTCCTAG.TCTTAAGTG
TGGTCGCTA.CACACCTGT	TGGTCGCTA.CACACCTGT
TGGTCGCTA.CCACGTTCT	TGGTCGCTA.CCACGTTCT
TGGTCGCTA.CGGTTCTAT	TGGTCGCTA.CGGTTCTAT
TGGTCGCTA.TCGGTATCA	TGGTCGCTA.TCGGTATCA
TGGTCTACG.GGAGCATCT	TGGTCTACG.GGAGCATCT
TGGTGGATC.CCGATCTCT	TGGTGGATC.CCGATCTCT
TGGTGGATC.CGATTGAAC	TGGTGGATC.CGATTGAAC
TGGTGGATC.GGTCTCATG	TGGTGGATC.GGTCTCATG
TGGTGGATC.GTGCTAAGC	TGGTGGATC.GTGCTAAGC
TGGTGGATC.TGGAAGATT	TGGTGGATC.TGGAAGATT
TGGTGGATC.TTACGGACC	TGGTGGATC.TTACGGACC
TGGTTATAC.CGAACAATC	TGGTTATAC.CGAACAATC
TGGTTATAC.TAACATTGG	TGGTTATAC.TAACATTGG
TGGTTATAC.TTACTAGTC	TGGTTATAC.TTACTAGTC
TGTAACAGT.GAGTCCAAT	TGTAACAGT.GAGTCCAAT
TGTAACAGT.GCTACAATG	TGTAACAGT.GCTACAATG
TGTAACAGT.GTGCTGACT	TGTAACAGT.GTGCTGACT
TGTAACAGT.TGCAGATGC	TGTAACAGT.TGCAGATGC
TGTAACAGT.TGGATTAGC	TGTAACAGT.TGGATTAGC
TGTACACGA.AATAACTCC	TGTACACGA.AATAACTCC
TGTACACGA.ACGTAGTAT	TGTACACGA.ACGTAGTAT
TGTACACGA.ATTAGCCAC	TGTACACGA.ATTAGCCAC
TGTACACGA.CTGTCTAGT	TGTACACGA.CTGTCTAGT
TGTACACGA.GGATACCTA	TGTACACGA.GGATACCTA
TGTACACGA.GGTTCTATC	TGTACACGA.GGTTCTATC
TGTAGATCG.CACACCTGT	TGTAGATCG.CACACCTGT
TGTAGATCG.GGATAATAC	TGTAGATCG.GGATAATAC
TGTAGATCG.GTTCAGAAG	TGTAGATCG.GTTCAGAAG
TGTAGATCG.TCGCCAAGC	TGTAGATCG.TCGCCAAGC
TGTAGCAAG.GAGATGTAT	TGTAGCAAG.GAGATGTAT
TGTAGCAAG.GTAGTGGAG	TGTAGCAAG.GTAGTGGAG
TGTAGCAAG.TTATCGCAC	TGTAGCAAG.TTATCGCAC
TGTAGGTTA.ATCGATCCT	TGTAGGTTA.ATCGATCCT
TGTAGGTTA.TAGGATGCC	TGTAGGTTA.TAGGATGCC
TGTATCGTG.CCGAAGCGT	TGTATCGTG.CCGAAGCGT
TGTATCGTG.CGCAGTGTC	TGTATCGTG.CGCAGTGTC
TGTATCGTG.TCCTTCAAC	TGTATCGTG.TCCTTCAAC
TGTATGTAG.CCTAGCAAT	TGTATGTAG.CCTAGCAAT
TGTATGTAG.TCGTACCTT	TGTATGTAG.TCGTACCTT
TGTCAACCT.CTACGGTAT	TGTCAACCT.CTACGGTAT
TGTCAACCT.CTGGTAATC	TGTCAACCT.CTGGTAATC
TGTCAACCT.GCTTCTACG	TGTCAACCT.GCTTCTACG
TGTCATAGC.ACAGTATTG	TGTCATAGC.ACAGTATTG
TGTCATAGC.ACTCCGTCG	TGTCATAGC.ACTCCGTCG
TGTCATAGC.ATAAGTTCG	TGTCATAGC.ATAAGTTCG
TGTCATAGC.ATACAACCG	TGTCATAGC.ATACAACCG
TGTCATAGC.ATGGACGTT	TGTCATAGC.ATGGACGTT
TGTCATAGC.CCATTCTGC	TGTCATAGC.CCATTCTGC
TGTCATAGC.GACCGTAGT	TGTCATAGC.GACCGTAGT
TGTCATAGC.GCACCATCG	TGTCATAGC.GCACCATCG
TGTCATAGC.TCAATGGAC	TGTCATAGC.TCAATGGAC
TGTCCATAG.ACGCAAGAT	TGTCCATAG.ACGCAAGAT
TGTCCATAG.TCGCCAAGC	TGTCCATAG.TCGCCAAGC
TGTCGTACA.ACGGTGCCT	TGTCGTACA.ACGGTGCCT
TGTCGTACA.CGTAATGAC	TGTCGTACA.CGTAATGAC
TGTCGTACA.TAATCACGC	TGTCGTACA.TAATCACGC
TGTCGTACA.TATCGGAAC	TGTCGTACA.TATCGGAAC
TGTCGTACA.TCCTCTAGT	TGTCGTACA.TCCTCTAGT
TGTCGTGAG.ACAGGTATC	TGTCGTGAG.ACAGGTATC
TGTCGTGAG.AGGTCACGT	TGTCGTGAG.AGGTCACGT
TGTCGTGAG.TAAGTACAC	TGTCGTGAG.TAAGTACAC
TGTCGTGAG.TGCCTTCAG	TGTCGTGAG.TGCCTTCAG
TGTCGTGAG.TGGTCGCTA	TGTCGTGAG.TGGTCGCTA
TGTCGTGAG.TGTTAAGCC	TGTCGTGAG.TGTTAAGCC
TGTGAGTAT.TGAACCAAT	TGTGAGTAT.TGAACCAAT
TGTGCAGTA.CCTCTCTAG	TGTGCAGTA.CCTCTCTAG
TGTGCAGTA.CGCAATCGA	TGTGCAGTA.CGCAATCGA
TGTGCAGTA.TAGCGCAGC	TGTGCAGTA.TAGCGCAGC
TGTGCAGTA.TAGGATGCC	TGTGCAGTA.TAGGATGCC
TGTGCCATG.AGTCCGTGT	TGTGCCATG.AGTCCGTGT
TGTGCCATG.CAGTGAGGA	TGTGCCATG.CAGTGAGGA
TGTGCCATG.CTCTACGCA	TGTGCCATG.CTCTACGCA
TGTGCCATG.CTTCCGGTA	TGTGCCATG.CTTCCGGTA
TGTGCTAAC.GCACTGGAT	TGTGCTAAC.GCACTGGAT
TGTGCTAAC.GCGAGCAAG	TGTGCTAAC.GCGAGCAAG
TGTGCTAAC.GTTCCAACA	TGTGCTAAC.GTTCCAACA
TGTGCTAAC.TACAACACC	TGTGCTAAC.TACAACACC
TGTGCTAAC.TTCTGAATG	TGTGCTAAC.TTCTGAATG
TGTGGACAA.CATAGAGAT	TGTGGACAA.CATAGAGAT
TGTGGACAA.TCTACAGTT	TGTGGACAA.TCTACAGTT
TGTGGACAA.TTATCCAAG	TGTGGACAA.TTATCCAAG
TGTGGTCCT.AGTTGCCTT	TGTGGTCCT.AGTTGCCTT
TGTGGTCCT.CGCCATTAC	TGTGGTCCT.CGCCATTAC
TGTGGTCCT.GGTAAGGAT	TGTGGTCCT.GGTAAGGAT
TGTGGTCCT.TAGGTTAGT	TGTGGTCCT.TAGGTTAGT
TGTGGTCCT.TGACCTCCT	TGTGGTCCT.TGACCTCCT
TGTGTAGAG.ACCGGTTAC	TGTGTAGAG.ACCGGTTAC
TGTGTAGAG.GATGTTACA	TGTGTAGAG.GATGTTACA
TGTGTAGAG.GCACGTAGA	TGTGTAGAG.GCACGTAGA
TGTGTAGAG.GTATCGTCG	TGTGTAGAG.GTATCGTCG
TGTGTAGAG.TCTACATCC	TGTGTAGAG.TCTACATCC
TGTGTCTAC.ATGCGCTAC	TGTGTCTAC.ATGCGCTAC
TGTGTCTAC.GTGATGTGC	TGTGTCTAC.GTGATGTGC
TGTTAAGCC.GAGCCATCC	TGTTAAGCC.GAGCCATCC
TGTTAAGCC.TGATGTGTG	TGTTAAGCC.TGATGTGTG
TGTTAAGCC.TGGACTGCC	TGTTAAGCC.TGGACTGCC
TGTTACTGA.CGTCTGTCC	TGTTACTGA.CGTCTGTCC
TGTTACTGA.CTATCCATC	TGTTACTGA.CTATCCATC
TGTTACTGA.CTCGAACTG	TGTTACTGA.CTCGAACTG
TGTTACTGA.CTGTCTAGT	TGTTACTGA.CTGTCTAGT
TGTTGTCGA.AGCAAGTCC	TGTTGTCGA.AGCAAGTCC
TTAACGGAG.GCATACTCC	TTAACGGAG.GCATACTCC
TTAACGTTC.ACAACGAGC	TTAACGTTC.ACAACGAGC
TTAACGTTC.AGCACACCT	TTAACGTTC.AGCACACCT
TTAACGTTC.CCTGCAGAT	TTAACGTTC.CCTGCAGAT
TTAAGTGGT.CCTCTGCAT	TTAAGTGGT.CCTCTGCAT
TTAAGTGGT.GTAGTGGAG	TTAAGTGGT.GTAGTGGAG
TTAAGTGGT.TAGAGCGTC	TTAAGTGGT.TAGAGCGTC
TTACACCTT.CTATTCCGT	TTACACCTT.CTATTCCGT
TTACACCTT.GACAGGTTA	TTACACCTT.GACAGGTTA
TTACACCTT.GCACAACTC	TTACACCTT.GCACAACTC
TTACAGTGT.TCCTGTGGA	TTACAGTGT.TCCTGTGGA
TTACAGTGT.TCGTGCCAC	TTACAGTGT.TCGTGCCAC
TTACCTCTC.ATGCGCCGT	TTACCTCTC.ATGCGCCGT
TTACCTCTC.CAAGAGGAG	TTACCTCTC.CAAGAGGAG
TTACCTCTC.CTAGTTCCA	TTACCTCTC.CTAGTTCCA
TTACCTCTC.GATGTAAGG	TTACCTCTC.GATGTAAGG
TTACGCTCG.AGTAAGCCA	TTACGCTCG.AGTAAGCCA
TTACGCTCG.ATAGCACGG	TTACGCTCG.ATAGCACGG
TTACGCTCG.CCGCAGAAT	TTACGCTCG.CCGCAGAAT
TTACGCTCG.GATGCGACG	TTACGCTCG.GATGCGACG
TTACGCTCG.TGCGATACT	TTACGCTCG.TGCGATACT
TTACGGACC.CCTAAGTCT	TTACGGACC.CCTAAGTCT
TTACGGACC.TCAACACTC	TTACGGACC.TCAACACTC
TTACTAGTC.ATTCGCTTA	TTACTAGTC.ATTCGCTTA
TTACTAGTC.CGATAGGTG	TTACTAGTC.CGATAGGTG
TTACTAGTC.TACAAGAGG	TTACTAGTC.TACAAGAGG
TTACTTACG.TGCGCACTG	TTACTTACG.TGCGCACTG
TTACTTACG.TTGCTCTGC	TTACTTACG.TTGCTCTGC
TTAGATCGG.ATTGCGCTA	TTAGATCGG.ATTGCGCTA
TTAGATCGG.CCGATCAGC	TTAGATCGG.CCGATCAGC
TTAGATCGG.GCTTACGTT	TTAGATCGG.GCTTACGTT
TTAGATCGG.TTACTAGTC	TTAGATCGG.TTACTAGTC
TTAGCGTCT.GGTAAGGAT	TTAGCGTCT.GGTAAGGAT
TTAGGAAGG.CGTACATCT	TTAGGAAGG.CGTACATCT
TTAGGAAGG.CTGCGATTC	TTAGGAAGG.CTGCGATTC
TTAGGAAGG.CTGGTAATC	TTAGGAAGG.CTGGTAATC
TTAGTCGGA.ACTCGAGTC	TTAGTCGGA.ACTCGAGTC
TTAGTCGGA.TCAATGGAC	TTAGTCGGA.TCAATGGAC
TTAGTCGGA.TTCGCTGAG	TTAGTCGGA.TTCGCTGAG
TTATCCAAG.AGAGAGTGG	TTATCCAAG.AGAGAGTGG
TTATCCAAG.ATACCGCTT	TTATCCAAG.ATACCGCTT
TTATCCAAG.ATTGCGCTA	TTATCCAAG.ATTGCGCTA
TTATCCAAG.GCAACCAAC	TTATCCAAG.GCAACCAAC
TTATCCAAG.GTGTTGGAA	TTATCCAAG.GTGTTGGAA
TTATCCAAG.TGAGATCAT	TTATCCAAG.TGAGATCAT
TTATCGCAC.CCATAATCG	TTATCGCAC.CCATAATCG
TTATCGCAC.CTGGAGCGA	TTATCGCAC.CTGGAGCGA
TTATCGCAC.TACTTCCAG	TTATCGCAC.TACTTCCAG
TTATTCGAC.ACCACTAGG	TTATTCGAC.ACCACTAGG
TTATTCGAC.ACTTGATCT	TTATTCGAC.ACTTGATCT
TTATTCGAC.ATGAGTGTG	TTATTCGAC.ATGAGTGTG
TTATTCGAC.CCAAGTCGA	TTATTCGAC.CCAAGTCGA
TTATTCGAC.GGACGAGCA	TTATTCGAC.GGACGAGCA
TTATTCGAC.TACCTCACT	TTATTCGAC.TACCTCACT
TTATTCGAC.TGTACACGA	TTATTCGAC.TGTACACGA
TTCAACTAC.ACGCTAGTG	TTCAACTAC.ACGCTAGTG
TTCACCTTG.GTCACTATG	TTCACCTTG.GTCACTATG
TTCACCTTG.TACCGATTG	TTCACCTTG.TACCGATTG
TTCACCTTG.TGAGCAGAT	TTCACCTTG.TGAGCAGAT
TTCACTCCT.CAATTGTCT	TTCACTCCT.CAATTGTCT
TTCACTCCT.CCATATCTT	TTCACTCCT.CCATATCTT
TTCACTCCT.CTTCCGTGG	TTCACTCCT.CTTCCGTGG
TTCACTGGA.AAGCAGCAT	TTCACTGGA.AAGCAGCAT
TTCAGTGCC.CGTATTCCT	TTCAGTGCC.CGTATTCCT
TTCAGTGCC.GCTCTGTGT	TTCAGTGCC.GCTCTGTGT
TTCATCCAA.AGACATCCA	TTCATCCAA.AGACATCCA
TTCATCCAA.ATGGAGGAA	TTCATCCAA.ATGGAGGAA
TTCATCCAA.GCATGTGGT	TTCATCCAA.GCATGTGGT
TTCATCCAA.GCCGCTATC	TTCATCCAA.GCCGCTATC
TTCATTCGC.ATAGTCTCC	TTCATTCGC.ATAGTCTCC
TTCATTCGC.CGTGCCTAT	TTCATTCGC.CGTGCCTAT
TTCATTCGC.GTAGTGGAG	TTCATTCGC.GTAGTGGAG
TTCATTCGC.GTCTGACGT	TTCATTCGC.GTCTGACGT
TTCATTCGC.GTTCAGAAG	TTCATTCGC.GTTCAGAAG
TTCATTCGC.TTCCATACC	TTCATTCGC.TTCCATACC
TTCCAATTC.CGTCTGCTG	TTCCAATTC.CGTCTGCTG
TTCCAGATT.AACGTCGAG	TTCCAGATT.AACGTCGAG
TTCCAGATT.CATGGTCGA	TTCCAGATT.CATGGTCGA
TTCCAGATT.CATGTGAAC	TTCCAGATT.CATGTGAAC
TTCCAGATT.CCGCAATGG	TTCCAGATT.CCGCAATGG
TTCCAGATT.CTAACACTG	TTCCAGATT.CTAACACTG
TTCCAGATT.GGTGATAGG	TTCCAGATT.GGTGATAGG
TTCCAGGAG.CACCTAGCG	TTCCAGGAG.CACCTAGCG
TTCCAGGAG.GAGTCAAGG	TTCCAGGAG.GAGTCAAGG
TTCCAGGAG.TCCAGCAGC	TTCCAGGAG.TCCAGCAGC
TTCCAGGAG.TCTAGTGAC	TTCCAGGAG.TCTAGTGAC
TTCCATACC.TATCACCTG	TTCCATACC.TATCACCTG
TTCCGAGCG.ACCGCTGTG	TTCCGAGCG.ACCGCTGTG
TTCCGAGCG.TACAGGACT	TTCCGAGCG.TACAGGACT
TTCCGAGCG.TTCATTCGC	TTCCGAGCG.TTCATTCGC
TTCCGCCAG.ACCGATCGA	TTCCGCCAG.ACCGATCGA
TTCCGCCAG.CATTGACAA	TTCCGCCAG.CATTGACAA
TTCCGCCAG.GATATGGAC	TTCCGCCAG.GATATGGAC
TTCCGCCAG.GCCATCGCT	TTCCGCCAG.GCCATCGCT
TTCCGCCAG.GCCGCCTAA	TTCCGCCAG.GCCGCCTAA
TTCCGCCAG.GGTACGAGC	TTCCGCCAG.GGTACGAGC
TTCCGCCAG.TTAGATCGG	TTCCGCCAG.TTAGATCGG
TTCCGCCAG.TTGTTAGAG	TTCCGCCAG.TTGTTAGAG
TTCCTAAGG.ACAGAGATG	TTCCTAAGG.ACAGAGATG
TTCCTAAGG.AGTCCGTGT	TTCCTAAGG.AGTCCGTGT
TTCCTAAGG.CAGCACGTG	TTCCTAAGG.CAGCACGTG
TTCCTAAGG.TAGACACGT	TTCCTAAGG.TAGACACGT
TTCCTAAGG.TCAAGCGTA	TTCCTAAGG.TCAAGCGTA
TTCCTAAGG.TTGGTAACT	TTCCTAAGG.TTGGTAACT
TTCCTCGGT.ACGATGGAA	TTCCTCGGT.ACGATGGAA
TTCCTCGGT.GGTGTTCAT	TTCCTCGGT.GGTGTTCAT
TTCCTCGGT.TCGGACAGT	TTCCTCGGT.TCGGACAGT
TTCCTGCTA.ACAAGTACA	TTCCTGCTA.ACAAGTACA
TTCCTGCTA.ACACCGCCA	TTCCTGCTA.ACACCGCCA
TTCCTGCTA.AGAAGTCCT	TTCCTGCTA.AGAAGTCCT
