AACAACCTA.ACACTAACG	AACAACCTA.ACACTAACG
AACAACCTA.GGTAGTGTT	AACAACCTA.GGTAGTGTT
AACAACCTA.TCTACAGTT	AACAACCTA.TCTACAGTT
AACAACTGG.TGTGCTAAC	AACAACTGG.TGTGCTAAC
AACAATGCA.AACAACCTA	AACAATGCA.AACAACCTA
AACAATGCA.CAGTGCCAT	AACAATGCA.CAGTGCCAT
AACAATGCA.GAGGTGAGC	AACAATGCA.GAGGTGAGC
AACAATGCA.GATATATCC	AACAATGCA.GATATATCC
AACACACTC.AGCATTCCA	AACACACTC.AGCATTCCA
AACACACTC.AGGATGCGT	AACACACTC.AGGATGCGT
AACACACTC.ATGAGGTAT	AACACACTC.ATGAGGTAT
AACACACTC.CCTCTTGTA	AACACACTC.CCTCTTGTA
AACACACTC.GCGATATGA	AACACACTC.GCGATATGA
AACAGATCG.AATCCGCTG	AACAGATCG.AATCCGCTG
AACAGATCG.CCATATCTT	AACAGATCG.CCATATCTT
AACAGATCG.TGGAGAACC	AACAGATCG.TGGAGAACC
AACAGATCG.TGTATGTAG	AACAGATCG.TGTATGTAG
AACAGCAGT.ATATCCGAT	AACAGCAGT.ATATCCGAT
AACAGCAGT.CAAGTCACT	AACAGCAGT.CAAGTCACT
AACAGCAGT.CACAACCAG	AACAGCAGT.CACAACCAG
AACAGCAGT.CTACCTGCG	AACAGCAGT.CTACCTGCG
AACAGCAGT.TACATGCAC	AACAGCAGT.TACATGCAC
AACAGCAGT.TAGACCATG	AACAGCAGT.TAGACCATG
AACCATGGT.ACCAGCGTT	AACCATGGT.ACCAGCGTT
AACCATGGT.ACCTTGAAG	AACCATGGT.ACCTTGAAG
AACCATGGT.AGCGGTAAG	AACCATGGT.AGCGGTAAG
AACCATGGT.CCTCGACCT	AACCATGGT.CCTCGACCT
AACCATGGT.CTCCGCATT	AACCATGGT.CTCCGCATT
AACCATGGT.TTCTGGTGC	AACCATGGT.TTCTGGTGC
AACCGCTGA.ATTAGCCAC	AACCGCTGA.ATTAGCCAC
AACCGCTGA.CTAACACTG	AACCGCTGA.CTAACACTG
AACCGCTGA.CTTGCACAA	AACCGCTGA.CTTGCACAA
AACCGCTGA.GCTGGTAAC	AACCGCTGA.GCTGGTAAC
AACCGCTGA.GCTGTTCGG	AACCGCTGA.GCTGTTCGG
AACCGTGAG.ACTTCTTGG	AACCGTGAG.ACTTCTTGG
AACCGTGAG.CCTTGCTTG	AACCGTGAG.CCTTGCTTG
AACCGTGAG.GCTTGTCCT	AACCGTGAG.GCTTGTCCT
AACCGTGAG.TATCACCTG	AACCGTGAG.TATCACCTG
AACCGTGAG.TTGATGAGT	AACCGTGAG.TTGATGAGT
AACGAGAAT.AGCTTGGTG	AACGAGAAT.AGCTTGGTG
AACGAGAAT.CATCGCTGG	AACGAGAAT.CATCGCTGG
AACGAGAAT.CCTCATAAC	AACGAGAAT.CCTCATAAC
AACGAGAAT.TCCGATCTG	AACGAGAAT.TCCGATCTG
AACGAGGTG.ACCGTCCTA	AACGAGGTG.ACCGTCCTA
AACGAGGTG.ATTAGCACA	AACGAGGTG.ATTAGCACA
AACGAGGTG.CTCATTAGT	AACGAGGTG.CTCATTAGT
AACGATGAC.ACCATGTCT	AACGATGAC.ACCATGTCT
AACGATGAC.GCGGTAGTC	AACGATGAC.GCGGTAGTC
AACGATGAC.GTATGATCT	AACGATGAC.GTATGATCT
AACGCATTG.ACACGTTGC	AACGCATTG.ACACGTTGC
AACGCATTG.CTGCTGCTT	AACGCATTG.CTGCTGCTT
AACGCATTG.TCTCATCGG	AACGCATTG.TCTCATCGG
AACGCCTAC.AAGGAAGTC	AACGCCTAC.AAGGAAGTC
AACGCTCAA.TAGCGCAGC	AACGCTCAA.TAGCGCAGC
AACGCTCAA.TCAAGGAGT	AACGCTCAA.TCAAGGAGT
AACGGAGAT.ACCGGTTAC	AACGGAGAT.ACCGGTTAC
AACGGAGAT.TTCTGGTGC	AACGGAGAT.TTCTGGTGC
AACGGTAGC.ACAAGTACA	AACGGTAGC.ACAAGTACA
AACGGTAGC.GATACTGTG	AACGGTAGC.GATACTGTG
AACGGTAGC.GGAAGAAGC	AACGGTAGC.GGAAGAAGC
AACGTCGAG.CAGTAATGT	AACGTCGAG.CAGTAATGT
AACGTCGAG.CTCCGCATT	AACGTCGAG.CTCCGCATT
AACGTCGAG.TTCACTGGA	AACGTCGAG.TTCACTGGA
AACGTTCTT.CCGAGCTGA	AACGTTCTT.CCGAGCTGA
AACGTTCTT.CGTATTCCT	AACGTTCTT.CGTATTCCT
AACGTTCTT.GTGTACCGT	AACGTTCTT.GTGTACCGT
AACTAACTG.ATAGTGGTT	AACTAACTG.ATAGTGGTT
AACTAACTG.CATTGCAGA	AACTAACTG.CATTGCAGA
AACTAACTG.CTCATTAGT	AACTAACTG.CTCATTAGT
AACTAACTG.TATGCCTTC	AACTAACTG.TATGCCTTC
AACTAACTG.TCCAAGTAA	AACTAACTG.TCCAAGTAA
AACTCCATG.TGGTCGCTA	AACTCCATG.TGGTCGCTA
AACTGCGAC.ACGTGTAGT	AACTGCGAC.ACGTGTAGT
AACTGCGAC.ATTGCGCTA	AACTGCGAC.ATTGCGCTA
AACTGCGAC.CATACGCAG	AACTGCGAC.CATACGCAG
AACTTAGCT.TTCGCATCC	AACTTAGCT.TTCGCATCC
AACTTGTCG.CACCTCGGA	AACTTGTCG.CACCTCGGA
AAGACGAAG.CTAGACATG	AAGACGAAG.CTAGACATG
AAGACGAAG.GCTCTGTGT	AAGACGAAG.GCTCTGTGT
AAGACGAAG.TACGGTCGT	AAGACGAAG.TACGGTCGT
AAGACTACC.GCCACGAGT	AAGACTACC.GCCACGAGT
AAGACTACC.TATCATGCT	AAGACTACC.TATCATGCT
AAGACTACC.TGGAACTAA	AAGACTACC.TGGAACTAA
AAGACTGGT.AACTCCATG	AAGACTGGT.AACTCCATG
AAGACTGGT.AAGAGAACT	AAGACTGGT.AAGAGAACT
AAGACTGGT.ATACCGAAG	AAGACTGGT.ATACCGAAG
AAGACTGGT.GTGCACGAG	AAGACTGGT.GTGCACGAG
AAGACTGGT.TGATGGACA	AAGACTGGT.TGATGGACA
AAGACTGGT.TTGCTCTGC	AAGACTGGT.TTGCTCTGC
AAGAGAACT.AACGCATTG	AAGAGAACT.AACGCATTG
AAGAGAACT.ATCGCCTCT	AAGAGAACT.ATCGCCTCT
AAGAGAACT.CAATGCATT	AAGAGAACT.CAATGCATT
AAGAGAACT.GATGCTCCT	AAGAGAACT.GATGCTCCT
AAGAGAGAG.ACGTCTATG	AAGAGAGAG.ACGTCTATG
AAGAGAGAG.ACTCGCTGT	AAGAGAGAG.ACTCGCTGT
AAGAGAGAG.ATCCTGCCT	AAGAGAGAG.ATCCTGCCT
AAGAGAGAG.GGATACAAT	AAGAGAGAG.GGATACAAT
AAGCAACTA.ACAGGTATC	AAGCAACTA.ACAGGTATC
AAGCAACTA.CCACGTTCT	AAGCAACTA.CCACGTTCT
AAGCAACTA.CGCATAACT	AAGCAACTA.CGCATAACT
AAGCAATCG.TACCTCACT	AAGCAATCG.TACCTCACT
AAGCACAAC.TATCAGTGC	AAGCACAAC.TATCAGTGC
AAGCACAAC.TATCCTCAG	AAGCACAAC.TATCCTCAG
AAGCAGCAT.CACGGAAGT	AAGCAGCAT.CACGGAAGT
AAGCAGCAT.CTGTTACCA	AAGCAGCAT.CTGTTACCA
AAGCAGCAT.GTAAGGTCC	AAGCAGCAT.GTAAGGTCC
AAGCAGCAT.TAAGTGTAG	AAGCAGCAT.TAAGTGTAG
AAGCAGCAT.TGAGCAGAT	AAGCAGCAT.TGAGCAGAT
AAGCAGCAT.TTCCTCGGT	AAGCAGCAT.TTCCTCGGT
AAGCATTGC.AATTGGTGA	AAGCATTGC.AATTGGTGA
AAGCATTGC.CGGTCGACA	AAGCATTGC.CGGTCGACA
AAGCATTGC.CGGTGAGTC	AAGCATTGC.CGGTGAGTC
AAGCATTGC.GCCTGGAAT	AAGCATTGC.GCCTGGAAT
AAGCATTGC.GCGACACAG	AAGCATTGC.GCGACACAG
AAGCATTGC.TCAATCTAG	AAGCATTGC.TCAATCTAG
AAGCCAAGT.AGCCGTTCT	AAGCCAAGT.AGCCGTTCT
AAGCCAAGT.ATGAGTGTG	AAGCCAAGT.ATGAGTGTG
AAGCCACAC.ACGGACCAT	AAGCCACAC.ACGGACCAT
AAGCCACAC.CTAACTAAG	AAGCCACAC.CTAACTAAG
AAGCCACAC.GAGGTCCTT	AAGCCACAC.GAGGTCCTT
AAGCCACAC.GCTTGGTTC	AAGCCACAC.GCTTGGTTC
AAGCCACAC.TATCGAGCC	AAGCCACAC.TATCGAGCC
AAGCCACAC.TATTCAACG	AAGCCACAC.TATTCAACG
AAGCCACAC.TCAGCGACC	AAGCCACAC.TCAGCGACC
AAGCCACAC.TCCGATCTG	AAGCCACAC.TCCGATCTG
AAGCCACAC.TTAAGTGGT	AAGCCACAC.TTAAGTGGT
AAGCTGAGG.AAGGTCTGA	AAGCTGAGG.AAGGTCTGA
AAGCTGAGG.ACGACATCT	AAGCTGAGG.ACGACATCT
AAGCTGAGG.CCATTCTGC	AAGCTGAGG.CCATTCTGC
AAGCTGAGG.GGTCGGTCT	AAGCTGAGG.GGTCGGTCT
AAGCTGAGG.TCACCGAGG	AAGCTGAGG.TCACCGAGG
AAGCTGGTC.ACAATAGGT	AAGCTGGTC.ACAATAGGT
AAGCTGGTC.ATAGTCAGT	AAGCTGGTC.ATAGTCAGT
AAGCTGGTC.GGATAGTCA	AAGCTGGTC.GGATAGTCA
AAGCTTGCA.TGGATTAGC	AAGCTTGCA.TGGATTAGC
AAGGAACAG.CAATCTCCG	AAGGAACAG.CAATCTCCG
AAGGAAGTC.ATATCCGAT	AAGGAAGTC.ATATCCGAT
AAGGAAGTC.ATGCTCACC	AAGGAAGTC.ATGCTCACC
AAGGAAGTC.GCCGCTATC	AAGGAAGTC.GCCGCTATC
AAGGAAGTC.TCGAACGCT	AAGGAAGTC.TCGAACGCT
AAGGATACG.CGCCACCAT	AAGGATACG.CGCCACCAT
AAGGATCGT.ACACGTTGC	AAGGATCGT.ACACGTTGC
AAGGATCGT.CCATAATCG	AAGGATCGT.CCATAATCG
AAGGATCGT.GCTTCACTC	AAGGATCGT.GCTTCACTC
AAGGATCGT.TGTAGATCG	AAGGATCGT.TGTAGATCG
AAGGTCTGA.CTGTAGAAG	AAGGTCTGA.CTGTAGAAG
AAGGTCTGA.TATGAAGAC	AAGGTCTGA.TATGAAGAC
AAGGTGCTG.ACGGTGCCT	AAGGTGCTG.ACGGTGCCT
AAGGTGCTG.ATTATGCAG	AAGGTGCTG.ATTATGCAG
AAGGTGCTG.CCGGATTGC	AAGGTGCTG.CCGGATTGC
AAGGTGCTG.CTGAGGTTA	AAGGTGCTG.CTGAGGTTA
AAGGTGCTG.CTGGTAATC	AAGGTGCTG.CTGGTAATC
AAGGTGCTG.GCCTGGAAT	AAGGTGCTG.GCCTGGAAT
AAGGTGCTG.GCGCTCTAT	AAGGTGCTG.GCGCTCTAT
AAGTAGGAC.AGGTGTACA	AAGTAGGAC.AGGTGTACA
AAGTAGGAC.CGATTGAAC	AAGTAGGAC.CGATTGAAC
AAGTAGGAC.TGATGACAG	AAGTAGGAC.TGATGACAG
AAGTCATGA.AAGGAAGTC	AAGTCATGA.AAGGAAGTC
AAGTCATGA.GATCTACTT	AAGTCATGA.GATCTACTT
AAGTCATGA.GGAGCTCAA	AAGTCATGA.GGAGCTCAA
AAGTTCTCT.ACACCGCCA	AAGTTCTCT.ACACCGCCA
AAGTTGCCA.AACTAACTG	AAGTTGCCA.AACTAACTG
AAGTTGCCA.CAATGCATT	AAGTTGCCA.CAATGCATT
AAGTTGCCA.CAGTATGAT	AAGTTGCCA.CAGTATGAT
AAGTTGCCA.CGTTGATCC	AAGTTGCCA.CGTTGATCC
AAGTTGCCA.CTGCGTCAC	AAGTTGCCA.CTGCGTCAC
AAGTTGCCA.TACTTACCA	AAGTTGCCA.TACTTACCA
AATAACTCC.AGGAGGTGA	AATAACTCC.AGGAGGTGA
AATAACTCC.ATACAACCG	AATAACTCC.ATACAACCG
AATAACTCC.CACCAAGAT	AATAACTCC.CACCAAGAT
AATAACTCC.CTTACCTAG	AATAACTCC.CTTACCTAG
AATAACTCC.TTCCTAAGG	AATAACTCC.TTCCTAAGG
AATACCTTG.AGTCATACT	AATACCTTG.AGTCATACT
AATACCTTG.CTCCGCATT	AATACCTTG.CTCCGCATT
AATACGTCT.CTGACGGAT	AATACGTCT.CTGACGGAT
AATACTCCG.GTAGCATAC	AATACTCCG.GTAGCATAC
AATACTCCG.TCGTGACGT	AATACTCCG.TCGTGACGT
AATATCAGC.AGACCACGC	AATATCAGC.AGACCACGC
AATATCAGC.AGCATTGTT	AATATCAGC.AGCATTGTT
AATATCAGC.AGCGACACC	AATATCAGC.AGCGACACC
AATATCAGC.CACCTAGCG	AATATCAGC.CACCTAGCG
AATATCAGC.CCGACTGTT	AATATCAGC.CCGACTGTT
AATATCAGC.CCTCGAGAG	AATATCAGC.CCTCGAGAG
AATATCAGC.CGTCGTCAA	AATATCAGC.CGTCGTCAA
AATATCAGC.CTACTGTCA	AATATCAGC.CTACTGTCA
AATATCAGC.TTGGACTTC	AATATCAGC.TTGGACTTC
AATATCGCT.CATTCCGAG	AATATCGCT.CATTCCGAG
AATATCGCT.TCTCGATGC	AATATCGCT.TCTCGATGC
AATCAGGAG.ATGGACGTT	AATCAGGAG.ATGGACGTT
AATCAGGAG.ATGTGACGA	AATCAGGAG.ATGTGACGA
AATCAGGAG.GCTTGTCCT	AATCAGGAG.GCTTGTCCT
AATCAGGAG.TATGAAGAC	AATCAGGAG.TATGAAGAC
AATCCGCTG.AATGAGTCG	AATCCGCTG.AATGAGTCG
AATCCGCTG.ATAGTCAGT	AATCCGCTG.ATAGTCAGT
AATCCGCTG.CCAGGAGTT	AATCCGCTG.CCAGGAGTT
AATCCGCTG.TCATATCGC	AATCCGCTG.TCATATCGC
AATCCTCGT.TTGTATCAC	AATCCTCGT.TTGTATCAC
AATCGCCAT.AGACGCTAT	AATCGCCAT.AGACGCTAT
AATCGCCAT.CATTCCGAG	AATCGCCAT.CATTCCGAG
AATCGCCAT.CGCAGTGTC	AATCGCCAT.CGCAGTGTC
AATCGTGTT.AATGCAGCG	AATCGTGTT.AATGCAGCG
AATCGTGTT.ACTACCATC	AATCGTGTT.ACTACCATC
AATCGTGTT.CTCAGCTGG	AATCGTGTT.CTCAGCTGG
AATCTCCTA.CGGAGACTT	AATCTCCTA.CGGAGACTT
AATCTCCTA.GATTATGCG	AATCTCCTA.GATTATGCG
AATCTCCTA.TACAACACC	AATCTCCTA.TACAACACC
AATCTGACC.CTTAGAAGG	AATCTGACC.CTTAGAAGG
AATCTGACC.TCTAATACC	AATCTGACC.TCTAATACC
AATGAGTCG.GCTACAATG	AATGAGTCG.GCTACAATG
AATGAGTCG.GGATACAAT	AATGAGTCG.GGATACAAT
AATGAGTCG.GTACGTCTA	AATGAGTCG.GTACGTCTA
AATGAGTCG.TGACCTCCT	AATGAGTCG.TGACCTCCT
AATGAGTCG.TTCTGGTGC	AATGAGTCG.TTCTGGTGC
AATGCACTT.CCAACGGAA	AATGCACTT.CCAACGGAA
AATGCACTT.CTATCTTGA	AATGCACTT.CTATCTTGA
AATGCAGCG.ATCCATTAG	AATGCAGCG.ATCCATTAG
AATGCCTCA.AGACATATC	AATGCCTCA.AGACATATC
AATGCCTCA.CGCAATCGA	AATGCCTCA.CGCAATCGA
AATGCCTCA.CTAGTCGTC	AATGCCTCA.CTAGTCGTC
AATGCCTCA.GACACCGAT	AATGCCTCA.GACACCGAT
AATGCCTCA.TTACGCTCG	AATGCCTCA.TTACGCTCG
AATGCGTGC.AAGGAACAG	AATGCGTGC.AAGGAACAG
AATGCGTGC.CAACCTGGT	AATGCGTGC.CAACCTGGT
AATGCGTGC.TATTACTCG	AATGCGTGC.TATTACTCG
AATGCGTGC.TGGAATCGT	AATGCGTGC.TGGAATCGT
AATGCTATC.ATAAGTTCG	AATGCTATC.ATAAGTTCG
AATGCTATC.TCAAGGTCG	AATGCTATC.TCAAGGTCG
AATGCTGAT.ACAGAAGAG	AATGCTGAT.ACAGAAGAG
AATGCTGAT.ACTTCTTGG	AATGCTGAT.ACTTCTTGG
AATGCTGAT.CTCATTAGT	AATGCTGAT.CTCATTAGT
AATGCTGAT.CTGTAGAAG	AATGCTGAT.CTGTAGAAG
AATGCTGAT.GCCACGAGT	AATGCTGAT.GCCACGAGT
AATGCTGAT.TCCGGAGCT	AATGCTGAT.TCCGGAGCT
AATGTGCGT.ACCTGTACC	AATGTGCGT.ACCTGTACC
AATGTGCGT.ATATGCAGC	AATGTGCGT.ATATGCAGC
AATGTGCGT.CTGGACACT	AATGTGCGT.CTGGACACT
AATTAGAGG.CAGCGACGT	AATTAGAGG.CAGCGACGT
AATTAGAGG.CGCTTCACG	AATTAGAGG.CGCTTCACG
AATTAGAGG.TAACACATC	AATTAGAGG.TAACACATC
AATTCGGAA.CCTGTTAGC	AATTCGGAA.CCTGTTAGC
AATTCGGAA.CGCGAGTGT	AATTCGGAA.CGCGAGTGT
AATTCGGAA.GTTAATTCG	AATTCGGAA.GTTAATTCG
AATTCGGAA.TAAGCCATT	AATTCGGAA.TAAGCCATT
AATTGGATC.AGACATATC	AATTGGATC.AGACATATC
AATTGGATC.ATAGCCTAA	AATTGGATC.ATAGCCTAA
AATTGGATC.GCACTGGAT	AATTGGATC.GCACTGGAT
AATTGGATC.GCCGCCTAA	AATTGGATC.GCCGCCTAA
AATTGGTGA.AAGCATTGC	AATTGGTGA.AAGCATTGC
AATTGGTGA.AGTGTTCTG	AATTGGTGA.AGTGTTCTG
AATTGGTGA.CACGTAGAC	AATTGGTGA.CACGTAGAC
AATTGGTGA.CATAAGATC	AATTGGTGA.CATAAGATC
AATTGGTGA.TCAGTGCAA	AATTGGTGA.TCAGTGCAA
ACAACCGGA.ATATGTCCA	ACAACCGGA.ATATGTCCA
ACAACCGGA.CAATGCATT	ACAACCGGA.CAATGCATT
ACAACCGGA.CCTTCGAGC	ACAACCGGA.CCTTCGAGC
ACAACCGGA.TCGTGACGT	ACAACCGGA.TCGTGACGT
ACAACCGGA.TCTGCGCTG	ACAACCGGA.TCTGCGCTG
ACAACCGGA.TTGTCAACC	ACAACCGGA.TTGTCAACC
ACAACGAGC.ACACACCGT	ACAACGAGC.ACACACCGT
ACAACGAGC.TCGAACGCT	ACAACGAGC.TCGAACGCT
ACAACGAGC.TGCCGAACT	ACAACGAGC.TGCCGAACT
ACAACGAGC.TGCTTACGG	ACAACGAGC.TGCTTACGG
ACAAGAATG.CACACTGCC	ACAAGAATG.CACACTGCC
ACAAGAATG.GTCCACAAC	ACAAGAATG.GTCCACAAC
ACAAGAATG.GTCGTTAGA	ACAAGAATG.GTCGTTAGA
ACAAGAATG.GTGTCCGTG	ACAAGAATG.GTGTCCGTG
ACAAGAATG.TCCAGCTAT	ACAAGAATG.TCCAGCTAT
ACAAGGTAC.TGTATGTAG	ACAAGGTAC.TGTATGTAG
ACAAGTACA.CTTCTCATC	ACAAGTACA.CTTCTCATC
ACAAGTACA.TGCAACTCT	ACAAGTACA.TGCAACTCT
ACAATAGGT.AACTAACTG	ACAATAGGT.AACTAACTG
ACAATAGGT.AGCATTGTT	ACAATAGGT.AGCATTGTT
ACAATAGGT.AGTAATCAG	ACAATAGGT.AGTAATCAG
ACAATAGGT.ATCAGAAGC	ACAATAGGT.ATCAGAAGC
ACAATAGGT.ATGTGAGAC	ACAATAGGT.ATGTGAGAC
ACAATTCGG.ATGCTCACC	ACAATTCGG.ATGCTCACC
ACAATTCGG.ATTAAGACC	ACAATTCGG.ATTAAGACC
ACAATTCGG.CATCCTCTC	ACAATTCGG.CATCCTCTC
ACAATTCGG.GAAGAGCAC	ACAATTCGG.GAAGAGCAC
ACAATTCGG.GATTGGAAG	ACAATTCGG.GATTGGAAG
ACAATTCGG.TTAGCGTCT	ACAATTCGG.TTAGCGTCT
ACACACCGT.GCTTCACTC	ACACACCGT.GCTTCACTC
ACACACGTC.ACCATTCAC	ACACACGTC.ACCATTCAC
ACACAGAAC.TATACCACT	ACACAGAAC.TATACCACT
ACACATCTG.CACTAGACT	ACACATCTG.CACTAGACT
ACACATCTG.GTAACCATA	ACACATCTG.GTAACCATA
ACACATCTG.TATGTACCT	ACACATCTG.TATGTACCT
ACACCACAT.CATAGGTGT	ACACCACAT.CATAGGTGT
ACACCACAT.CGCGCACAT	ACACCACAT.CGCGCACAT
ACACCACAT.GAGATTCCT	ACACCACAT.GAGATTCCT
ACACCACAT.TCGTGCCAC	ACACCACAT.TCGTGCCAC
ACACCACAT.TCTTAGCGA	ACACCACAT.TCTTAGCGA
ACACCACAT.TGCACGATG	ACACCACAT.TGCACGATG
ACACCGCCA.AGGATTGAG	ACACCGCCA.AGGATTGAG
ACACCGCCA.AGTCTAAGC	ACACCGCCA.AGTCTAAGC
ACACCGCCA.CATCAATAG	ACACCGCCA.CATCAATAG
ACACCGCCA.GCTGATGTC	ACACCGCCA.GCTGATGTC
ACACCGCCA.TCACACTGC	ACACCGCCA.TCACACTGC
ACACCGCCA.TCGCTTAAC	ACACCGCCA.TCGCTTAAC
ACACGTTGC.AATCGTGTT	ACACGTTGC.AATCGTGTT
ACACGTTGC.GGACTCCTT	ACACGTTGC.GGACTCCTT
ACACGTTGC.TAGATAGCC	ACACGTTGC.TAGATAGCC
ACACGTTGC.TTCTGGTGC	ACACGTTGC.TTCTGGTGC
ACACTAACG.AGCGTCGTC	ACACTAACG.AGCGTCGTC
ACACTAACG.AGGAGGTGA	ACACTAACG.AGGAGGTGA
ACACTAACG.CCTGCGTTA	ACACTAACG.CCTGCGTTA
ACACTAACG.CGCGTACTA	ACACTAACG.CGCGTACTA
ACACTAACG.GCAGCAGTG	ACACTAACG.GCAGCAGTG
ACACTAACG.GCCTTATCT	ACACTAACG.GCCTTATCT
ACACTAACG.GTCGACATT	ACACTAACG.GTCGACATT
ACACTAACG.TTCCAGGAG	ACACTAACG.TTCCAGGAG
ACACTGTGA.GCGATATGA	ACACTGTGA.GCGATATGA
ACACTGTGA.TATTCAACG	ACACTGTGA.TATTCAACG
ACACTGTGA.TCTATGACA	ACACTGTGA.TCTATGACA
ACACTGTGA.TGAGATCAT	ACACTGTGA.TGAGATCAT
ACAGAAGAG.AGTCGCCGA	ACAGAAGAG.AGTCGCCGA
ACAGAAGAG.AGTGATGCG	ACAGAAGAG.AGTGATGCG
ACAGAAGAG.CATAAGATC	ACAGAAGAG.CATAAGATC
ACAGAAGAG.CTTCACTGT	ACAGAAGAG.CTTCACTGT
ACAGAGATG.AGCGACACC	ACAGAGATG.AGCGACACC
ACAGAGATG.GTAGTTGGT	ACAGAGATG.GTAGTTGGT
ACAGCATCA.AACGCCTAC	ACAGCATCA.AACGCCTAC
ACAGCATCA.ATCAAGAGA	ACAGCATCA.ATCAAGAGA
ACAGCATCA.CTAACCGGT	ACAGCATCA.CTAACCGGT
ACAGCATCA.CTGTACGAC	ACAGCATCA.CTGTACGAC
ACAGCATCA.TCCATCATT	ACAGCATCA.TCCATCATT
ACAGCATCA.TGTTGTCGA	ACAGCATCA.TGTTGTCGA
ACAGCGGTC.CAGCTTACC	ACAGCGGTC.CAGCTTACC
ACAGCGGTC.TACCAGCCA	ACAGCGGTC.TACCAGCCA
ACAGCGTAT.TATCGAGCC	ACAGCGTAT.TATCGAGCC
ACAGGAACT.AGTGTTCTG	ACAGGAACT.AGTGTTCTG
ACAGGAACT.CTCTAAGAG	ACAGGAACT.CTCTAAGAG
ACAGGAACT.CTTGCACAA	ACAGGAACT.CTTGCACAA
ACAGGAACT.TGTGGTCCT	ACAGGAACT.TGTGGTCCT
ACAGGTATC.AATCGTGTT	ACAGGTATC.AATCGTGTT
ACAGGTATC.CTCGACGAT	ACAGGTATC.CTCGACGAT
ACAGGTATC.CTCTTCAGC	ACAGGTATC.CTCTTCAGC
ACAGGTATC.GCCATCGCT	ACAGGTATC.GCCATCGCT
ACAGTATTG.CCGGTGGTT	ACAGTATTG.CCGGTGGTT
ACAGTATTG.CTAGTGCTG	ACAGTATTG.CTAGTGCTG
ACAGTATTG.GGATGCGAA	ACAGTATTG.GGATGCGAA
ACATCGTCC.GCGAAGCTC	ACATCGTCC.GCGAAGCTC
ACATGACTA.AATGCGTGC	ACATGACTA.AATGCGTGC
ACATGACTA.AGTTGCCTT	ACATGACTA.AGTTGCCTT
ACATGACTA.CACGGATAG	ACATGACTA.CACGGATAG
ACATGACTA.GTCTGACGT	ACATGACTA.GTCTGACGT
ACATGGATT.CTGAGATAG	ACATGGATT.CTGAGATAG
ACATGGATT.GGTTCTATC	ACATGGATT.GGTTCTATC
ACATTCCAC.AATGTGCGT	ACATTCCAC.AATGTGCGT
ACATTCCAC.CTTCCGTGG	ACATTCCAC.CTTCCGTGG
ACATTCCAC.GCAGGAGAA	ACATTCCAC.GCAGGAGAA
ACATTGACA.ATCGGTGGT	ACATTGACA.ATCGGTGGT
ACATTGACA.ATTGACACG	ACATTGACA.ATTGACACG
ACATTGACA.CGTATTCCT	ACATTGACA.CGTATTCCT
ACATTGACA.GATCTACTT	ACATTGACA.GATCTACTT
ACCACGCTA.AGTCGATCA	ACCACGCTA.AGTCGATCA
ACCACGCTA.GCAATGAGA	ACCACGCTA.GCAATGAGA
ACCACGCTA.TGGATTAGC	ACCACGCTA.TGGATTAGC
ACCACGGAT.TACCGATTG	ACCACGGAT.TACCGATTG
ACCACGGAT.TACGAGTGA	ACCACGGAT.TACGAGTGA
ACCACGGAT.TGGAGAGTG	ACCACGGAT.TGGAGAGTG
ACCACTAGG.GATTCCTCT	ACCACTAGG.GATTCCTCT
ACCAGCGTT.GTCAGTTGT	ACCAGCGTT.GTCAGTTGT
ACCATACTT.AGCCACTTC	ACCATACTT.AGCCACTTC
ACCATACTT.CAGGAGCCT	ACCATACTT.CAGGAGCCT
ACCATACTT.TACAGTTAG	ACCATACTT.TACAGTTAG
ACCATCTAA.ATCGGTGGT	ACCATCTAA.ATCGGTGGT
ACCATCTAA.ATGATAGCT	ACCATCTAA.ATGATAGCT
ACCATCTAA.CACCTAGCG	ACCATCTAA.CACCTAGCG
ACCATCTAA.CCGGATTGC	ACCATCTAA.CCGGATTGC
ACCATCTAA.CTGAGGTTA	ACCATCTAA.CTGAGGTTA
ACCATCTAA.GTCCTTCAT	ACCATCTAA.GTCCTTCAT
ACCATGTCT.AGCTTGGTG	ACCATGTCT.AGCTTGGTG
ACCATGTCT.CTGTTACCA	ACCATGTCT.CTGTTACCA
ACCATGTCT.TATACCACT	ACCATGTCT.TATACCACT
ACCATGTCT.TGATTGTGC	ACCATGTCT.TGATTGTGC
ACCATTCAC.ATAGTCAGT	ACCATTCAC.ATAGTCAGT
ACCATTCAC.ATGCTCACC	ACCATTCAC.ATGCTCACC
ACCATTCAC.CATAGTATG	ACCATTCAC.CATAGTATG
ACCATTCAC.GATTAGTGT	ACCATTCAC.GATTAGTGT
ACCGACGGT.AACGAGGTG	ACCGACGGT.AACGAGGTG
ACCGACGGT.AGAGCCGCA	ACCGACGGT.AGAGCCGCA
ACCGACGGT.GGATGCGAA	ACCGACGGT.GGATGCGAA
ACCGACGGT.TCAGACAAG	ACCGACGGT.TCAGACAAG
ACCGAGACA.ATCAGAAGC	ACCGAGACA.ATCAGAAGC
ACCGAGACA.CCGATCAGC	ACCGAGACA.CCGATCAGC
ACCGAGACA.GCCTTCCAT	ACCGAGACA.GCCTTCCAT
ACCGAGACA.GGTTAGATG	ACCGAGACA.GGTTAGATG
ACCGAGACA.GTCCGCTCA	ACCGAGACA.GTCCGCTCA
ACCGAGTAG.ATCACTTCC	ACCGAGTAG.ATCACTTCC
ACCGAGTAG.CAAGAGAGT	ACCGAGTAG.CAAGAGAGT
ACCGAGTAG.CCTGTTAGC	ACCGAGTAG.CCTGTTAGC
ACCGAGTAG.CGTCATGGA	ACCGAGTAG.CGTCATGGA
ACCGAGTAG.GACTCTCAC	ACCGAGTAG.GACTCTCAC
ACCGAGTAG.GCCATACAA	ACCGAGTAG.GCCATACAA
ACCGAGTAG.GTCTTATGC	ACCGAGTAG.GTCTTATGC
ACCGATCGA.CGGACAAGT	ACCGATCGA.CGGACAAGT
ACCGCTGTG.AATCGCCAT	ACCGCTGTG.AATCGCCAT
ACCGCTGTG.ATTGCCGAC	ACCGCTGTG.ATTGCCGAC
ACCGCTGTG.GCATACATG	ACCGCTGTG.GCATACATG
ACCGGAAGG.ACCTTGAAG	ACCGGAAGG.ACCTTGAAG
ACCGGAAGG.GATCTGAAT	ACCGGAAGG.GATCTGAAT
ACCGGAAGG.TATTCAACG	ACCGGAAGG.TATTCAACG
ACCGGAGTA.AGAGCGCGA	ACCGGAGTA.AGAGCGCGA
ACCGGAGTA.GCGCTTCTC	ACCGGAGTA.GCGCTTCTC
ACCGGAGTA.GTACGCGAT	ACCGGAGTA.GTACGCGAT
ACCGGAGTA.GTGCACGAG	ACCGGAGTA.GTGCACGAG
ACCGGTTAC.CGAATCCTG	ACCGGTTAC.CGAATCCTG
ACCGGTTAC.TCGTTCTCC	ACCGGTTAC.TCGTTCTCC
ACCGGTTAC.TGACGATGA	ACCGGTTAC.TGACGATGA
ACCGTCACG.ATAGCCTAA	ACCGTCACG.ATAGCCTAA
ACCGTCACG.GCAGCTCTT	ACCGTCACG.GCAGCTCTT
ACCGTCACG.GTAGAAGTT	ACCGTCACG.GTAGAAGTT
ACCTAGCAC.ACACGTTGC	ACCTAGCAC.ACACGTTGC
ACCTAGCAC.CATCGCTGG	ACCTAGCAC.CATCGCTGG
ACCTAGCAC.TGGTCCTAG	ACCTAGCAC.TGGTCCTAG
ACCTAGTTA.TCAGACAAG	ACCTAGTTA.TCAGACAAG
ACCTAGTTA.TTAAGTGGT	ACCTAGTTA.TTAAGTGGT
ACCTCCTAG.AATGCTGAT	ACCTCCTAG.AATGCTGAT
ACCTGCAGA.ACAATTCGG	ACCTGCAGA.ACAATTCGG
ACCTGCAGA.CAATCAAGT	ACCTGCAGA.CAATCAAGT
ACCTGCAGA.TGTGAGTAT	ACCTGCAGA.TGTGAGTAT
ACCTGTACC.AGCAAGTCC	ACCTGTACC.AGCAAGTCC
ACCTGTACC.TCAAGCGTA	ACCTGTACC.TCAAGCGTA
ACCTTGAAG.CGTCTGTCC	ACCTTGAAG.CGTCTGTCC
ACCTTGAAG.GCATTGATC	ACCTTGAAG.GCATTGATC
ACCTTGAAG.GTCACAGAG	ACCTTGAAG.GTCACAGAG
ACCTTGAAG.TGAGCAGAT	ACCTTGAAG.TGAGCAGAT
ACGAATCGC.CAAGTACGA	ACGAATCGC.CAAGTACGA
ACGAATCGC.CGACCACTT	ACGAATCGC.CGACCACTT
ACGAATCGC.GAACGCTGT	ACGAATCGC.GAACGCTGT
ACGAATCGC.TACTTACCA	ACGAATCGC.TACTTACCA
ACGACAGTC.AGTCGTCCG	ACGACAGTC.AGTCGTCCG
ACGACAGTC.CTTCTATGA	ACGACAGTC.CTTCTATGA
ACGACAGTC.GGTGAGCGT	ACGACAGTC.GGTGAGCGT
ACGACAGTC.TAGTTGACG	ACGACAGTC.TAGTTGACG
ACGACAGTC.TATTCAACG	ACGACAGTC.TATTCAACG
ACGACGATT.CAGCTGGAG	ACGACGATT.CAGCTGGAG
ACGACGATT.GCGATATGA	ACGACGATT.GCGATATGA
ACGACGATT.TCGCGTCAT	ACGACGATT.TCGCGTCAT
ACGACGATT.TGGAGAGTG	ACGACGATT.TGGAGAGTG
ACGAGAGCA.GATACTGTG	ACGAGAGCA.GATACTGTG
ACGAGAGCA.GCGGAGATT	ACGAGAGCA.GCGGAGATT
ACGAGAGCA.GGATTACGC	ACGAGAGCA.GGATTACGC
ACGAGAGCA.GTCGCAGGT	ACGAGAGCA.GTCGCAGGT
ACGAGAGCA.TAGATCTGT	ACGAGAGCA.TAGATCTGT
ACGAGAGCA.TCTCATCGG	ACGAGAGCA.TCTCATCGG
ACGAGCTTC.ACAAGTACA	ACGAGCTTC.ACAAGTACA
ACGAGCTTC.ATGATAGCT	ACGAGCTTC.ATGATAGCT
ACGAGCTTC.CAGGAGCCT	ACGAGCTTC.CAGGAGCCT
ACGAGCTTC.CCGACTTGG	ACGAGCTTC.CCGACTTGG
ACGAGCTTC.TGCATACAT	ACGAGCTTC.TGCATACAT
ACGATGACC.CGAATGAGT	ACGATGACC.CGAATGAGT
ACGATGACC.GGAACTGCT	ACGATGACC.GGAACTGCT
ACGATGACC.GTTCAGAAG	ACGATGACC.GTTCAGAAG
ACGATGACC.TCCGGAGCT	ACGATGACC.TCCGGAGCT
ACGATGGAA.AACTTAGCT	ACGATGGAA.AACTTAGCT
ACGATGGAA.AATTGGTGA	ACGATGGAA.AATTGGTGA
ACGATGGAA.AGTGTGCAC	ACGATGGAA.AGTGTGCAC
ACGATGGAA.GCTAGTGGA	ACGATGGAA.GCTAGTGGA
ACGCAAGAT.AATAACTCC	ACGCAAGAT.AATAACTCC
ACGCAAGAT.ACACCACAT	ACGCAAGAT.ACACCACAT
ACGCAAGAT.ACGTTCAAT	ACGCAAGAT.ACGTTCAAT
ACGCAAGAT.ATCCAATGA	ACGCAAGAT.ATCCAATGA
ACGCAAGAT.CTCTGCGGT	ACGCAAGAT.CTCTGCGGT
ACGCAAGAT.GGATAGTCA	ACGCAAGAT.GGATAGTCA
ACGCACACT.CCACGAAGG	ACGCACACT.CCACGAAGG
ACGCACACT.CGCTTGTAG	ACGCACACT.CGCTTGTAG
ACGCACACT.CTCCTGACG	ACGCACACT.CTCCTGACG
ACGCACACT.TCAAGGAGT	ACGCACACT.TCAAGGAGT
ACGCACACT.TTCGCTGAG	ACGCACACT.TTCGCTGAG
ACGCGACAG.ACAGCATCA	ACGCGACAG.ACAGCATCA
ACGCGACAG.CAAGGTGTG	ACGCGACAG.CAAGGTGTG
ACGCGACAG.GGAATTGGA	ACGCGACAG.GGAATTGGA
ACGCGTGAC.GAGATTCCT	ACGCGTGAC.GAGATTCCT
ACGCGTGAC.TGAGCAGAT	ACGCGTGAC.TGAGCAGAT
ACGCGTGAC.TGTCCATAG	ACGCGTGAC.TGTCCATAG
ACGCTAGTG.AACGCCTAC	ACGCTAGTG.AACGCCTAC
ACGCTAGTG.ATTGATCAC	ACGCTAGTG.ATTGATCAC
ACGCTAGTG.GAATTGTTG	ACGCTAGTG.GAATTGTTG
ACGCTATGT.ATTATGCAG	ACGCTATGT.ATTATGCAG
ACGCTCTTA.CCACTTCGC	ACGCTCTTA.CCACTTCGC
ACGCTCTTA.GGAATTGGA	ACGCTCTTA.GGAATTGGA
ACGCTCTTA.TATGCCTTC	ACGCTCTTA.TATGCCTTC
ACGCTCTTA.TTGCGAACA	ACGCTCTTA.TTGCGAACA
ACGGACCAT.CAATTGTCT	ACGGACCAT.CAATTGTCT
ACGGACCAT.TCGGATGTT	ACGGACCAT.TCGGATGTT
ACGGTGCCT.GCCTTCCAT	ACGGTGCCT.GCCTTCCAT
ACGGTGTAC.CCTAGAGTA	ACGGTGTAC.CCTAGAGTA
ACGGTGTAC.CTCCTATCT	ACGGTGTAC.CTCCTATCT
ACGGTGTAC.TAGCCTTGT	ACGGTGTAC.TAGCCTTGT
ACGTAGTAT.ACAGGTATC	ACGTAGTAT.ACAGGTATC
ACGTATGTC.AATACCTTG	ACGTATGTC.AATACCTTG
ACGTATGTC.ATAGAGCAG	ACGTATGTC.ATAGAGCAG
ACGTATGTC.TACCTCACT	ACGTATGTC.TACCTCACT
ACGTCGCTC.CCAAGCGAG	ACGTCGCTC.CCAAGCGAG
ACGTCGCTC.CTACGTTGG	ACGTCGCTC.CTACGTTGG
ACGTCGCTC.GCGAAGACA	ACGTCGCTC.GCGAAGACA
ACGTCGCTC.GTAACTCAT	ACGTCGCTC.GTAACTCAT
ACGTCTATG.ATCCTCCGA	ACGTCTATG.ATCCTCCGA
