TAGATAGCC.GCCACGAGT	TAGATAGCC.GCCACGAGT
TAGATAGCC.GCGTGAGCT	TAGATAGCC.GCGTGAGCT
TAGATAGCC.GGTACGAGC	TAGATAGCC.GGTACGAGC
TAGATAGCC.GTTATCGAT	TAGATAGCC.GTTATCGAT
TAGATAGCC.TCGATTCAG	TAGATAGCC.TCGATTCAG
TAGATCTGT.ATATCAGCC	TAGATCTGT.ATATCAGCC
TAGATCTGT.CCTGTCGAC	TAGATCTGT.CCTGTCGAC
TAGATCTGT.GCATTGATC	TAGATCTGT.GCATTGATC
TAGCACACG.ATTGATCAC	TAGCACACG.ATTGATCAC
TAGCACACG.TCCACCGGT	TAGCACACG.TCCACCGGT
TAGCACTAT.ACATGGATT	TAGCACTAT.ACATGGATT
TAGCAGAGT.GTATTACTG	TAGCAGAGT.GTATTACTG
TAGCAGAGT.TATACCACT	TAGCAGAGT.TATACCACT
TAGCAGAGT.TTCGGAGTC	TAGCAGAGT.TTCGGAGTC
TAGCCAGTG.CGTATCGAA	TAGCCAGTG.CGTATCGAA
TAGCCAGTG.GCTGGTAAC	TAGCCAGTG.GCTGGTAAC
TAGCCAGTG.TAACATTGG	TAGCCAGTG.TAACATTGG
TAGCCAGTG.TCGTACCTT	TAGCCAGTG.TCGTACCTT
TAGCCTTGT.AATTGGATC	TAGCCTTGT.AATTGGATC
TAGCCTTGT.AGACTTCGT	TAGCCTTGT.AGACTTCGT
TAGCCTTGT.CCTTAACAT	TAGCCTTGT.CCTTAACAT
TAGCCTTGT.TGTGCTAAC	TAGCCTTGT.TGTGCTAAC
TAGCGAGAA.AAGCCAAGT	TAGCGAGAA.AAGCCAAGT
TAGCGAGAA.CATTATGTC	TAGCGAGAA.CATTATGTC
TAGCGAGAA.GCGCTTCTC	TAGCGAGAA.GCGCTTCTC
TAGCGAGAA.TCTGCGCTG	TAGCGAGAA.TCTGCGCTG
TAGCGAGAA.TGCGTATCT	TAGCGAGAA.TGCGTATCT
TAGCGCAGC.ATACTTGCT	TAGCGCAGC.ATACTTGCT
TAGCGCAGC.CTCGTCTTG	TAGCGCAGC.CTCGTCTTG
TAGCTAAGA.AAGCTTGCA	TAGCTAAGA.AAGCTTGCA
TAGCTAAGA.CCTTAACAT	TAGCTAAGA.CCTTAACAT
TAGCTAAGA.GCTACAATG	TAGCTAAGA.GCTACAATG
TAGCTAAGA.GTAGGACGC	TAGCTAAGA.GTAGGACGC
TAGCTAAGA.GTAGTTGGT	TAGCTAAGA.GTAGTTGGT
TAGCTGTTG.AGTACGAAT	TAGCTGTTG.AGTACGAAT
TAGCTGTTG.TACCTCACT	TAGCTGTTG.TACCTCACT
TAGGAGCTA.CACCTAGCG	TAGGAGCTA.CACCTAGCG
TAGGAGCTA.CTTACATGC	TAGGAGCTA.CTTACATGC
TAGGAGCTA.GACTTGATT	TAGGAGCTA.GACTTGATT
TAGGAGCTA.TCTAGTGAC	TAGGAGCTA.TCTAGTGAC
TAGGAGGAT.CCTATTCAA	TAGGAGGAT.CCTATTCAA
TAGGAGGAT.GACCGTAGT	TAGGAGGAT.GACCGTAGT
TAGGAGGAT.GAGAACAGG	TAGGAGGAT.GAGAACAGG
TAGGATGCC.CAAGTCGAA	TAGGATGCC.CAAGTCGAA
TAGGATGCC.CACATTCTG	TAGGATGCC.CACATTCTG
TAGGATGCC.CATCAATAG	TAGGATGCC.CATCAATAG
TAGGATGCC.GATCGATAC	TAGGATGCC.GATCGATAC
TAGGATGCC.TATACGGAT	TAGGATGCC.TATACGGAT
TAGGATGCC.TTGGAGAAC	TAGGATGCC.TTGGAGAAC
TAGGATTAG.CCATATCTT	TAGGATTAG.CCATATCTT
TAGGATTAG.GACGCCGTA	TAGGATTAG.GACGCCGTA
TAGGATTAG.TCGCTGTAA	TAGGATTAG.TCGCTGTAA
TAGGTCAAC.AATACTCCG	TAGGTCAAC.AATACTCCG
TAGGTCAAC.AGTCTGGAA	TAGGTCAAC.AGTCTGGAA
TAGGTCAAC.TCCACCTCA	TAGGTCAAC.TCCACCTCA
TAGGTTAGT.ATGCGGATT	TAGGTTAGT.ATGCGGATT
TAGGTTAGT.CAGAAGTGA	TAGGTTAGT.CAGAAGTGA
TAGGTTAGT.TAAGTACAC	TAGGTTAGT.TAAGTACAC
TAGGTTAGT.TATGCCTTC	TAGGTTAGT.TATGCCTTC
TAGTAACGG.AAGCCACAC	TAGTAACGG.AAGCCACAC
TAGTAACGG.GGTCCTGGT	TAGTAACGG.GGTCCTGGT
TAGTAACGG.GTGGTACGG	TAGTAACGG.GTGGTACGG
TAGTAACGG.TAACCGTGA	TAGTAACGG.TAACCGTGA
TAGTACGTA.AGTTCAACC	TAGTACGTA.AGTTCAACC
TAGTACGTA.AGTTGCCTT	TAGTACGTA.AGTTGCCTT
TAGTACGTA.CACACTGCC	TAGTACGTA.CACACTGCC
TAGTACGTA.CAGTGCCAT	TAGTACGTA.CAGTGCCAT
TAGTACGTA.CCTAGCAAT	TAGTACGTA.CCTAGCAAT
TAGTAGTCT.CACAGCGAA	TAGTAGTCT.CACAGCGAA
TAGTCAGAC.ATTATGCAG	TAGTCAGAC.ATTATGCAG
TAGTCAGAC.TCTCATCGG	TAGTCAGAC.TCTCATCGG
TAGTCGCAT.CGTGCCTAT	TAGTCGCAT.CGTGCCTAT
TAGTCGCAT.GCGATGGTG	TAGTCGCAT.GCGATGGTG
TAGTCGCAT.GTATGCCTT	TAGTCGCAT.GTATGCCTT
TAGTCGCAT.TCAGTGTTC	TAGTCGCAT.TCAGTGTTC
TAGTGATCC.ATTAGCCAC	TAGTGATCC.ATTAGCCAC
TAGTGATCC.GCTGTTCGG	TAGTGATCC.GCTGTTCGG
TAGTGATCC.TCGGACAGT	TAGTGATCC.TCGGACAGT
TAGTGATCC.TGCGCACTG	TAGTGATCC.TGCGCACTG
TAGTGCACT.CGCTTGTAG	TAGTGCACT.CGCTTGTAG
TAGTGCACT.CGTGCAAGG	TAGTGCACT.CGTGCAAGG
TAGTGCACT.CTTGGATCA	TAGTGCACT.CTTGGATCA
TAGTTGACG.TACAACACC	TAGTTGACG.TACAACACC
TATAATCGC.AATGTGCGT	TATAATCGC.AATGTGCGT
TATAATCGC.ATGGAGAGT	TATAATCGC.ATGGAGAGT
TATACCACT.CAGCGTAAG	TATACCACT.CAGCGTAAG
TATACCACT.TCGCTTAAC	TATACCACT.TCGCTTAAC
TATACGGAT.AAGCAGCAT	TATACGGAT.AAGCAGCAT
TATACGGAT.TCGTACCTT	TATACGGAT.TCGTACCTT
TATACGTGG.ACCGGAGTA	TATACGTGG.ACCGGAGTA
TATACGTGG.CACGGATAG	TATACGTGG.CACGGATAG
TATAGTGCG.CGCACTCTT	TATAGTGCG.CGCACTCTT
TATCACCTG.AGTTATCGC	TATCACCTG.AGTTATCGC
TATCACCTG.ATCCTCCGA	TATCACCTG.ATCCTCCGA
TATCACCTG.CCACCATGC	TATCACCTG.CCACCATGC
TATCACCTG.GGTAACTAC	TATCACCTG.GGTAACTAC
TATCAGTGC.AATGCTATC	TATCAGTGC.AATGCTATC
TATCAGTGC.TCGCGTCAT	TATCAGTGC.TCGCGTCAT
TATCAGTGC.TCGCTTAAC	TATCAGTGC.TCGCTTAAC
TATCATGCT.ACAGAGATG	TATCATGCT.ACAGAGATG
TATCATGCT.GCCGCCTAA	TATCATGCT.GCCGCCTAA
TATCCTCAG.CAATACCAC	TATCCTCAG.CAATACCAC
TATCCTCAG.CCGCTCATG	TATCCTCAG.CCGCTCATG
TATCCTCAG.CTCTGCAAG	TATCCTCAG.CTCTGCAAG
TATCGAGCC.ATGTGACGA	TATCGAGCC.ATGTGACGA
TATCGAGCC.CCGCATCCT	TATCGAGCC.CCGCATCCT
TATCGAGCC.CTAACACTG	TATCGAGCC.CTAACACTG
TATCGAGCC.TGCCATCTC	TATCGAGCC.TGCCATCTC
TATCGGAAC.AACGTTCTT	TATCGGAAC.AACGTTCTT
TATCGGAAC.AATATCAGC	TATCGGAAC.AATATCAGC
TATCGGAAC.ACATGGATT	TATCGGAAC.ACATGGATT
TATCGGAAC.CGACCTGTA	TATCGGAAC.CGACCTGTA
TATCGGAAC.GTTATCGAT	TATCGGAAC.GTTATCGAT
TATCGGAAC.TCACTACGT	TATCGGAAC.TCACTACGT
TATCTAGGT.ATCCGTCTC	TATCTAGGT.ATCCGTCTC
TATCTAGGT.CTCTTCAGC	TATCTAGGT.CTCTTCAGC
TATCTAGGT.GCTACAATG	TATCTAGGT.GCTACAATG
TATCTGTCA.AATGCGTGC	TATCTGTCA.AATGCGTGC
TATCTGTCA.ACTCTCACA	TATCTGTCA.ACTCTCACA
TATCTGTCA.ATATGCAGC	TATCTGTCA.ATATGCAGC
TATCTGTCA.CTAACCGGT	TATCTGTCA.CTAACCGGT
TATCTGTCA.CTGCTGCTT	TATCTGTCA.CTGCTGCTT
TATCTGTCA.CTGGACTAA	TATCTGTCA.CTGGACTAA
TATCTGTCA.TCCAAGTAA	TATCTGTCA.TCCAAGTAA
TATCTGTCA.TGCGTAATC	TATCTGTCA.TGCGTAATC
TATGAAGAC.ACCGTCACG	TATGAAGAC.ACCGTCACG
TATGACCGA.ACCTAGTTA	TATGACCGA.ACCTAGTTA
TATGACCGA.CCGCTCATG	TATGACCGA.CCGCTCATG
TATGACCGA.GCGACCTGT	TATGACCGA.GCGACCTGT
TATGACCGA.TAGCGCAGC	TATGACCGA.TAGCGCAGC
TATGAGACC.GTAGTTGGT	TATGAGACC.GTAGTTGGT
TATGAGACC.GTTGACGTG	TATGAGACC.GTTGACGTG
TATGAGACC.TAATGTAGC	TATGAGACC.TAATGTAGC
TATGAGACC.TTGCCGTAG	TATGAGACC.TTGCCGTAG
TATGATGTG.AAGTTCTCT	TATGATGTG.AAGTTCTCT
TATGATGTG.ACTTGATCT	TATGATGTG.ACTTGATCT
TATGATGTG.CTCATGCCA	TATGATGTG.CTCATGCCA
TATGATGTG.TGACTGAGA	TATGATGTG.TGACTGAGA
TATGCCTTC.ACTCCGTCG	TATGCCTTC.ACTCCGTCG
TATGCCTTC.CACTAGACT	TATGCCTTC.CACTAGACT
TATGCCTTC.TAACACGAG	TATGCCTTC.TAACACGAG
TATGCCTTC.TCGCCAAGC	TATGCCTTC.TCGCCAAGC
TATGGTTGG.AACGGTAGC	TATGGTTGG.AACGGTAGC
TATGGTTGG.AATAACTCC	TATGGTTGG.AATAACTCC
TATGGTTGG.ACCGAGACA	TATGGTTGG.ACCGAGACA
TATGGTTGG.CTGGACACT	TATGGTTGG.CTGGACACT
TATGGTTGG.GCCATCGCT	TATGGTTGG.GCCATCGCT
TATGGTTGG.GTCAACTGA	TATGGTTGG.GTCAACTGA
TATGGTTGG.TTCGGAGTC	TATGGTTGG.TTCGGAGTC
TATGTACCT.AACGTTCTT	TATGTACCT.AACGTTCTT
TATGTACCT.AATTAGAGG	TATGTACCT.AATTAGAGG
TATGTACCT.ACACACGTC	TATGTACCT.ACACACGTC
TATGTACCT.ACCATACTT	TATGTACCT.ACCATACTT
TATGTACCT.AGTAAGCCA	TATGTACCT.AGTAAGCCA
TATGTACCT.CACTTCCTT	TATGTACCT.CACTTCCTT
TATGTACCT.CTGTCTAGT	TATGTACCT.CTGTCTAGT
TATGTATGC.GTTGCATGG	TATGTATGC.GTTGCATGG
TATTACAGC.ACAGGAACT	TATTACAGC.ACAGGAACT
TATTACAGC.ATAATCGAG	TATTACAGC.ATAATCGAG
TATTACAGC.ATGCGGATT	TATTACAGC.ATGCGGATT
TATTACAGC.CAGTCCTAA	TATTACAGC.CAGTCCTAA
TATTACAGC.CCTGCTCCA	TATTACAGC.CCTGCTCCA
TATTACAGC.CGTGCTTGA	TATTACAGC.CGTGCTTGA
TATTACAGC.CTCGTTCAC	TATTACAGC.CTCGTTCAC
TATTACAGC.GTCCGTAAG	TATTACAGC.GTCCGTAAG
TATTACAGC.TACTTCCAG	TATTACAGC.TACTTCCAG
TATTACAGC.TGAAGACCA	TATTACAGC.TGAAGACCA
TATTACAGC.TGAGCAGAT	TATTACAGC.TGAGCAGAT
TATTACTCG.ATACCGCTT	TATTACTCG.ATACCGCTT
TATTACTCG.CGACGTGAT	TATTACTCG.CGACGTGAT
TATTACTCG.GAACGCTGT	TATTACTCG.GAACGCTGT
TATTACTCG.GCACGCATT	TATTACTCG.GCACGCATT
TATTACTCG.GTGTTGGAA	TATTACTCG.GTGTTGGAA
TATTACTCG.TCGCTGTAA	TATTACTCG.TCGCTGTAA
TATTCAACG.CAGTATGAT	TATTCAACG.CAGTATGAT
TATTCAACG.GACCTTGTG	TATTCAACG.GACCTTGTG
TATTGACTG.CCGTCCACT	TATTGACTG.CCGTCCACT
TATTGACTG.CTTCTCATC	TATTGACTG.CTTCTCATC
TATTGACTG.GCACATGTT	TATTGACTG.GCACATGTT
TATTGACTG.GCGCTTCTC	TATTGACTG.GCGCTTCTC
TATTGACTG.TCGATTCAG	TATTGACTG.TCGATTCAG
TCAACACTC.AAGGTCTGA	TCAACACTC.AAGGTCTGA
TCAACACTC.ATGAACTAG	TCAACACTC.ATGAACTAG
TCAACACTC.GGTTCTATC	TCAACACTC.GGTTCTATC
TCAACACTC.GTATGTATC	TCAACACTC.GTATGTATC
TCAAGCGTA.CACTGGTCC	TCAAGCGTA.CACTGGTCC
TCAAGCGTA.TATGATGTG	TCAAGCGTA.TATGATGTG
TCAAGGAGT.CAAGCTGCA	TCAAGGAGT.CAAGCTGCA
TCAAGGAGT.CTCAGTGAT	TCAAGGAGT.CTCAGTGAT
TCAAGGAGT.GTGTCCGTG	TCAAGGAGT.GTGTCCGTG
TCAAGGAGT.TATCACCTG	TCAAGGAGT.TATCACCTG
TCAAGGTCG.CAACACTCC	TCAAGGTCG.CAACACTCC
TCAAGGTCG.CCTTGTTGC	TCAAGGTCG.CCTTGTTGC
TCAAGGTCG.CGACGTACG	TCAAGGTCG.CGACGTACG
TCAAGGTCG.CTTCTGAGT	TCAAGGTCG.CTTCTGAGT
TCAAGGTCG.CTTGCGACC	TCAAGGTCG.CTTGCGACC
TCAATCTAG.CTGGTCGGT	TCAATCTAG.CTGGTCGGT
TCAATCTAG.GGTAAGGAT	TCAATCTAG.GGTAAGGAT
TCAATCTAG.TGATTCACC	TCAATCTAG.TGATTCACC
TCAATCTAG.TTCCAGGAG	TCAATCTAG.TTCCAGGAG
TCAATGGAC.AAGTAGGAC	TCAATGGAC.AAGTAGGAC
TCAATGGAC.CCTAGTCTC	TCAATGGAC.CCTAGTCTC
TCAATGGAC.CTAATACGC	TCAATGGAC.CTAATACGC
TCAATGGAC.CTCATTAGT	TCAATGGAC.CTCATTAGT
TCAATGGAC.TAGCGCAGC	TCAATGGAC.TAGCGCAGC
TCAATGGAC.TGAACGGTT	TCAATGGAC.TGAACGGTT
TCACACTGC.ATACGAGGT	TCACACTGC.ATACGAGGT
TCACACTGC.GGAGCATCT	TCACACTGC.GGAGCATCT
TCACACTGC.TGACGGTTG	TCACACTGC.TGACGGTTG
TCACATACT.AACGCCTAC	TCACATACT.AACGCCTAC
TCACATACT.ATGCCTGTC	TCACATACT.ATGCCTGTC
TCACATACT.CGGAATGCA	TCACATACT.CGGAATGCA
TCACATACT.CGGAGACTT	TCACATACT.CGGAGACTT
TCACCGAGG.CCACGGATC	TCACCGAGG.CCACGGATC
TCACCGAGG.TTGATGAGT	TCACCGAGG.TTGATGAGT
TCACGACAA.AAGCACAAC	TCACGACAA.AAGCACAAC
TCACGACAA.GAGACGATC	TCACGACAA.GAGACGATC
TCACGACAA.GGAAGAAGC	TCACGACAA.GGAAGAAGC
TCACGACAA.TGGTCCTAG	TCACGACAA.TGGTCCTAG
TCACGCGAC.AAGCTGAGG	TCACGCGAC.AAGCTGAGG
TCACGCGAC.CGTTACACC	TCACGCGAC.CGTTACACC
TCACGCGAC.CTATTAAGG	TCACGCGAC.CTATTAAGG
TCACGCGAC.GCCAACAAT	TCACGCGAC.GCCAACAAT
TCACTACGT.ATGCGCTAC	TCACTACGT.ATGCGCTAC
TCACTCGCT.ACCACGCTA	TCACTCGCT.ACCACGCTA
TCACTCGCT.CACACCACA	TCACTCGCT.CACACCACA
TCACTCGCT.CTTGCACAA	TCACTCGCT.CTTGCACAA
TCACTCGCT.GACGTCAAT	TCACTCGCT.GACGTCAAT
TCACTCGCT.GCGACAACC	TCACTCGCT.GCGACAACC
TCACTCGCT.TGCCGCTAC	TCACTCGCT.TGCCGCTAC
TCACTCGCT.TTGCCAGAT	TCACTCGCT.TTGCCAGAT
TCAGACAAG.AAGGAAGTC	TCAGACAAG.AAGGAAGTC
TCAGACAAG.ATCTTACAG	TCAGACAAG.ATCTTACAG
TCAGACAAG.CATAGGTGT	TCAGACAAG.CATAGGTGT
TCAGACAAG.CTAGAGGTA	TCAGACAAG.CTAGAGGTA
TCAGACAAG.TAATTCGTG	TCAGACAAG.TAATTCGTG
TCAGACAAG.TCAGGACTG	TCAGACAAG.TCAGGACTG
TCAGACAAG.TGCAACTCT	TCAGACAAG.TGCAACTCT
TCAGAGCGT.AGTAATCAG	TCAGAGCGT.AGTAATCAG
TCAGAGCGT.ATCCAATGA	TCAGAGCGT.ATCCAATGA
TCAGAGCGT.ATCTAGGTT	TCAGAGCGT.ATCTAGGTT
TCAGAGCGT.ATCTGGTAG	TCAGAGCGT.ATCTGGTAG
TCAGAGCGT.CCGATGTTC	TCAGAGCGT.CCGATGTTC
TCAGAGCGT.CGCCTGCAA	TCAGAGCGT.CGCCTGCAA
TCAGAGCGT.GGATACCTA	TCAGAGCGT.GGATACCTA
TCAGAGCGT.TCCAGCTAT	TCAGAGCGT.TCCAGCTAT
TCAGAGTCA.AATGCTATC	TCAGAGTCA.AATGCTATC
TCAGAGTCA.AGTTGCCTT	TCAGAGTCA.AGTTGCCTT
TCAGAGTCA.CAGCTTACC	TCAGAGTCA.CAGCTTACC
TCAGAGTCA.CAGTCCTAA	TCAGAGTCA.CAGTCCTAA
TCAGAGTCA.GCGAAGCTC	TCAGAGTCA.GCGAAGCTC
TCAGAGTCA.GGAAGGTAT	TCAGAGTCA.GGAAGGTAT
TCAGAGTCA.TATACGTGG	TCAGAGTCA.TATACGTGG
TCAGAGTCA.TATAGTGCG	TCAGAGTCA.TATAGTGCG
TCAGCGACC.ACGGTGTAC	TCAGCGACC.ACGGTGTAC
TCAGCGACC.AGCCAGGAC	TCAGCGACC.AGCCAGGAC
TCAGCGACC.AGGTCCGTC	TCAGCGACC.AGGTCCGTC
TCAGCGACC.ATATCCGAT	TCAGCGACC.ATATCCGAT
TCAGCGACC.CACAACGCT	TCAGCGACC.CACAACGCT
TCAGCTCAG.CCGCACTCA	TCAGCTCAG.CCGCACTCA
TCAGCTCAG.GCGAGCAAG	TCAGCTCAG.GCGAGCAAG
TCAGGACTG.AATCCTCGT	TCAGGACTG.AATCCTCGT
TCAGGACTG.ACCGGTTAC	TCAGGACTG.ACCGGTTAC
TCAGGACTG.CAACTAATC	TCAGGACTG.CAACTAATC
TCAGGACTG.GCAACTCGC	TCAGGACTG.GCAACTCGC
TCAGGACTG.TTGTTAGAG	TCAGGACTG.TTGTTAGAG
TCAGGTGCA.CCTGTCATT	TCAGGTGCA.CCTGTCATT
TCAGGTGCA.CGTGACCAG	TCAGGTGCA.CGTGACCAG
TCAGTAAGC.AAGGATCGT	TCAGTAAGC.AAGGATCGT
TCAGTAAGC.TAGTGCACT	TCAGTAAGC.TAGTGCACT
TCAGTAAGC.TGATACCGT	TCAGTAAGC.TGATACCGT
TCAGTGCAA.AGCATTGTT	TCAGTGCAA.AGCATTGTT
TCAGTGCAA.GTCCTAGTT	TCAGTGCAA.GTCCTAGTT
TCAGTGTTC.AACTGCGAC	TCAGTGTTC.AACTGCGAC
TCAGTGTTC.CCTTAATTC	TCAGTGTTC.CCTTAATTC
TCAGTGTTC.GGTTAGATG	TCAGTGTTC.GGTTAGATG
TCATATCGC.AATCGTGTT	TCATATCGC.AATCGTGTT
TCATATCGC.GAATTCAGT	TCATATCGC.GAATTCAGT
TCATATCGC.TGTATGTAG	TCATATCGC.TGTATGTAG
TCATCAGAG.ACGTGTAGT	TCATCAGAG.ACGTGTAGT
TCATCAGAG.AGATGAAGA	TCATCAGAG.AGATGAAGA
TCATCAGAG.CTAATACGC	TCATCAGAG.CTAATACGC
TCATCAGAG.GGAAGTATG	TCATCAGAG.GGAAGTATG
TCATCAGAG.GTGTTGGAA	TCATCAGAG.GTGTTGGAA
TCATCATCT.AACTTCTGC	TCATCATCT.AACTTCTGC
TCATCATCT.ACAAGAATG	TCATCATCT.ACAAGAATG
TCATCATCT.ACGCAAGAT	TCATCATCT.ACGCAAGAT
TCATCATCT.GAACCTTCA	TCATCATCT.GAACCTTCA
TCATCATCT.GCCTTAGAG	TCATCATCT.GCCTTAGAG
TCATCATCT.TAAGTGTAG	TCATCATCT.TAAGTGTAG
TCATCTGTC.CCGGTTGAG	TCATCTGTC.CCGGTTGAG
TCATCTGTC.CCTAAGAAG	TCATCTGTC.CCTAAGAAG
TCATCTGTC.GCCATCGCT	TCATCTGTC.GCCATCGCT
TCATCTGTC.TCAGGTGCA	TCATCTGTC.TCAGGTGCA
TCATCTGTC.TGCCAATGG	TCATCTGTC.TGCCAATGG
TCATGCTCA.ACGCACACT	TCATGCTCA.ACGCACACT
TCATGCTCA.CACTGTATC	TCATGCTCA.CACTGTATC
TCATGCTCA.TACTCGACC	TCATGCTCA.TACTCGACC
TCCAACGTG.CTCTTCAGC	TCCAACGTG.CTCTTCAGC
TCCAAGTAA.CACGTCATA	TCCAAGTAA.CACGTCATA
TCCAAGTAA.CTCTACGCA	TCCAAGTAA.CTCTACGCA
TCCAAGTAA.GAAGAGCAC	TCCAAGTAA.GAAGAGCAC
TCCAAGTAA.GGTGTTCAT	TCCAAGTAA.GGTGTTCAT
TCCAAGTAA.TCCTCGTCG	TCCAAGTAA.TCCTCGTCG
TCCAATCAT.ACGAGAGCA	TCCAATCAT.ACGAGAGCA
TCCAATCAT.CTACGAGAA	TCCAATCAT.CTACGAGAA
TCCAATCAT.TACCGCGTT	TCCAATCAT.TACCGCGTT
TCCAATCAT.TGCGCACTG	TCCAATCAT.TGCGCACTG
TCCAATCAT.TTCCAGATT	TCCAATCAT.TTCCAGATT
TCCACCGGT.ATACGAGGT	TCCACCGGT.ATACGAGGT
TCCACCGGT.CCAGCCAAT	TCCACCGGT.CCAGCCAAT
TCCACCGGT.GCCATCGCT	TCCACCGGT.GCCATCGCT
TCCACCGGT.TTACTAGTC	TCCACCGGT.TTACTAGTC
TCCACCGGT.TTGCTCTGC	TCCACCGGT.TTGCTCTGC
TCCACCTCA.CACACTGCC	TCCACCTCA.CACACTGCC
TCCACCTCA.CGGAATGCA	TCCACCTCA.CGGAATGCA
TCCACCTCA.CGTTGATCC	TCCACCTCA.CGTTGATCC
TCCACGTGC.ACACGTTGC	TCCACGTGC.ACACGTTGC
TCCACGTGC.AGTGAACGG	TCCACGTGC.AGTGAACGG
TCCACGTGC.GGAAGTATG	TCCACGTGC.GGAAGTATG
TCCAGAACG.AGACATATC	TCCAGAACG.AGACATATC
TCCAGAACG.AGTCGTCCG	TCCAGAACG.AGTCGTCCG
TCCAGAACG.ATCTCGAAC	TCCAGAACG.ATCTCGAAC
TCCAGAACG.TGCAGCCTT	TCCAGAACG.TGCAGCCTT
TCCAGCAGC.AAGGATCGT	TCCAGCAGC.AAGGATCGT
TCCAGCAGC.ACAGGAACT	TCCAGCAGC.ACAGGAACT
TCCAGCAGC.ACCGAGTAG	TCCAGCAGC.ACCGAGTAG
TCCAGCAGC.ATGAGGTAT	TCCAGCAGC.ATGAGGTAT
TCCAGCAGC.CAAGCGCAT	TCCAGCAGC.CAAGCGCAT
TCCAGCAGC.GCAACTCGC	TCCAGCAGC.GCAACTCGC
TCCAGCAGC.GGTGAGTTC	TCCAGCAGC.GGTGAGTTC
TCCAGCAGC.TCGTACCTT	TCCAGCAGC.TCGTACCTT
TCCAGCAGC.TGAGTTAAG	TCCAGCAGC.TGAGTTAAG
TCCAGCAGC.TTGAGCTCT	TCCAGCAGC.TTGAGCTCT
TCCAGCTAT.AGGAATTGG	TCCAGCTAT.AGGAATTGG
TCCAGCTAT.CCATAAGTA	TCCAGCTAT.CCATAAGTA
TCCAGCTAT.GGTGAGCGT	TCCAGCTAT.GGTGAGCGT
TCCAGCTAT.TATTGACTG	TCCAGCTAT.TATTGACTG
TCCATCATT.ATCCAATGA	TCCATCATT.ATCCAATGA
TCCGATAAC.ATAAGTTCG	TCCGATAAC.ATAAGTTCG
TCCGATAAC.ATAGTCAGT	TCCGATAAC.ATAGTCAGT
TCCGATAAC.CATGCCAGT	TCCGATAAC.CATGCCAGT
TCCGATAAC.GAATTGTTG	TCCGATAAC.GAATTGTTG
TCCGATAAC.GCAATGAGA	TCCGATAAC.GCAATGAGA
TCCGATAAC.TACTCGACC	TCCGATAAC.TACTCGACC
TCCGATAAC.TCTATGACA	TCCGATAAC.TCTATGACA
TCCGATCTG.TCGTCCGAT	TCCGATCTG.TCGTCCGAT
TCCGGAGCT.CGCAGTGTC	TCCGGAGCT.CGCAGTGTC
TCCGGAGCT.TATGTACCT	TCCGGAGCT.TATGTACCT
TCCGGAGCT.TCTTAGCGA	TCCGGAGCT.TCTTAGCGA
TCCGGAGCT.TTCCAATTC	TCCGGAGCT.TTCCAATTC
TCCGTATAC.ACTCGCTGT	TCCGTATAC.ACTCGCTGT
TCCGTATAC.TGTCTACAC	TCCGTATAC.TGTCTACAC
TCCTCGTCG.AGTGTCTCT	TCCTCGTCG.AGTGTCTCT
TCCTCGTCG.CACATATCA	TCCTCGTCG.CACATATCA
TCCTCGTCG.CATGCCAGT	TCCTCGTCG.CATGCCAGT
TCCTCGTCG.CCGTCAGGT	TCCTCGTCG.CCGTCAGGT
TCCTCGTCG.GTTGACCAT	TCCTCGTCG.GTTGACCAT
TCCTCTAGT.ACGAGAGCA	TCCTCTAGT.ACGAGAGCA
TCCTCTAGT.AGCACCGTG	TCCTCTAGT.AGCACCGTG
TCCTCTAGT.AGCTTCGAT	TCCTCTAGT.AGCTTCGAT
TCCTCTAGT.TCAGTGCAA	TCCTCTAGT.TCAGTGCAA
TCCTGAGAC.GCAGGAGAA	TCCTGAGAC.GCAGGAGAA
TCCTGAGAC.TGCCATCTC	TCCTGAGAC.TGCCATCTC
TCCTGTCCG.AGAGGTGAA	TCCTGTCCG.AGAGGTGAA
TCCTGTCCG.AGCCACTTC	TCCTGTCCG.AGCCACTTC
TCCTGTCCG.ATATTCGCA	TCCTGTCCG.ATATTCGCA
TCCTGTCCG.ATTCATGTG	TCCTGTCCG.ATTCATGTG
TCCTGTCCG.TATCGAGCC	TCCTGTCCG.TATCGAGCC
TCCTGTCCG.TTACTAGTC	TCCTGTCCG.TTACTAGTC
TCCTGTGGA.AGCGGTCTA	TCCTGTGGA.AGCGGTCTA
TCCTGTGGA.CCTCGAGAG	TCCTGTGGA.CCTCGAGAG
TCCTGTGGA.TCAGTGTTC	TCCTGTGGA.TCAGTGTTC
TCCTGTGGA.TGTAACAGT	TCCTGTGGA.TGTAACAGT
TCCTTAGGT.GGAAGGTAT	TCCTTAGGT.GGAAGGTAT
TCCTTAGGT.GTGCGAGTA	TCCTTAGGT.GTGCGAGTA
TCCTTCAAC.ACTGTGTCA	TCCTTCAAC.ACTGTGTCA
TCCTTCAAC.ATCTCGTGA	TCCTTCAAC.ATCTCGTGA
TCCTTCAAC.GATAAGCTG	TCCTTCAAC.GATAAGCTG
TCCTTCGTA.CTTGATCTA	TCCTTCGTA.CTTGATCTA
TCCTTCGTA.GGTGAGCGT	TCCTTCGTA.GGTGAGCGT
TCCTTCGTA.TCCGATAAC	TCCTTCGTA.TCCGATAAC
TCCTTCGTA.TCTGCAACA	TCCTTCGTA.TCTGCAACA
TCCTTCGTA.TGAGTGACT	TCCTTCGTA.TGAGTGACT
TCCTTCGTA.TGTCAACCT	TCCTTCGTA.TGTCAACCT
TCGAACGCT.ACACTGTGA	TCGAACGCT.ACACTGTGA
TCGAACGCT.CTTGCGACC	TCGAACGCT.CTTGCGACC
TCGAACGCT.GTGCTGACT	TCGAACGCT.GTGCTGACT
TCGAACGCT.TCAGTGTTC	TCGAACGCT.TCAGTGTTC
TCGAACGCT.TTGAGCTCT	TCGAACGCT.TTGAGCTCT
TCGAATAGA.AAGACGAAG	TCGAATAGA.AAGACGAAG
TCGAATAGA.TGATTGCTG	TCGAATAGA.TGATTGCTG
TCGACGTTG.ACAACGAGC	TCGACGTTG.ACAACGAGC
TCGACGTTG.ACGAGAGCA	TCGACGTTG.ACGAGAGCA
TCGATTCAG.ACCATGTCT	TCGATTCAG.ACCATGTCT
TCGATTCAG.ATGCAGTTC	TCGATTCAG.ATGCAGTTC
TCGATTCAG.TCGGACAGT	TCGATTCAG.TCGGACAGT
TCGATTCAG.TGATCGGAA	TCGATTCAG.TGATCGGAA
TCGCAAGCA.CTCCGCATT	TCGCAAGCA.CTCCGCATT
TCGCAAGCA.GGTAGCATC	TCGCAAGCA.GGTAGCATC
TCGCATTCG.AACCATGGT	TCGCATTCG.AACCATGGT
TCGCATTCG.AGATGAAGA	TCGCATTCG.AGATGAAGA
TCGCATTCG.CATATGTCG	TCGCATTCG.CATATGTCG
TCGCATTCG.CGTACACAC	TCGCATTCG.CGTACACAC
TCGCATTCG.GTAGAGAGC	TCGCATTCG.GTAGAGAGC
TCGCCAAGC.TAGACCGCA	TCGCCAAGC.TAGACCGCA
TCGCGTCAT.CAGTCGGTA	TCGCGTCAT.CAGTCGGTA
TCGCGTCAT.CCAATATAC	TCGCGTCAT.CCAATATAC
TCGCGTCAT.TGAGATCAT	TCGCGTCAT.TGAGATCAT
TCGCGTCAT.TGCGACGTT	TCGCGTCAT.TGCGACGTT
TCGCGTCAT.TGGACGAGA	TCGCGTCAT.TGGACGAGA
TCGCTGATT.CATCCTCTC	TCGCTGATT.CATCCTCTC
TCGCTGATT.GCAGCTTGA	TCGCTGATT.GCAGCTTGA
TCGCTTAAC.AGTCCGTGT	TCGCTTAAC.AGTCCGTGT
TCGCTTAAC.CAGATCATT	TCGCTTAAC.CAGATCATT
TCGCTTAAC.CAGGTATCG	TCGCTTAAC.CAGGTATCG
TCGCTTAAC.CATAAGATC	TCGCTTAAC.CATAAGATC
TCGCTTAAC.CCTTGTTGC	TCGCTTAAC.CCTTGTTGC
TCGCTTAAC.GACGCCGTA	TCGCTTAAC.GACGCCGTA
TCGGAACGA.CATAAGATC	TCGGAACGA.CATAAGATC
TCGGAACGA.CTCGCTACG	TCGGAACGA.CTCGCTACG
TCGGACAGT.AACTGATTC	TCGGACAGT.AACTGATTC
TCGGACAGT.ATCTGGTAG	TCGGACAGT.ATCTGGTAG
TCGGATGTT.CCGCATCCT	TCGGATGTT.CCGCATCCT
TCGGATGTT.GGATGCGAA	TCGGATGTT.GGATGCGAA
TCGGTATCA.ACTCGTAGG	TCGGTATCA.ACTCGTAGG
TCGGTATCA.ATTCTCTGG	TCGGTATCA.ATTCTCTGG
TCGTAATAG.ACTACTCAT	TCGTAATAG.ACTACTCAT
TCGTAATAG.ATGAGGTAT	TCGTAATAG.ATGAGGTAT
TCGTAATAG.CCTAGTTAG	TCGTAATAG.CCTAGTTAG
TCGTAATAG.TAGGATTAG	TCGTAATAG.TAGGATTAG
TCGTAATAG.TGTGGACAA	TCGTAATAG.TGTGGACAA
TCGTACCTT.ACCGGAAGG	TCGTACCTT.ACCGGAAGG
TCGTACCTT.GTGTACCGT	TCGTACCTT.GTGTACCGT
TCGTAGGAA.ACGTAGTAT	TCGTAGGAA.ACGTAGTAT
TCGTAGGAA.ACGTTCAAT	TCGTAGGAA.ACGTTCAAT
TCGTAGGAA.AGGATGCGT	TCGTAGGAA.AGGATGCGT
TCGTAGGAA.CGTTGATCC	TCGTAGGAA.CGTTGATCC
TCGTAGGAA.GGTAGTGTT	TCGTAGGAA.GGTAGTGTT
TCGTAGGAA.TATGAAGAC	TCGTAGGAA.TATGAAGAC
TCGTCATTC.CATGCCAGT	TCGTCATTC.CATGCCAGT
TCGTCCGAT.TGCTTACGG	TCGTCCGAT.TGCTTACGG
TCGTCCGAT.TGTCTACAC	TCGTCCGAT.TGTCTACAC
TCGTGACGT.AGAGCCGCA	TCGTGACGT.AGAGCCGCA
TCGTGACGT.CAGCTAGTT	TCGTGACGT.CAGCTAGTT
TCGTGACGT.GAGATGTAT	TCGTGACGT.GAGATGTAT
TCGTGACGT.GTATTACTG	TCGTGACGT.GTATTACTG
TCGTGACGT.TATCGAGCC	TCGTGACGT.TATCGAGCC
TCGTGACGT.TTAACGGAG	TCGTGACGT.TTAACGGAG
TCGTGCCAC.TCTGTGAAG	TCGTGCCAC.TCTGTGAAG
TCGTTCTCC.TTAAGTGGT	TCGTTCTCC.TTAAGTGGT
TCTAATACC.ACAACGAGC	TCTAATACC.ACAACGAGC
TCTAATACC.ACGACGATT	TCTAATACC.ACGACGATT
TCTAATACC.CAGCACGTG	TCTAATACC.CAGCACGTG
TCTAATACC.CTGCGATTC	TCTAATACC.CTGCGATTC
TCTAATACC.GCCGTCTTC	TCTAATACC.GCCGTCTTC
TCTAATACC.TATACGGAT	TCTAATACC.TATACGGAT
TCTACAGTT.ATTGATTGG	TCTACAGTT.ATTGATTGG
TCTACATCC.AACGGTAGC	TCTACATCC.AACGGTAGC
TCTACATCC.GCCATACAA	TCTACATCC.GCCATACAA
TCTACATCC.GGAGACACA	TCTACATCC.GGAGACACA
TCTACATCC.TGCAGCCTT	TCTACATCC.TGCAGCCTT
TCTACATCC.TGCGATACT	TCTACATCC.TGCGATACT
TCTACGCAA.ACCTTGAAG	TCTACGCAA.ACCTTGAAG
TCTACGCAA.CGACCATCA	TCTACGCAA.CGACCATCA
TCTAGCTGG.CCGAAGCGT	TCTAGCTGG.CCGAAGCGT
TCTAGCTGG.CTCTGCGGT	TCTAGCTGG.CTCTGCGGT
TCTAGGATG.ACTCCAACT	TCTAGGATG.ACTCCAACT
TCTAGGATG.CTCTGCGGT	TCTAGGATG.CTCTGCGGT
TCTAGTGAC.ACAGCGTAT	TCTAGTGAC.ACAGCGTAT
TCTAGTGAC.ACGTAGTAT	TCTAGTGAC.ACGTAGTAT
TCTAGTGAC.GTACGTCTA	TCTAGTGAC.GTACGTCTA
TCTAGTGAC.GTGGTACGG	TCTAGTGAC.GTGGTACGG
TCTAGTGAC.GTTATCGAT	TCTAGTGAC.GTTATCGAT
TCTAGTGAC.TCTTAAGTG	TCTAGTGAC.TCTTAAGTG
TCTATGACA.ACTCCAACT	TCTATGACA.ACTCCAACT
TCTATGACA.CTTCTCATC	TCTATGACA.CTTCTCATC
TCTATGACA.GAGATTCCT	TCTATGACA.GAGATTCCT
TCTATTAGG.AGAGAGTGG	TCTATTAGG.AGAGAGTGG
TCTATTAGG.CAGCTTACC	TCTATTAGG.CAGCTTACC
TCTATTAGG.CCGGATTGC	TCTATTAGG.CCGGATTGC
TCTATTAGG.CTATAGCTC	TCTATTAGG.CTATAGCTC
TCTATTAGG.GGTCGGTCT	TCTATTAGG.GGTCGGTCT
TCTATTAGG.TGACTGAGA	TCTATTAGG.TGACTGAGA
TCTCAGGAT.GTGCACGAG	TCTCAGGAT.GTGCACGAG
TCTCAGGAT.TAGGAGGAT	TCTCAGGAT.TAGGAGGAT
TCTCATCGG.ATCGATCCT	TCTCATCGG.ATCGATCCT
TCTCATCGG.CGGTTCGTA	TCTCATCGG.CGGTTCGTA
TCTCATCGG.CTAGTTCCA	TCTCATCGG.CTAGTTCCA
TCTCATCGG.TAGACACGT	TCTCATCGG.TAGACACGT
TCTCCGCGT.AACAGATCG	TCTCCGCGT.AACAGATCG
TCTCCGCGT.CGGTTCTAT	TCTCCGCGT.CGGTTCTAT
TCTCCGCGT.GACGTTCAG	TCTCCGCGT.GACGTTCAG
TCTCCGCGT.TGGTGGATC	TCTCCGCGT.TGGTGGATC
TCTCGATGC.CAAGAGAGT	TCTCGATGC.CAAGAGAGT
TCTCGATGC.CTAGACATG	TCTCGATGC.CTAGACATG
TCTCGATGC.TGATACCGT	TCTCGATGC.TGATACCGT
TCTCGTATC.CCACGAAGG	TCTCGTATC.CCACGAAGG
TCTCGTATC.TAGCTGTTG	TCTCGTATC.TAGCTGTTG
TCTCGTATC.TGTGCAGTA	TCTCGTATC.TGTGCAGTA
