CCTGCAGAT.GACGCTTGC	CCTGCAGAT.GACGCTTGC
CCTGCAGAT.GCTGGTAAC	CCTGCAGAT.GCTGGTAAC
CCTGCAGAT.GGTGTGACC	CCTGCAGAT.GGTGTGACC
CCTGCAGAT.TATCATGCT	CCTGCAGAT.TATCATGCT
CCTGCGTTA.ACGCTATGT	CCTGCGTTA.ACGCTATGT
CCTGCGTTA.AGCATTGTT	CCTGCGTTA.AGCATTGTT
CCTGCGTTA.CACCTACGC	CCTGCGTTA.CACCTACGC
CCTGCGTTA.CACTTCCTT	CCTGCGTTA.CACTTCCTT
CCTGCTCCA.ACTATTGTC	CCTGCTCCA.ACTATTGTC
CCTGCTCCA.AGTACTCTC	CCTGCTCCA.AGTACTCTC
CCTGCTCCA.AGTTCAACC	CCTGCTCCA.AGTTCAACC
CCTGCTCCA.GGACAGATT	CCTGCTCCA.GGACAGATT
CCTGCTCCA.TCATCTGTC	CCTGCTCCA.TCATCTGTC
CCTGTATCT.AATACTCCG	CCTGTATCT.AATACTCCG
CCTGTATCT.ACCAGCGTT	CCTGTATCT.ACCAGCGTT
CCTGTATCT.CTCCACGTC	CCTGTATCT.CTCCACGTC
CCTGTATCT.GACGCCGTA	CCTGTATCT.GACGCCGTA
CCTGTATCT.GTGCTCTTG	CCTGTATCT.GTGCTCTTG
CCTGTCATT.ACGCAAGAT	CCTGTCATT.ACGCAAGAT
CCTGTCATT.GTAGCATAC	CCTGTCATT.GTAGCATAC
CCTGTCGAC.AGTGACGAT	CCTGTCGAC.AGTGACGAT
CCTGTCGAC.TTACGCTCG	CCTGTCGAC.TTACGCTCG
CCTGTTAGC.ACCGGAAGG	CCTGTTAGC.ACCGGAAGG
CCTGTTAGC.AGTACTACA	CCTGTTAGC.AGTACTACA
CCTGTTAGC.TCAGTGTTC	CCTGTTAGC.TCAGTGTTC
CCTTAATTC.TCGACGTTG	CCTTAATTC.TCGACGTTG
CCTTATCCG.ATTAGCACA	CCTTATCCG.ATTAGCACA
CCTTATCCG.CACCTTCCT	CCTTATCCG.CACCTTCCT
CCTTATCCG.GATACACTA	CCTTATCCG.GATACACTA
CCTTATCCG.GGAATTCAC	CCTTATCCG.GGAATTCAC
CCTTATCCG.TGATACCGT	CCTTATCCG.TGATACCGT
CCTTCCTCA.GACTTGATT	CCTTCCTCA.GACTTGATT
CCTTCCTCA.GGTAAGGAT	CCTTCCTCA.GGTAAGGAT
CCTTCCTCA.TCATATCGC	CCTTCCTCA.TCATATCGC
CCTTCGAGC.AAGCACAAC	CCTTCGAGC.AAGCACAAC
CCTTCGAGC.CCTTAACAT	CCTTCGAGC.CCTTAACAT
CCTTCGAGC.CTAGTTCCA	CCTTCGAGC.CTAGTTCCA
CCTTCGAGC.GTAATATCG	CCTTCGAGC.GTAATATCG
CCTTGACGG.TCATGCTCA	CCTTGACGG.TCATGCTCA
CCTTGACGG.TGCCGAACT	CCTTGACGG.TGCCGAACT
CCTTGACGG.TGGTCGCTA	CCTTGACGG.TGGTCGCTA
CCTTGACGG.TGTGGACAA	CCTTGACGG.TGTGGACAA
CCTTGCTTG.ACGTTCAAT	CCTTGCTTG.ACGTTCAAT
CCTTGCTTG.CGTCGTCAA	CCTTGCTTG.CGTCGTCAA
CCTTGCTTG.GCATTGATC	CCTTGCTTG.GCATTGATC
CCTTGCTTG.GTCACAGAG	CCTTGCTTG.GTCACAGAG
CCTTGTTGC.ACCATGTCT	CCTTGTTGC.ACCATGTCT
CCTTGTTGC.ACGTTCAAT	CCTTGTTGC.ACGTTCAAT
CCTTGTTGC.GCGAAGCTC	CCTTGTTGC.GCGAAGCTC
CCTTGTTGC.GCGGTAGTC	CCTTGTTGC.GCGGTAGTC
CGAACAATC.GCACCATCG	CGAACAATC.GCACCATCG
CGAACAATC.TGACCTCCT	CGAACAATC.TGACCTCCT
CGAACAATC.TTACGGACC	CGAACAATC.TTACGGACC
CGAACAGAG.ACAGGTATC	CGAACAGAG.ACAGGTATC
CGAACAGAG.ACGAGCTTC	CGAACAGAG.ACGAGCTTC
CGAACAGAG.GCAGCTTGA	CGAACAGAG.GCAGCTTGA
CGAAGAGGT.AAGCAATCG	CGAAGAGGT.AAGCAATCG
CGAAGAGGT.AATATCAGC	CGAAGAGGT.AATATCAGC
CGAAGAGGT.ACCTTGAAG	CGAAGAGGT.ACCTTGAAG
CGAAGAGGT.ATTGATCAC	CGAAGAGGT.ATTGATCAC
CGAAGAGGT.GTGCACGAG	CGAAGAGGT.GTGCACGAG
CGAAGAGGT.TAGCCAGTG	CGAAGAGGT.TAGCCAGTG
CGAATCCTG.ATTCTCTGG	CGAATCCTG.ATTCTCTGG
CGAATCCTG.CGACCATCA	CGAATCCTG.CGACCATCA
CGAATCCTG.GAGCCATCC	CGAATCCTG.GAGCCATCC
CGAATCCTG.TAGATCTGT	CGAATCCTG.TAGATCTGT
CGAATGAGT.AAGGATCGT	CGAATGAGT.AAGGATCGT
CGAATGAGT.CTGATCAAG	CGAATGAGT.CTGATCAAG
CGACAGACC.ATATCAGCC	CGACAGACC.ATATCAGCC
CGACAGACC.CAACTAATC	CGACAGACC.CAACTAATC
CGACAGACC.GTGATGTGC	CGACAGACC.GTGATGTGC
CGACAGACC.TCAAGCGTA	CGACAGACC.TCAAGCGTA
CGACAGGAA.AGCCAGGAC	CGACAGGAA.AGCCAGGAC
CGACAGGAA.CACACCACA	CGACAGGAA.CACACCACA
CGACAGGAA.CATTATGTC	CGACAGGAA.CATTATGTC
CGACAGGAA.GAGCAGGAA	CGACAGGAA.GAGCAGGAA
CGACAGGAA.GATCTGAAT	CGACAGGAA.GATCTGAAT
CGACAGGAA.GTCGTCGAC	CGACAGGAA.GTCGTCGAC
CGACAGGAA.TTGACCTGA	CGACAGGAA.TTGACCTGA
CGACCACTT.CTCAGCTGG	CGACCACTT.CTCAGCTGG
CGACCACTT.GTGACGTAA	CGACCACTT.GTGACGTAA
CGACCACTT.TAAGTACAC	CGACCACTT.TAAGTACAC
CGACCACTT.TGCCTTCAG	CGACCACTT.TGCCTTCAG
CGACCATCA.CTAGACATG	CGACCATCA.CTAGACATG
CGACCATCA.GCCGAACCA	CGACCATCA.GCCGAACCA
CGACCATCA.GTATGCCTT	CGACCATCA.GTATGCCTT
CGACCTAGC.ACTTCAGTA	CGACCTAGC.ACTTCAGTA
CGACCTAGC.CACTAGACT	CGACCTAGC.CACTAGACT
CGACCTAGC.TCTCATCGG	CGACCTAGC.TCTCATCGG
CGACCTGTA.ATGAACTAG	CGACCTGTA.ATGAACTAG
CGACCTGTA.CTCTAAGAG	CGACCTGTA.CTCTAAGAG
CGACCTGTA.TAGGTTAGT	CGACCTGTA.TAGGTTAGT
CGACCTGTA.TGCTCCTCC	CGACCTGTA.TGCTCCTCC
CGACGTGAT.ACCAGCGTT	CGACGTGAT.ACCAGCGTT
CGACGTGAT.ATGTCGCCT	CGACGTGAT.ATGTCGCCT
CGACGTGAT.CTGTTACCA	CGACGTGAT.CTGTTACCA
CGAGCCGTT.ACCATACTT	CGAGCCGTT.ACCATACTT
CGAGCCGTT.CATACAACC	CGAGCCGTT.CATACAACC
CGAGCCGTT.TGCTCACAC	CGAGCCGTT.TGCTCACAC
CGAGCCGTT.TTCACTCCT	CGAGCCGTT.TTCACTCCT
CGAGCTTAC.GGATCGTTC	CGAGCTTAC.GGATCGTTC
CGAGTAGCA.CACGACTCA	CGAGTAGCA.CACGACTCA
CGAGTAGCA.CGATTCGAG	CGAGTAGCA.CGATTCGAG
CGAGTAGCA.CTCAGTGAT	CGAGTAGCA.CTCAGTGAT
CGAGTAGCA.CTGGTGACA	CGAGTAGCA.CTGGTGACA
CGATACTCT.CGTCAGCAC	CGATACTCT.CGTCAGCAC
CGATACTCT.GATTCCTCT	CGATACTCT.GATTCCTCT
CGATAGGTG.GCAGCTTGA	CGATAGGTG.GCAGCTTGA
CGATAGGTG.GTTAATTCG	CGATAGGTG.GTTAATTCG
CGATAGGTG.TGGATTAGC	CGATAGGTG.TGGATTAGC
CGATCCAGA.AGCGGTCTA	CGATCCAGA.AGCGGTCTA
CGATCCAGA.ATACCGCTT	CGATCCAGA.ATACCGCTT
CGATCCAGA.ATCATAGAC	CGATCCAGA.ATCATAGAC
CGATTCGAG.AATCGCCAT	CGATTCGAG.AATCGCCAT
CGATTCGAG.TAGCAGAGT	CGATTCGAG.TAGCAGAGT
CGATTCGAG.TCGTACCTT	CGATTCGAG.TCGTACCTT
CGATTCGAG.TTGGACTTC	CGATTCGAG.TTGGACTTC
CGATTGAAC.CTGACGGAT	CGATTGAAC.CTGACGGAT
CGATTGAAC.CTTACCTAG	CGATTGAAC.CTTACCTAG
CGCAACCTC.ATGAGGTAT	CGCAACCTC.ATGAGGTAT
CGCAACCTC.ATGTCCTCC	CGCAACCTC.ATGTCCTCC
CGCAACCTC.TGGAAGATT	CGCAACCTC.TGGAAGATT
CGCAACCTC.TTGATGAGT	CGCAACCTC.TTGATGAGT
CGCAATCGA.AACTCCATG	CGCAATCGA.AACTCCATG
CGCAATCGA.CGTGAGACT	CGCAATCGA.CGTGAGACT
CGCACTCTT.CGCAACCTC	CGCACTCTT.CGCAACCTC
CGCACTCTT.GATGCGGTT	CGCACTCTT.GATGCGGTT
CGCACTGAA.AATCAGGAG	CGCACTGAA.AATCAGGAG
CGCACTGAA.ATTAGCACA	CGCACTGAA.ATTAGCACA
CGCACTGAA.CGCCATTAC	CGCACTGAA.CGCCATTAC
CGCACTGAA.TCCATCATT	CGCACTGAA.TCCATCATT
CGCAGTGTC.AATGTGCGT	CGCAGTGTC.AATGTGCGT
CGCAGTGTC.CGTGGTACC	CGCAGTGTC.CGTGGTACC
CGCAGTGTC.GAACATGAC	CGCAGTGTC.GAACATGAC
CGCAGTGTC.GGTAAGGAT	CGCAGTGTC.GGTAAGGAT
CGCAGTGTC.GGTGATAGG	CGCAGTGTC.GGTGATAGG
CGCAGTGTC.TCCGGAGCT	CGCAGTGTC.TCCGGAGCT
CGCATAACT.AATCCGCTG	CGCATAACT.AATCCGCTG
CGCATAACT.ATCGGTGGT	CGCATAACT.ATCGGTGGT
CGCATAACT.CGAGTAGCA	CGCATAACT.CGAGTAGCA
CGCATAACT.CGTGCTTGA	CGCATAACT.CGTGCTTGA
CGCATAACT.GATTAGACA	CGCATAACT.GATTAGACA
CGCATAACT.GCGACCTGT	CGCATAACT.GCGACCTGT
CGCATAACT.GCTGAGCAG	CGCATAACT.GCTGAGCAG
CGCATCTAC.ATGCGCCGT	CGCATCTAC.ATGCGCCGT
CGCATCTAC.CAGCTCTTC	CGCATCTAC.CAGCTCTTC
CGCATCTAC.CCTAGTTAG	CGCATCTAC.CCTAGTTAG
CGCATCTAC.GGTAGCATC	CGCATCTAC.GGTAGCATC
CGCATCTAC.GTCCTTCAT	CGCATCTAC.GTCCTTCAT
CGCATCTAC.GTTACTACT	CGCATCTAC.GTTACTACT
CGCCACCAT.AGGTGTACA	CGCCACCAT.AGGTGTACA
CGCCACCAT.ATCCAATGA	CGCCACCAT.ATCCAATGA
CGCCACCAT.ATTGACACG	CGCCACCAT.ATTGACACG
CGCCACCAT.CACATGTGC	CGCCACCAT.CACATGTGC
CGCCACCAT.CTTGATCTA	CGCCACCAT.CTTGATCTA
CGCCACCAT.GAACGCTGT	CGCCACCAT.GAACGCTGT
CGCCACCAT.TACATGCAC	CGCCACCAT.TACATGCAC
CGCCACCAT.TCAATCTAG	CGCCACCAT.TCAATCTAG
CGCCATTAC.ACCGGTTAC	CGCCATTAC.ACCGGTTAC
CGCCATTAC.CGCCACCAT	CGCCATTAC.CGCCACCAT
CGCCATTAC.GCAACCAAC	CGCCATTAC.GCAACCAAC
CGCCATTAC.GTCAGACCG	CGCCATTAC.GTCAGACCG
CGCCATTAC.TCCTTCGTA	CGCCATTAC.TCCTTCGTA
CGCCTGCAA.CACAACCAG	CGCCTGCAA.CACAACCAG
CGCCTGCAA.GGTAAGGAT	CGCCTGCAA.GGTAAGGAT
CGCCTGCAA.TATGAGACC	CGCCTGCAA.TATGAGACC
CGCCTGCAA.TATGCCTTC	CGCCTGCAA.TATGCCTTC
CGCCTGCAA.TGCCGAACT	CGCCTGCAA.TGCCGAACT
CGCGAGTGT.AAGGAACAG	CGCGAGTGT.AAGGAACAG
CGCGAGTGT.AGAGGACGT	CGCGAGTGT.AGAGGACGT
CGCGAGTGT.GTATGCCTT	CGCGAGTGT.GTATGCCTT
CGCGAGTGT.TCGCTGATT	CGCGAGTGT.TCGCTGATT
CGCGATGTA.ATTGCCGAC	CGCGATGTA.ATTGCCGAC
CGCGATGTA.CACGACTCA	CGCGATGTA.CACGACTCA
CGCGATGTA.CAGCGACGT	CGCGATGTA.CAGCGACGT
CGCGATGTA.CAGGTTGTC	CGCGATGTA.CAGGTTGTC
CGCGATGTA.GTCTTCTCG	CGCGATGTA.GTCTTCTCG
CGCGATGTA.TCGGTATCA	CGCGATGTA.TCGGTATCA
CGCGATGTA.TCTACAGTT	CGCGATGTA.TCTACAGTT
CGCGCACAT.CCTGCAGAT	CGCGCACAT.CCTGCAGAT
CGCGTACTA.AATCCTCGT	CGCGTACTA.AATCCTCGT
CGCGTACTA.GATGCTCCT	CGCGTACTA.GATGCTCCT
CGCGTGAGA.ACATGGATT	CGCGTGAGA.ACATGGATT
CGCGTGAGA.CTCAGTGAT	CGCGTGAGA.CTCAGTGAT
CGCGTGAGA.TGCAGATGC	CGCGTGAGA.TGCAGATGC
CGCTGTAGT.ATATGTCCA	CGCTGTAGT.ATATGTCCA
CGCTGTAGT.CCACATTAG	CGCTGTAGT.CCACATTAG
CGCTGTAGT.GGTACTTCC	CGCTGTAGT.GGTACTTCC
CGCTTATGA.ACGGTGTAC	CGCTTATGA.ACGGTGTAC
CGCTTATGA.CTCCAGCGT	CGCTTATGA.CTCCAGCGT
CGCTTGTAG.ACACCACAT	CGCTTGTAG.ACACCACAT
CGCTTGTAG.CTGGTACAT	CGCTTGTAG.CTGGTACAT
CGGAACGAG.CACCAAGAT	CGGAACGAG.CACCAAGAT
CGGAACGAG.TCGCTGATT	CGGAACGAG.TCGCTGATT
CGGAACGAG.TTCGCTGAG	CGGAACGAG.TTCGCTGAG
CGGAAGACG.AACTGATTC	CGGAAGACG.AACTGATTC
CGGAAGACG.ACACATCTG	CGGAAGACG.ACACATCTG
CGGAAGACG.CCGATCAGC	CGGAAGACG.CCGATCAGC
CGGAAGACG.CTTGATCTA	CGGAAGACG.CTTGATCTA
CGGAATGCA.AGCCAGGAC	CGGAATGCA.AGCCAGGAC
CGGAATGCA.TATAATCGC	CGGAATGCA.TATAATCGC
CGGACAAGT.CACACCACA	CGGACAAGT.CACACCACA
CGGAGACTT.AACAGATCG	CGGAGACTT.AACAGATCG
CGGAGACTT.ACAGAGATG	CGGAGACTT.ACAGAGATG
CGGAGACTT.CATCTCACG	CGGAGACTT.CATCTCACG
CGGAGACTT.CGAACAATC	CGGAGACTT.CGAACAATC
CGGAGACTT.GTAGCCTTG	CGGAGACTT.GTAGCCTTG
CGGATTCTC.AGCTCTCCG	CGGATTCTC.AGCTCTCCG
CGGATTCTC.AGGATCATG	CGGATTCTC.AGGATCATG
CGGATTCTC.CATCGCTGG	CGGATTCTC.CATCGCTGG
CGGATTCTC.GCTCCTAGC	CGGATTCTC.GCTCCTAGC
CGGATTCTC.GTCTTCATA	CGGATTCTC.GTCTTCATA
CGGATTCTC.TCTTAGCGA	CGGATTCTC.TCTTAGCGA
CGGATTCTC.TGAGAGGAC	CGGATTCTC.TGAGAGGAC
CGGTAGCTT.ACTCCAACT	CGGTAGCTT.ACTCCAACT
CGGTAGCTT.AGGTCCGTC	CGGTAGCTT.AGGTCCGTC
CGGTCGACA.AGCTCTCCG	CGGTCGACA.AGCTCTCCG
CGGTCGACA.CTGATGCAC	CGGTCGACA.CTGATGCAC
CGGTCGACA.TCACGACAA	CGGTCGACA.TCACGACAA
CGGTGAGTC.AACGGTAGC	CGGTGAGTC.AACGGTAGC
CGGTGAGTC.ACTATTGTC	CGGTGAGTC.ACTATTGTC
CGGTGAGTC.CGAGCTTAC	CGGTGAGTC.CGAGCTTAC
CGGTGAGTC.CTGAGATAG	CGGTGAGTC.CTGAGATAG
CGGTGAGTC.CTTAACAGC	CGGTGAGTC.CTTAACAGC
CGGTGAGTC.GTACCACAA	CGGTGAGTC.GTACCACAA
CGGTGAGTC.TGATTGCTG	CGGTGAGTC.TGATTGCTG
CGGTGTTAC.CGCGTACTA	CGGTGTTAC.CGCGTACTA
CGGTGTTAC.TTACGCTCG	CGGTGTTAC.TTACGCTCG
CGGTTCGTA.AACTCCATG	CGGTTCGTA.AACTCCATG
CGGTTCGTA.AATTCGGAA	CGGTTCGTA.AATTCGGAA
CGGTTCGTA.CTCAGCTGG	CGGTTCGTA.CTCAGCTGG
CGGTTCGTA.CTGTCTAGT	CGGTTCGTA.CTGTCTAGT
CGGTTCGTA.GCGGTAAGT	CGGTTCGTA.GCGGTAAGT
CGGTTCTAT.ACCAGCGTT	CGGTTCTAT.ACCAGCGTT
CGGTTCTAT.AGTGAACGG	CGGTTCTAT.AGTGAACGG
CGGTTCTAT.ATTGATTGG	CGGTTCTAT.ATTGATTGG
CGGTTCTAT.CGTCTGTCC	CGGTTCTAT.CGTCTGTCC
CGGTTGCGA.AACCGTGAG	CGGTTGCGA.AACCGTGAG
CGGTTGCGA.CAGCTTACC	CGGTTGCGA.CAGCTTACC
CGGTTGCGA.CATCGCTGG	CGGTTGCGA.CATCGCTGG
CGTAATGAC.ACCACGCTA	CGTAATGAC.ACCACGCTA
CGTACACAC.ATATAGCGT	CGTACACAC.ATATAGCGT
CGTACACAC.GTCCTTCAT	CGTACACAC.GTCCTTCAT
CGTACACAC.TTGTATCAC	CGTACACAC.TTGTATCAC
CGTACATCT.ATAGTCAGT	CGTACATCT.ATAGTCAGT
CGTACATCT.TAACTCCGA	CGTACATCT.TAACTCCGA
CGTATAGCG.CACCAAGAT	CGTATAGCG.CACCAAGAT
CGTATAGCG.CATAATTGG	CGTATAGCG.CATAATTGG
CGTATAGCG.CTATCCATC	CGTATAGCG.CTATCCATC
CGTATAGCG.GCCACGAGT	CGTATAGCG.GCCACGAGT
CGTATCGAA.AGACCACGC	CGTATCGAA.AGACCACGC
CGTATCGAA.AGCAACATT	CGTATCGAA.AGCAACATT
CGTATCGAA.CTATCCATC	CGTATCGAA.CTATCCATC
CGTATTCCT.AACAATGCA	CGTATTCCT.AACAATGCA
CGTATTCCT.CTCGCAAGA	CGTATTCCT.CTCGCAAGA
CGTATTCCT.CTGAGTCCA	CGTATTCCT.CTGAGTCCA
CGTCAGCAC.ACGTGAATC	CGTCAGCAC.ACGTGAATC
CGTCAGCAC.CCAGTACTC	CGTCAGCAC.CCAGTACTC
CGTCAGCAC.GCGTGAGCT	CGTCAGCAC.GCGTGAGCT
CGTCAGCAC.GGAGACACA	CGTCAGCAC.GGAGACACA
CGTCAGCAC.TAAGCCATT	CGTCAGCAC.TAAGCCATT
CGTCAGCAC.TAGTAACGG	CGTCAGCAC.TAGTAACGG
CGTCATGGA.GACGCCGTA	CGTCATGGA.GACGCCGTA
CGTCATGGA.GGAAGAAGC	CGTCATGGA.GGAAGAAGC
CGTCGTCAA.ACAAGAATG	CGTCGTCAA.ACAAGAATG
CGTCGTCAA.CAGTCTAAC	CGTCGTCAA.CAGTCTAAC
CGTCGTCAA.GCGCTTCTC	CGTCGTCAA.GCGCTTCTC
CGTCTGCTG.AATCCTCGT	CGTCTGCTG.AATCCTCGT
CGTCTGCTG.TGAGCAGAT	CGTCTGCTG.TGAGCAGAT
CGTCTGCTG.TGCCAATGG	CGTCTGCTG.TGCCAATGG
CGTCTGTCC.AGGAAGGTG	CGTCTGTCC.AGGAAGGTG
CGTCTGTCC.TCACTCGCT	CGTCTGTCC.TCACTCGCT
CGTCTGTCC.TCTGGAGGA	CGTCTGTCC.TCTGGAGGA
CGTGACCAG.CACACCACA	CGTGACCAG.CACACCACA
CGTGACCAG.CATACAACC	CGTGACCAG.CATACAACC
CGTGACCAG.GGTAGCATC	CGTGACCAG.GGTAGCATC
CGTGCAAGG.AGATCTGAC	CGTGCAAGG.AGATCTGAC
CGTGCAAGG.TATTGACTG	CGTGCAAGG.TATTGACTG
CGTGCCTAT.CGAATGAGT	CGTGCCTAT.CGAATGAGT
CGTGCCTAT.TAACGTGTC	CGTGCCTAT.TAACGTGTC
CGTGCTTGA.ACTTGATCT	CGTGCTTGA.ACTTGATCT
CGTGCTTGA.GCACATGTT	CGTGCTTGA.GCACATGTT
CGTGGTACC.AATTGGTGA	CGTGGTACC.AATTGGTGA
CGTGGTACC.AGAAGTAAC	CGTGGTACC.AGAAGTAAC
CGTGGTACC.CACTACAGG	CGTGGTACC.CACTACAGG
CGTGGTACC.CTGTACGAC	CGTGGTACC.CTGTACGAC
CGTGGTACC.GAGTCCAAT	CGTGGTACC.GAGTCCAAT
CGTGGTACC.GATGCTCCT	CGTGGTACC.GATGCTCCT
CGTGGTACC.GCCGCCTAA	CGTGGTACC.GCCGCCTAA
CGTGGTACC.GTTACTACT	CGTGGTACC.GTTACTACT
CGTGGTACC.TGAGAATCC	CGTGGTACC.TGAGAATCC
CGTGTATTC.GCTCAGCCA	CGTGTATTC.GCTCAGCCA
CGTGTATTC.GGTTGCTAT	CGTGTATTC.GGTTGCTAT
CGTGTCCGA.CAACGTCTT	CGTGTCCGA.CAACGTCTT
CGTGTGTGG.AGCGCATGA	CGTGTGTGG.AGCGCATGA
CGTGTGTGG.CATGGTTAC	CGTGTGTGG.CATGGTTAC
CGTGTGTGG.CGCGATGTA	CGTGTGTGG.CGCGATGTA
CGTGTGTGG.GCATGTGGT	CGTGTGTGG.GCATGTGGT
CGTGTGTGG.TGATCTCGG	CGTGTGTGG.TGATCTCGG
CGTTAATGG.ACCTAGTTA	CGTTAATGG.ACCTAGTTA
CGTTAATGG.AGGATTGAG	CGTTAATGG.AGGATTGAG
CGTTAATGG.CCATGCGTC	CGTTAATGG.CCATGCGTC
CGTTAATGG.TCTCAGGAT	CGTTAATGG.TCTCAGGAT
CGTTACACC.ATTATGCAG	CGTTACACC.ATTATGCAG
CGTTACACC.CAGAGCACC	CGTTACACC.CAGAGCACC
CGTTACACC.TATTACAGC	CGTTACACC.TATTACAGC
CGTTCCATT.ACATGGATT	CGTTCCATT.ACATGGATT
CGTTCCATT.ACTGGTGCT	CGTTCCATT.ACTGGTGCT
CGTTCCATT.CCATAAGTA	CGTTCCATT.CCATAAGTA
CGTTCCATT.CCTCCTTGT	CGTTCCATT.CCTCCTTGT
CGTTCCATT.TTACTAGTC	CGTTCCATT.TTACTAGTC
CGTTCGTAC.ACCTAGTTA	CGTTCGTAC.ACCTAGTTA
CGTTCGTAC.ATCATAGAC	CGTTCGTAC.ATCATAGAC
CGTTCGTAC.GTCAGTTGT	CGTTCGTAC.GTCAGTTGT
CGTTCGTAC.TTACTTACG	CGTTCGTAC.TTACTTACG
CGTTGATCC.GACTTCACC	CGTTGATCC.GACTTCACC
CGTTGATCC.TCGAACGCT	CGTTGATCC.TCGAACGCT
CGTTGATCC.TGTGCCATG	CGTTGATCC.TGTGCCATG
CTAACCGGT.AGATGAAGA	CTAACCGGT.AGATGAAGA
CTAACCGGT.AGCGGTAAG	CTAACCGGT.AGCGGTAAG
CTAACCGGT.CAGATCATT	CTAACCGGT.CAGATCATT
CTAACCGGT.CTGTTACCA	CTAACCGGT.CTGTTACCA
CTAACCGGT.CTTGCACAA	CTAACCGGT.CTTGCACAA
CTAACTAAG.GCCGCCTAA	CTAACTAAG.GCCGCCTAA
CTAACTAAG.GTGGATAAG	CTAACTAAG.GTGGATAAG
CTAATACGC.AGGTCACGT	CTAATACGC.AGGTCACGT
CTAATACGC.ATAGACCGA	CTAATACGC.ATAGACCGA
CTAATACGC.CTATGGATG	CTAATACGC.CTATGGATG
CTAATACGC.GACACGCAA	CTAATACGC.GACACGCAA
CTACCTGCG.CACCTTCCT	CTACCTGCG.CACCTTCCT
CTACCTGCG.CATCTCGAT	CTACCTGCG.CATCTCGAT
CTACCTGCG.CCAGGAGTT	CTACCTGCG.CCAGGAGTT
CTACCTGCG.CCATAGCCA	CTACCTGCG.CCATAGCCA
CTACCTGCG.GAGAACAGG	CTACCTGCG.GAGAACAGG
CTACCTGCG.TCCAACGTG	CTACCTGCG.TCCAACGTG
CTACCTGCG.TGTGGTCCT	CTACCTGCG.TGTGGTCCT
CTACGAGAA.GGAGATGAG	CTACGAGAA.GGAGATGAG
CTACGAGAA.TATTGACTG	CTACGAGAA.TATTGACTG
CTACGAGAA.TGATGTGTG	CTACGAGAA.TGATGTGTG
CTACGGTAT.ATGCCTTCA	CTACGGTAT.ATGCCTTCA
CTACGGTAT.GGAGCTCAA	CTACGGTAT.GGAGCTCAA
CTACGTTGG.ACTTAGCTT	CTACGTTGG.ACTTAGCTT
CTACGTTGG.TCGCGTCAT	CTACGTTGG.TCGCGTCAT
CTACTGTCA.CATAGAGAT	CTACTGTCA.CATAGAGAT
CTACTGTCA.CTCGACTGC	CTACTGTCA.CTCGACTGC
CTACTGTCA.GCATGTAAG	CTACTGTCA.GCATGTAAG
CTAGACATG.ATATAGCGT	CTAGACATG.ATATAGCGT
CTAGAGGTA.CCTCTGCAT	CTAGAGGTA.CCTCTGCAT
CTAGAGTCG.CAACGATCG	CTAGAGTCG.CAACGATCG
CTAGAGTCG.CCACAAGGT	CTAGAGTCG.CCACAAGGT
CTAGGTACT.GACGGTGCT	CTAGGTACT.GACGGTGCT
CTAGGTACT.GTCGCAGGT	CTAGGTACT.GTCGCAGGT
CTAGGTACT.TTACTTACG	CTAGGTACT.TTACTTACG
CTAGTATAG.TCCAGAACG	CTAGTATAG.TCCAGAACG
CTAGTATAG.TCCTCTAGT	CTAGTATAG.TCCTCTAGT
CTAGTCGTC.CATGGTTAC	CTAGTCGTC.CATGGTTAC
CTAGTCGTC.GCATTGATC	CTAGTCGTC.GCATTGATC
CTAGTCGTC.TATGTACCT	CTAGTCGTC.TATGTACCT
CTAGTCGTC.TCGCTTAAC	CTAGTCGTC.TCGCTTAAC
CTAGTCGTC.TTCGCTGAG	CTAGTCGTC.TTCGCTGAG
CTAGTGCTG.GTGCTCTTG	CTAGTGCTG.GTGCTCTTG
CTAGTGCTG.TAGCTGTTG	CTAGTGCTG.TAGCTGTTG
CTAGTTCCA.GATCTGAAT	CTAGTTCCA.GATCTGAAT
CTATACTAG.ACAGGTATC	CTATACTAG.ACAGGTATC
CTATACTAG.AGTCTGGAA	CTATACTAG.AGTCTGGAA
CTATACTAG.CCGCATCCT	CTATACTAG.CCGCATCCT
CTATACTAG.CGCGTGAGA	CTATACTAG.CGCGTGAGA
CTATACTAG.GTGCCATGA	CTATACTAG.GTGCCATGA
CTATACTAG.GTTAGATTG	CTATACTAG.GTTAGATTG
CTATAGCTC.ATCGCCTCT	CTATAGCTC.ATCGCCTCT
CTATAGCTC.GAATTGTTG	CTATAGCTC.GAATTGTTG
CTATAGCTC.GGTCGGATA	CTATAGCTC.GGTCGGATA
CTATCCATC.CAGCTGGAG	CTATCCATC.CAGCTGGAG
CTATCCATC.CATACAACC	CTATCCATC.CATACAACC
CTATCCATC.CTCGTGTCC	CTATCCATC.CTCGTGTCC
CTATCCATC.GATTCCTCT	CTATCCATC.GATTCCTCT
CTATCCATC.TACGACCAT	CTATCCATC.TACGACCAT
CTATCCATC.TCGCTGATT	CTATCCATC.TCGCTGATT
CTATCTTGA.ATATCAGCC	CTATCTTGA.ATATCAGCC
CTATCTTGA.GCTTAGAAC	CTATCTTGA.GCTTAGAAC
CTATCTTGA.GTGACTCTC	CTATCTTGA.GTGACTCTC
CTATGGATG.ATTGATTGG	CTATGGATG.ATTGATTGG
CTATGGATG.CCGTCAGGT	CTATGGATG.CCGTCAGGT
CTATGGATG.TAGAGCCAG	CTATGGATG.TAGAGCCAG
CTATGGATG.TTCATCCAA	CTATGGATG.TTCATCCAA
CTATTAAGG.AACGCATTG	CTATTAAGG.AACGCATTG
CTATTCCGT.AACGAGGTG	CTATTCCGT.AACGAGGTG
CTATTCCGT.CGTCTGTCC	CTATTCCGT.CGTCTGTCC
CTATTCCGT.GAGGTGAGC	CTATTCCGT.GAGGTGAGC
CTCAGCTGG.CTCAGGTAC	CTCAGCTGG.CTCAGGTAC
CTCAGGTAC.ACAGCATCA	CTCAGGTAC.ACAGCATCA
CTCAGGTAC.AGGTCCGTC	CTCAGGTAC.AGGTCCGTC
CTCAGGTAC.ATCATGTTC	CTCAGGTAC.ATCATGTTC
CTCAGGTAC.CACTGTATC	CTCAGGTAC.CACTGTATC
CTCAGGTAC.GGTTGAAGG	CTCAGGTAC.GGTTGAAGG
CTCAGGTAC.TAACACGAG	CTCAGGTAC.TAACACGAG
CTCAGGTAC.TATCGAGCC	CTCAGGTAC.TATCGAGCC
CTCAGGTAC.TGAGACAGC	CTCAGGTAC.TGAGACAGC
CTCAGTGAT.CCACGAAGG	CTCAGTGAT.CCACGAAGG
CTCAGTGAT.CGTAATGAC	CTCAGTGAT.CGTAATGAC
CTCAGTGAT.GTAGGACGC	CTCAGTGAT.GTAGGACGC
CTCATGCCA.ACGACATCT	CTCATGCCA.ACGACATCT
CTCATGCCA.ATAGCACGG	CTCATGCCA.ATAGCACGG
CTCATGCCA.CCTCGAGAG	CTCATGCCA.CCTCGAGAG
CTCATTAGT.CCTGTTAGC	CTCATTAGT.CCTGTTAGC
CTCATTAGT.GAGAACAGG	CTCATTAGT.GAGAACAGG
CTCATTAGT.TCCTTCGTA	CTCATTAGT.TCCTTCGTA
CTCATTAGT.TTACAGTGT	CTCATTAGT.TTACAGTGT
CTCATTAGT.TTACTTACG	CTCATTAGT.TTACTTACG
CTCCACGTC.GAATCACAT	CTCCACGTC.GAATCACAT
CTCCAGCGT.AGAATCAGA	CTCCAGCGT.AGAATCAGA
CTCCAGCGT.GGTAAGGAT	CTCCAGCGT.GGTAAGGAT
CTCCAGCGT.TGATTGCTG	CTCCAGCGT.TGATTGCTG
CTCCGCATT.ACGACAGTC	CTCCGCATT.ACGACAGTC
CTCCGCATT.CAGTACATC	CTCCGCATT.CAGTACATC
CTCCTATCT.GGTCGGTCT	CTCCTATCT.GGTCGGTCT
CTCCTATCT.GGTTCGCAA	CTCCTATCT.GGTTCGCAA
CTCCTATCT.TCAATCTAG	CTCCTATCT.TCAATCTAG
CTCCTGACG.ATGAGTGTG	CTCCTGACG.ATGAGTGTG
CTCCTGACG.CACCTACGC	CTCCTGACG.CACCTACGC
CTCGAACTG.CCATATCTT	CTCGAACTG.CCATATCTT
CTCGAACTG.TCAACACTC	CTCGAACTG.TCAACACTC
CTCGAACTG.TCCGATCTG	CTCGAACTG.TCCGATCTG
CTCGACGAT.CAGTTACTG	CTCGACGAT.CAGTTACTG
CTCGACGAT.CTGCTTAGG	CTCGACGAT.CTGCTTAGG
CTCGACGAT.TGATAGAGG	CTCGACGAT.TGATAGAGG
CTCGACGAT.TGCGTATCT	CTCGACGAT.TGCGTATCT
CTCGACTGC.GTAGCCTTG	CTCGACTGC.GTAGCCTTG
CTCGACTGC.TCTCCGCGT	CTCGACTGC.TCTCCGCGT
CTCGCAAGA.AAGCACAAC	CTCGCAAGA.AAGCACAAC
CTCGCAAGA.CTGTCACTT	CTCGCAAGA.CTGTCACTT
CTCGCAAGA.GCTGGTAAC	CTCGCAAGA.GCTGGTAAC
CTCGCAAGA.GTAGGACGC	CTCGCAAGA.GTAGGACGC
CTCGCTACG.AGCACCAGC	CTCGCTACG.AGCACCAGC
CTCGCTACG.AGTCTGGAA	CTCGCTACG.AGTCTGGAA
CTCGCTACG.TACAGGACT	CTCGCTACG.TACAGGACT
CTCGTCTTG.CAGCACGTG	CTCGTCTTG.CAGCACGTG
CTCGTCTTG.CTATTCCGT	CTCGTCTTG.CTATTCCGT
CTCGTGTCC.ACTCGAGTC	CTCGTGTCC.ACTCGAGTC
CTCGTGTCC.AGTCCGTGT	CTCGTGTCC.AGTCCGTGT
CTCGTGTCC.CACGGATAG	CTCGTGTCC.CACGGATAG
CTCGTGTCC.CAGTCTAAC	CTCGTGTCC.CAGTCTAAC
CTCGTGTCC.GGAATTGGA	CTCGTGTCC.GGAATTGGA
CTCGTGTCC.TACTTACCA	CTCGTGTCC.TACTTACCA
CTCGTTCAC.AATATCAGC	CTCGTTCAC.AATATCAGC
CTCGTTCAC.CCAATATAC	CTCGTTCAC.CCAATATAC
CTCGTTCAC.TAGTTGACG	CTCGTTCAC.TAGTTGACG
CTCGTTCAC.TGGTAGCAG	CTCGTTCAC.TGGTAGCAG
CTCGTTCAC.TTGCAGTCA	CTCGTTCAC.TTGCAGTCA
CTCTAAGAG.AGATCGAGT	CTCTAAGAG.AGATCGAGT
CTCTAAGAG.GAGTATCGC	CTCTAAGAG.GAGTATCGC
CTCTAAGAG.GATGTTACA	CTCTAAGAG.GATGTTACA
CTCTAAGAG.GGAGAATGA	CTCTAAGAG.GGAGAATGA
CTCTACGCA.GATAGTTCT	CTCTACGCA.GATAGTTCT
CTCTACGCA.TCATGCAGG	CTCTACGCA.TCATGCAGG
CTCTAGTAA.AATACCTTG	CTCTAGTAA.AATACCTTG
CTCTAGTAA.GCCAACAAT	CTCTAGTAA.GCCAACAAT
CTCTAGTAA.GCTACCGAG	CTCTAGTAA.GCTACCGAG
CTCTAGTAA.GTGCTCGGA	CTCTAGTAA.GTGCTCGGA
CTCTAGTAA.TCTACATCC	CTCTAGTAA.TCTACATCC
CTCTCAGTC.ATCATAGAC	CTCTCAGTC.ATCATAGAC
CTCTCAGTC.ATGCCTTCA	CTCTCAGTC.ATGCCTTCA
CTCTCAGTC.CAATACCAC	CTCTCAGTC.CAATACCAC
CTCTCAGTC.CAGGTTGTC	CTCTCAGTC.CAGGTTGTC
CTCTCAGTC.TAGAGCCAG	CTCTCAGTC.TAGAGCCAG
CTCTCAGTC.TTACGGACC	CTCTCAGTC.TTACGGACC
CTCTCGATA.CAGCGACGT	CTCTCGATA.CAGCGACGT
CTCTCGATA.TCGCTGATT	CTCTCGATA.TCGCTGATT
CTCTCGATA.TTGACCTGA	CTCTCGATA.TTGACCTGA
CTCTGCAAG.AACTGCGAC	CTCTGCAAG.AACTGCGAC
CTCTGCAAG.CCACTACCA	CTCTGCAAG.CCACTACCA
CTCTGCAAG.CGTGCTTGA	CTCTGCAAG.CGTGCTTGA
CTCTGCAAG.GGAGACACA	CTCTGCAAG.GGAGACACA
CTCTGCAAG.GTGGATAAG	CTCTGCAAG.GTGGATAAG
CTCTGCGGT.GTCTGACGT	CTCTGCGGT.GTCTGACGT
CTCTGCGGT.GTGGTTACC	CTCTGCGGT.GTGGTTACC
CTCTGTCAA.AACGGTAGC	CTCTGTCAA.AACGGTAGC
CTCTGTCAA.CAATACCAC	CTCTGTCAA.CAATACCAC
CTCTGTCAA.CACAATAAC	CTCTGTCAA.CACAATAAC
CTCTGTCAA.TATCACCTG	CTCTGTCAA.TATCACCTG
CTCTTCAGC.GATACTGTG	CTCTTCAGC.GATACTGTG
CTCTTCAGC.TAAGTACAC	CTCTTCAGC.TAAGTACAC
CTGACAGCA.AGGAAGGTG	CTGACAGCA.AGGAAGGTG
CTGACAGCA.TTACGGACC	CTGACAGCA.TTACGGACC
CTGACGATG.ACCTAGTTA	CTGACGATG.ACCTAGTTA
CTGACGGAT.CAATCAAGT	CTGACGGAT.CAATCAAGT
CTGACGGAT.CATAGGTGT	CTGACGGAT.CATAGGTGT
CTGACGGAT.CGATAGGTG	CTGACGGAT.CGATAGGTG
CTGACGGAT.CTCGTGTCC	CTGACGGAT.CTCGTGTCC
CTGACGGAT.TTCCAGATT	CTGACGGAT.TTCCAGATT
CTGAGATAG.GAATAAGAG	CTGAGATAG.GAATAAGAG
CTGAGATAG.GCCTTCCAT	CTGAGATAG.GCCTTCCAT
CTGAGATAG.TCTCCGCGT	CTGAGATAG.TCTCCGCGT
CTGAGGTTA.CTACGGTAT	CTGAGGTTA.CTACGGTAT
CTGAGGTTA.GCAGCGATA	CTGAGGTTA.GCAGCGATA
CTGAGTAGC.ACGGACCAT	CTGAGTAGC.ACGGACCAT
CTGAGTAGC.GCTGTTCGG	CTGAGTAGC.GCTGTTCGG
CTGAGTAGC.GTGCATCAA	CTGAGTAGC.GTGCATCAA
CTGAGTCCA.ACGTGTAGT	CTGAGTCCA.ACGTGTAGT
CTGAGTCCA.CGAAGAGGT	CTGAGTCCA.CGAAGAGGT
