TCACATACT.GCGCATTAC	TCACATACT.GCGCATTAC
TCACATACT.TGGAACTAA	TCACATACT.TGGAACTAA
TCACATACT.TGGTCTACG	TCACATACT.TGGTCTACG
TCACCGAGG.ACAAGAATG	TCACCGAGG.ACAAGAATG
TCACCGAGG.ACTTAGCTT	TCACCGAGG.ACTTAGCTT
TCACCGAGG.CCAGTCTCA	TCACCGAGG.CCAGTCTCA
TCACCGAGG.CGGATTCTC	TCACCGAGG.CGGATTCTC
TCACCGAGG.CTGATGCAC	TCACCGAGG.CTGATGCAC
TCACCGAGG.GGTCGGTCT	TCACCGAGG.GGTCGGTCT
TCACCGAGG.GTCAGTTGT	TCACCGAGG.GTCAGTTGT
TCACCGAGG.GTGCATCAA	TCACCGAGG.GTGCATCAA
TCACCGAGG.TACCGATTG	TCACCGAGG.TACCGATTG
TCACCGAGG.TATTGACTG	TCACCGAGG.TATTGACTG
TCACCGAGG.TCATGCAGG	TCACCGAGG.TCATGCAGG
TCACCGAGG.TCGCTGTAA	TCACCGAGG.TCGCTGTAA
TCACGACAA.AGGATTGAG	TCACGACAA.AGGATTGAG
TCACGACAA.CTTCCGTGG	TCACGACAA.CTTCCGTGG
TCACGACAA.GAATTGTTG	TCACGACAA.GAATTGTTG
TCACGACAA.TATACGGAT	TCACGACAA.TATACGGAT
TCACGCGAC.ATCTTACAG	TCACGCGAC.ATCTTACAG
TCACGCGAC.GCGAAGCTC	TCACGCGAC.GCGAAGCTC
TCACTACGT.ATGCTTCAG	TCACTACGT.ATGCTTCAG
TCACTCGCT.ATCGTAGTG	TCACTCGCT.ATCGTAGTG
TCACTCGCT.CCAACAACA	TCACTCGCT.CCAACAACA
TCACTCGCT.CGATAGGTG	TCACTCGCT.CGATAGGTG
TCACTCGCT.GACGCTTGC	TCACTCGCT.GACGCTTGC
TCACTCGCT.GTAGCATAC	TCACTCGCT.GTAGCATAC
TCACTCGCT.TTCCAGATT	TCACTCGCT.TTCCAGATT
TCAGACAAG.ACAGCATCA	TCAGACAAG.ACAGCATCA
TCAGACAAG.ATAATGTGG	TCAGACAAG.ATAATGTGG
TCAGACAAG.CTGTGCTCA	TCAGACAAG.CTGTGCTCA
TCAGACAAG.GCCTGGAAT	TCAGACAAG.GCCTGGAAT
TCAGACAAG.TCTCGTATC	TCAGACAAG.TCTCGTATC
TCAGAGCGT.AGCAGACAA	TCAGAGCGT.AGCAGACAA
TCAGAGCGT.CATAATTGG	TCAGAGCGT.CATAATTGG
TCAGAGCGT.CTGTCTAGT	TCAGAGCGT.CTGTCTAGT
TCAGAGCGT.GTCAGTTGT	TCAGAGCGT.GTCAGTTGT
TCAGAGCGT.TCTACAGTT	TCAGAGCGT.TCTACAGTT
TCAGAGTCA.ACGCTATGT	TCAGAGTCA.ACGCTATGT
TCAGAGTCA.CTCGACGAT	TCAGAGTCA.CTCGACGAT
TCAGAGTCA.CTGTAGAAG	TCAGAGTCA.CTGTAGAAG
TCAGAGTCA.GGACGAGCA	TCAGAGTCA.GGACGAGCA
TCAGAGTCA.TAGCCTTGT	TCAGAGTCA.TAGCCTTGT
TCAGCGACC.AGGTCCGTC	TCAGCGACC.AGGTCCGTC
TCAGCGACC.ATACTTGCT	TCAGCGACC.ATACTTGCT
TCAGCGACC.CCACGAAGG	TCAGCGACC.CCACGAAGG
TCAGCGACC.GTCTACCAA	TCAGCGACC.GTCTACCAA
TCAGCGACC.TAGCCAGTG	TCAGCGACC.TAGCCAGTG
TCAGCTCAG.ACACACCGT	TCAGCTCAG.ACACACCGT
TCAGCTCAG.AGACATCCA	TCAGCTCAG.AGACATCCA
TCAGCTCAG.AGCGACACC	TCAGCTCAG.AGCGACACC
TCAGCTCAG.CACATTCTG	TCAGCTCAG.CACATTCTG
TCAGCTCAG.CAGCTCTTC	TCAGCTCAG.CAGCTCTTC
TCAGCTCAG.GAGCCATCC	TCAGCTCAG.GAGCCATCC
TCAGGACTG.CAGATCATT	TCAGGACTG.CAGATCATT
TCAGGACTG.CGATAGGTG	TCAGGACTG.CGATAGGTG
TCAGGACTG.GCTCAATGA	TCAGGACTG.GCTCAATGA
TCAGGACTG.GTGTACCGT	TCAGGACTG.GTGTACCGT
TCAGGACTG.TCACACTGC	TCAGGACTG.TCACACTGC
TCAGGTGCA.AGTAAGCCA	TCAGGTGCA.AGTAAGCCA
TCAGGTGCA.ATCTGGTAG	TCAGGTGCA.ATCTGGTAG
TCAGGTGCA.CACAATAAC	TCAGGTGCA.CACAATAAC
TCAGGTGCA.TCCATCATT	TCAGGTGCA.TCCATCATT
TCAGGTGCA.TGAGATCAT	TCAGGTGCA.TGAGATCAT
TCAGTAAGC.ACATTCCAC	TCAGTAAGC.ACATTCCAC
TCAGTAAGC.ACCACGGAT	TCAGTAAGC.ACCACGGAT
TCAGTAAGC.CTAGTTCCA	TCAGTAAGC.CTAGTTCCA
TCAGTAAGC.GGAACTGCT	TCAGTAAGC.GGAACTGCT
TCAGTAAGC.GGATTCGTC	TCAGTAAGC.GGATTCGTC
TCAGTAAGC.TACTTACCA	TCAGTAAGC.TACTTACCA
TCAGTAAGC.TCAGCGACC	TCAGTAAGC.TCAGCGACC
TCAGTAAGC.TGAAGACCA	TCAGTAAGC.TGAAGACCA
TCAGTAAGC.TGCATCGGA	TCAGTAAGC.TGCATCGGA
TCAGTGCAA.ACTAACCGA	TCAGTGCAA.ACTAACCGA
TCAGTGCAA.AGGTCCGTC	TCAGTGCAA.AGGTCCGTC
TCAGTGCAA.CCTCTCTAG	TCAGTGCAA.CCTCTCTAG
TCAGTGCAA.GGTCTTGCA	TCAGTGCAA.GGTCTTGCA
TCAGTGCAA.TCCTCTAGT	TCAGTGCAA.TCCTCTAGT
TCAGTGCAA.TTCCTTGAC	TCAGTGCAA.TTCCTTGAC
TCAGTGTTC.CAAGCGCAT	TCAGTGTTC.CAAGCGCAT
TCAGTGTTC.CCGCATCCT	TCAGTGTTC.CCGCATCCT
TCAGTGTTC.TCCTGTCCG	TCAGTGTTC.TCCTGTCCG
TCAGTGTTC.TCGGATGTT	TCAGTGTTC.TCGGATGTT
TCAGTGTTC.TTAGCGTCT	TCAGTGTTC.TTAGCGTCT
TCATATCGC.AACTTGTCG	TCATATCGC.AACTTGTCG
TCATATCGC.ACTCGCTGT	TCATATCGC.ACTCGCTGT
TCATATCGC.ATCCGACCA	TCATATCGC.ATCCGACCA
TCATATCGC.CGCGAGTGT	TCATATCGC.CGCGAGTGT
TCATATCGC.GATTAGACA	TCATATCGC.GATTAGACA
TCATATCGC.GTCATTCTA	TCATATCGC.GTCATTCTA
TCATATCGC.GTTCCAACA	TCATATCGC.GTTCCAACA
TCATCAGAG.ACCGTACGC	TCATCAGAG.ACCGTACGC
TCATCAGAG.CAGCAGTAC	TCATCAGAG.CAGCAGTAC
TCATCAGAG.CCATTACAG	TCATCAGAG.CCATTACAG
TCATCATCT.ACGTCTATG	TCATCATCT.ACGTCTATG
TCATCATCT.CACCTTCCT	TCATCATCT.CACCTTCCT
TCATCATCT.CGCAATCGA	TCATCATCT.CGCAATCGA
TCATCATCT.CTGGTACAT	TCATCATCT.CTGGTACAT
TCATCATCT.TGCCTTCAG	TCATCATCT.TGCCTTCAG
TCATCTGTC.ACCGGAAGG	TCATCTGTC.ACCGGAAGG
TCATCTGTC.ACTGCTAGT	TCATCTGTC.ACTGCTAGT
TCATCTGTC.AGCGCATGA	TCATCTGTC.AGCGCATGA
TCATCTGTC.CACATATCA	TCATCTGTC.CACATATCA
TCATCTGTC.CATGCCAGT	TCATCTGTC.CATGCCAGT
TCATCTGTC.CCACCATGC	TCATCTGTC.CCACCATGC
TCATCTGTC.TCCAACGTG	TCATCTGTC.TCCAACGTG
TCATCTGTC.TGATACCGT	TCATCTGTC.TGATACCGT
TCATCTGTC.TTCATCCAA	TCATCTGTC.TTCATCCAA
TCATGCAGG.ATAGTCTCC	TCATGCAGG.ATAGTCTCC
TCATGCAGG.CACTGCTTA	TCATGCAGG.CACTGCTTA
TCATGCAGG.GCCATCGCT	TCATGCAGG.GCCATCGCT
TCATGCAGG.GTAACGCGA	TCATGCAGG.GTAACGCGA
TCATGCAGG.TAGTAACGG	TCATGCAGG.TAGTAACGG
TCATGCAGG.TATCAGTGC	TCATGCAGG.TATCAGTGC
TCATGCTCA.AGCAAGTCC	TCATGCTCA.AGCAAGTCC
TCATGCTCA.CAGCTAGTT	TCATGCTCA.CAGCTAGTT
TCATGCTCA.CAGGATCAA	TCATGCTCA.CAGGATCAA
TCATGCTCA.CTTAATCGT	TCATGCTCA.CTTAATCGT
TCATGCTCA.GTCATTCTA	TCATGCTCA.GTCATTCTA
TCCAACGTG.AATCTGACC	TCCAACGTG.AATCTGACC
TCCAACGTG.CACTTCCTT	TCCAACGTG.CACTTCCTT
TCCAACGTG.GTCCTAGTT	TCCAACGTG.GTCCTAGTT
TCCAACGTG.TACAGTTAG	TCCAACGTG.TACAGTTAG
TCCAACGTG.TACTTCCAG	TCCAACGTG.TACTTCCAG
TCCAACGTG.TAGACCATG	TCCAACGTG.TAGACCATG
TCCAACGTG.TCAGCGACC	TCCAACGTG.TCAGCGACC
TCCAACGTG.TCATCAGAG	TCCAACGTG.TCATCAGAG
TCCAACGTG.TGATAGAGG	TCCAACGTG.TGATAGAGG
TCCAAGTAA.ACGACGATT	TCCAAGTAA.ACGACGATT
TCCAAGTAA.ATTGATTGG	TCCAAGTAA.ATTGATTGG
TCCAAGTAA.CGTGCTTGA	TCCAAGTAA.CGTGCTTGA
TCCAAGTAA.GGAGATGAG	TCCAAGTAA.GGAGATGAG
TCCAATCAT.CAATCTCCG	TCCAATCAT.CAATCTCCG
TCCAATCAT.TGATCTCGG	TCCAATCAT.TGATCTCGG
TCCACCGGT.ATCCAGCTG	TCCACCGGT.ATCCAGCTG
TCCACCGGT.CCGCACTCA	TCCACCGGT.CCGCACTCA
TCCACCGGT.GACTGCCTG	TCCACCGGT.GACTGCCTG
TCCACCGGT.GGATACCTA	TCCACCGGT.GGATACCTA
TCCACCGGT.GGTGATAGG	TCCACCGGT.GGTGATAGG
TCCACCGGT.TTCCAGATT	TCCACCGGT.TTCCAGATT
TCCACCTCA.AGGAATTGG	TCCACCTCA.AGGAATTGG
TCCACCTCA.AGTCTGGAA	TCCACCTCA.AGTCTGGAA
TCCACCTCA.ATTAGCACA	TCCACCTCA.ATTAGCACA
TCCACCTCA.CGGAATGCA	TCCACCTCA.CGGAATGCA
TCCACCTCA.GCTCCTAGC	TCCACCTCA.GCTCCTAGC
TCCACCTCA.TTATCCAAG	TCCACCTCA.TTATCCAAG
TCCACGTGC.AATATCAGC	TCCACGTGC.AATATCAGC
TCCACGTGC.AGTGTCTCT	TCCACGTGC.AGTGTCTCT
TCCACGTGC.CCTACTAGA	TCCACGTGC.CCTACTAGA
TCCACGTGC.GCCTTATCT	TCCACGTGC.GCCTTATCT
TCCACGTGC.TATTACAGC	TCCACGTGC.TATTACAGC
TCCACGTGC.TCAAGGAGT	TCCACGTGC.TCAAGGAGT
TCCACGTGC.TCTTAGCGA	TCCACGTGC.TCTTAGCGA
TCCAGAACG.ATAAGTTCG	TCCAGAACG.ATAAGTTCG
TCCAGAACG.GATTCCTCT	TCCAGAACG.GATTCCTCT
TCCAGAACG.GCACATGTT	TCCAGAACG.GCACATGTT
TCCAGAACG.GCTTCACTC	TCCAGAACG.GCTTCACTC
TCCAGAACG.TACGTTACC	TCCAGAACG.TACGTTACC
TCCAGAACG.TATGGTTGG	TCCAGAACG.TATGGTTGG
TCCAGAACG.TGGAACTAA	TCCAGAACG.TGGAACTAA
TCCAGAACG.TGTAGATCG	TCCAGAACG.TGTAGATCG
TCCAGAACG.TGTAGGTTA	TCCAGAACG.TGTAGGTTA
TCCAGAACG.TTCCATACC	TCCAGAACG.TTCCATACC
TCCAGCAGC.ACGTCGCTC	TCCAGCAGC.ACGTCGCTC
TCCAGCAGC.CCTAGAGTA	TCCAGCAGC.CCTAGAGTA
TCCAGCAGC.CCTTAACAT	TCCAGCAGC.CCTTAACAT
TCCAGCAGC.CTGTACGAC	TCCAGCAGC.CTGTACGAC
TCCAGCAGC.GCCATTAAG	TCCAGCAGC.GCCATTAAG
TCCAGCAGC.GCGTGAGCT	TCCAGCAGC.GCGTGAGCT
TCCAGCAGC.TTATCCAAG	TCCAGCAGC.TTATCCAAG
TCCAGCTAT.CAGCTCTTC	TCCAGCTAT.CAGCTCTTC
TCCAGCTAT.GATCGCGAA	TCCAGCTAT.GATCGCGAA
TCCAGCTAT.GCGAGTCTA	TCCAGCTAT.GCGAGTCTA
TCCATCATT.CCTTGACGG	TCCATCATT.CCTTGACGG
TCCATCATT.TAAGGTGAT	TCCATCATT.TAAGGTGAT
TCCGATAAC.ACAGCGGTC	TCCGATAAC.ACAGCGGTC
TCCGATAAC.AGATCTGAC	TCCGATAAC.AGATCTGAC
TCCGATAAC.CTGATCAAG	TCCGATAAC.CTGATCAAG
TCCGATAAC.GATTCCTCT	TCCGATAAC.GATTCCTCT
TCCGATCTG.ATGGAGGAA	TCCGATCTG.ATGGAGGAA
TCCGATCTG.CCGCAATGG	TCCGATCTG.CCGCAATGG
TCCGATCTG.CTTCGTGCA	TCCGATCTG.CTTCGTGCA
TCCGATCTG.GATGCTCCT	TCCGATCTG.GATGCTCCT
TCCGATCTG.GTGCTCTTG	TCCGATCTG.GTGCTCTTG
TCCGATCTG.TAACATTGG	TCCGATCTG.TAACATTGG
TCCGATCTG.TCGATTCAG	TCCGATCTG.TCGATTCAG
TCCGATCTG.TGCGCACTG	TCCGATCTG.TGCGCACTG
TCCGGAGCT.AGTATGACG	TCCGGAGCT.AGTATGACG
TCCGGAGCT.CCTGTCGAC	TCCGGAGCT.CCTGTCGAC
TCCGGAGCT.CTGCATGTT	TCCGGAGCT.CTGCATGTT
TCCGGAGCT.TCGGTATCA	TCCGGAGCT.TCGGTATCA
TCCGGAGCT.TGCCGCTAC	TCCGGAGCT.TGCCGCTAC
TCCGTATAC.ACTCTAGGA	TCCGTATAC.ACTCTAGGA
TCCGTATAC.AGAAGCTGC	TCCGTATAC.AGAAGCTGC
TCCGTATAC.CGTGAGACT	TCCGTATAC.CGTGAGACT
TCCGTATAC.GTAACGCGA	TCCGTATAC.GTAACGCGA
TCCGTATAC.TCATCAGAG	TCCGTATAC.TCATCAGAG
TCCGTATAC.TCTTGGTAG	TCCGTATAC.TCTTGGTAG
TCCGTATAC.TTGCCAGAT	TCCGTATAC.TTGCCAGAT
TCCTATTCC.ACCTTGAAG	TCCTATTCC.ACCTTGAAG
TCCTATTCC.CACGCGTAA	TCCTATTCC.CACGCGTAA
TCCTATTCC.GAGTCGTAC	TCCTATTCC.GAGTCGTAC
TCCTATTCC.GTACCTAAC	TCCTATTCC.GTACCTAAC
TCCTATTCC.TAGTACGTA	TCCTATTCC.TAGTACGTA
TCCTATTCC.TCTTAGCGA	TCCTATTCC.TCTTAGCGA
TCCTCGTCG.TTCCTGCTA	TCCTCGTCG.TTCCTGCTA
TCCTCTAGT.ACCGTCACG	TCCTCTAGT.ACCGTCACG
TCCTCTAGT.AGACGCTAT	TCCTCTAGT.AGACGCTAT
TCCTCTAGT.GGATACCTA	TCCTCTAGT.GGATACCTA
TCCTCTAGT.TAACCGTGA	TCCTCTAGT.TAACCGTGA
TCCTCTAGT.TAGCCAGTG	TCCTCTAGT.TAGCCAGTG
TCCTCTAGT.TGAGATCAT	TCCTCTAGT.TGAGATCAT
TCCTCTAGT.TTAGCGTCT	TCCTCTAGT.TTAGCGTCT
TCCTGAGAC.ACGACAGTC	TCCTGAGAC.ACGACAGTC
TCCTGTCCG.ACCTTGAAG	TCCTGTCCG.ACCTTGAAG
TCCTGTCCG.CACATTCTG	TCCTGTCCG.CACATTCTG
TCCTGTGGA.ACTTAGCTT	TCCTGTGGA.ACTTAGCTT
TCCTGTGGA.CGCAATCGA	TCCTGTGGA.CGCAATCGA
TCCTGTGGA.CGGTAGCTT	TCCTGTGGA.CGGTAGCTT
TCCTGTGGA.CGTCATGGA	TCCTGTGGA.CGTCATGGA
TCCTGTGGA.CTGCATGTT	TCCTGTGGA.CTGCATGTT
TCCTGTGGA.GTAACCATA	TCCTGTGGA.GTAACCATA
TCCTGTGGA.TACGACTTG	TCCTGTGGA.TACGACTTG
TCCTGTGGA.TTGTCAACC	TCCTGTGGA.TTGTCAACC
TCCTTAGGT.AGTTATCGC	TCCTTAGGT.AGTTATCGC
TCCTTAGGT.GTAAGGTCC	TCCTTAGGT.GTAAGGTCC
TCCTTCAAC.AACTAACTG	TCCTTCAAC.AACTAACTG
TCCTTCAAC.AGCATATGG	TCCTTCAAC.AGCATATGG
TCCTTCAAC.GATACTGTG	TCCTTCAAC.GATACTGTG
TCCTTCAAC.TAATTCGTG	TCCTTCAAC.TAATTCGTG
TCCTTCAAC.TCAATCTAG	TCCTTCAAC.TCAATCTAG
TCCTTCGTA.ACCATCTAA	TCCTTCGTA.ACCATCTAA
TCCTTCGTA.AGCAACATT	TCCTTCGTA.AGCAACATT
TCCTTCGTA.AGTCTAAGC	TCCTTCGTA.AGTCTAAGC
TCCTTCGTA.CGAGCTTAC	TCCTTCGTA.CGAGCTTAC
TCCTTCGTA.GCTATGTAA	TCCTTCGTA.GCTATGTAA
TCCTTCGTA.TAGGATTAG	TCCTTCGTA.TAGGATTAG
TCCTTCGTA.TATTACAGC	TCCTTCGTA.TATTACAGC
TCCTTCGTA.TGCGTAATC	TCCTTCGTA.TGCGTAATC
TCCTTCGTA.TGCGTCTTA	TCCTTCGTA.TGCGTCTTA
TCCTTCGTA.TTCATTCGC	TCCTTCGTA.TTCATTCGC
TCGAACGCT.AAGACGAAG	TCGAACGCT.AAGACGAAG
TCGAACGCT.ACACTGTGA	TCGAACGCT.ACACTGTGA
TCGAACGCT.GATGCGACG	TCGAACGCT.GATGCGACG
TCGAATAGA.ACGCTCTTA	TCGAATAGA.ACGCTCTTA
TCGAATAGA.CATAATTGG	TCGAATAGA.CATAATTGG
TCGAATAGA.CTGGACTAA	TCGAATAGA.CTGGACTAA
TCGAATAGA.TCTAGGATG	TCGAATAGA.TCTAGGATG
TCGAATAGA.TGTTACTGA	TCGAATAGA.TGTTACTGA
TCGACGTTG.ACGTCGCTC	TCGACGTTG.ACGTCGCTC
TCGACGTTG.CAGCTCTTC	TCGACGTTG.CAGCTCTTC
TCGACGTTG.GGTAGCATC	TCGACGTTG.GGTAGCATC
TCGACGTTG.TATCGAGCC	TCGACGTTG.TATCGAGCC
TCGACGTTG.TATTGCTAC	TCGACGTTG.TATTGCTAC
TCGACGTTG.TGCCGCTAC	TCGACGTTG.TGCCGCTAC
TCGATTCAG.CAGCAGTAC	TCGATTCAG.CAGCAGTAC
TCGATTCAG.GATACACTA	TCGATTCAG.GATACACTA
TCGATTCAG.GCTACCGAG	TCGATTCAG.GCTACCGAG
TCGATTCAG.GGTAAGTGA	TCGATTCAG.GGTAAGTGA
TCGATTCAG.GTCCGCTCA	TCGATTCAG.GTCCGCTCA
TCGATTCAG.TCTAGTGAC	TCGATTCAG.TCTAGTGAC
TCGCAAGCA.CCGAATATG	TCGCAAGCA.CCGAATATG
TCGCAAGCA.CGGTAGCTT	TCGCAAGCA.CGGTAGCTT
TCGCAAGCA.GAGATTCCT	TCGCAAGCA.GAGATTCCT
TCGCAAGCA.GTAACAGTC	TCGCAAGCA.GTAACAGTC
TCGCAAGCA.TATCCTCAG	TCGCAAGCA.TATCCTCAG
TCGCAAGCA.TCCTCTAGT	TCGCAAGCA.TCCTCTAGT
TCGCAAGCA.TCTAGCTGG	TCGCAAGCA.TCTAGCTGG
TCGCAAGCA.TCTGTGAAG	TCGCAAGCA.TCTGTGAAG
TCGCAAGCA.TGCGTCTTA	TCGCAAGCA.TGCGTCTTA
TCGCATTCG.AGCTGCACT	TCGCATTCG.AGCTGCACT
TCGCATTCG.ATCATAGAC	TCGCATTCG.ATCATAGAC
TCGCATTCG.CCGAAGCGT	TCGCATTCG.CCGAAGCGT
TCGCATTCG.CTTAATCGT	TCGCATTCG.CTTAATCGT
TCGCATTCG.GCGAAGCTC	TCGCATTCG.GCGAAGCTC
TCGCATTCG.GTAGAGAGC	TCGCATTCG.GTAGAGAGC
TCGCATTCG.GTGATGTGC	TCGCATTCG.GTGATGTGC
TCGCATTCG.TGCCGACTA	TCGCATTCG.TGCCGACTA
TCGCCAAGC.CCTAGTTAG	TCGCCAAGC.CCTAGTTAG
TCGCCAAGC.GGTTCAGAC	TCGCCAAGC.GGTTCAGAC
TCGCCAAGC.GTACGAACG	TCGCCAAGC.GTACGAACG
TCGCCAAGC.GTTAATTCG	TCGCCAAGC.GTTAATTCG
TCGCCAAGC.TGACAAGTT	TCGCCAAGC.TGACAAGTT
TCGCGTCAT.ACTATTGTC	TCGCGTCAT.ACTATTGTC
TCGCGTCAT.GCTATGTAA	TCGCGTCAT.GCTATGTAA
TCGCGTCAT.GGAATTCAC	TCGCGTCAT.GGAATTCAC
TCGCGTCAT.GGACACTGG	TCGCGTCAT.GGACACTGG
TCGCGTCAT.GTATTACTG	TCGCGTCAT.GTATTACTG
TCGCGTCAT.GTCTGACGT	TCGCGTCAT.GTCTGACGT
TCGCGTCAT.TGGTCCTAG	TCGCGTCAT.TGGTCCTAG
TCGCTGATT.AATAGACGC	TCGCTGATT.AATAGACGC
TCGCTGATT.AGTAACGTA	TCGCTGATT.AGTAACGTA
TCGCTGATT.ATGCTTCAG	TCGCTGATT.ATGCTTCAG
TCGCTGATT.CCACTTCGC	TCGCTGATT.CCACTTCGC
TCGCTGATT.CCTGTCGAC	TCGCTGATT.CCTGTCGAC
TCGCTGATT.GCTCCTAGC	TCGCTGATT.GCTCCTAGC
TCGCTGATT.TACCTCCTC	TCGCTGATT.TACCTCCTC
TCGCTGATT.TTCGCTGAG	TCGCTGATT.TTCGCTGAG
TCGCTGTAA.AACCGCTGA	TCGCTGTAA.AACCGCTGA
TCGCTGTAA.ACGCGACAG	TCGCTGTAA.ACGCGACAG
TCGCTGTAA.ACTAAGTTC	TCGCTGTAA.ACTAAGTTC
TCGCTGTAA.CCACATTAG	TCGCTGTAA.CCACATTAG
TCGCTGTAA.GGTACTTCC	TCGCTGTAA.GGTACTTCC
TCGCTGTAA.GTGATGTGC	TCGCTGTAA.GTGATGTGC
TCGCTGTAA.TAGCAGAGT	TCGCTGTAA.TAGCAGAGT
TCGCTTAAC.CAGTATGAT	TCGCTTAAC.CAGTATGAT
TCGCTTAAC.CTTCACTGT	TCGCTTAAC.CTTCACTGT
TCGCTTAAC.GGAACTGCT	TCGCTTAAC.GGAACTGCT
TCGCTTAAC.GTAGCATAC	TCGCTTAAC.GTAGCATAC
TCGCTTAAC.TAGAGACTA	TCGCTTAAC.TAGAGACTA
TCGCTTAAC.TATGAGACC	TCGCTTAAC.TATGAGACC
TCGGAACGA.ACTTCTAAC	TCGGAACGA.ACTTCTAAC
TCGGAACGA.ATGCTCACC	TCGGAACGA.ATGCTCACC
TCGGACAGT.AGGTATTCC	TCGGACAGT.AGGTATTCC
TCGGACAGT.GTGCTAAGC	TCGGACAGT.GTGCTAAGC
TCGGATGTT.CGACGTACG	TCGGATGTT.CGACGTACG
TCGGATGTT.CTGGTCGGT	TCGGATGTT.CTGGTCGGT
TCGGATGTT.CTTCGTGCA	TCGGATGTT.CTTCGTGCA
TCGGATGTT.GTGACTCTC	TCGGATGTT.GTGACTCTC
TCGGATGTT.TACGACTTG	TCGGATGTT.TACGACTTG
TCGGATGTT.TCAGTGTTC	TCGGATGTT.TCAGTGTTC
TCGGATGTT.TGAGATCAT	TCGGATGTT.TGAGATCAT
TCGGTATCA.CCGGTGGTT	TCGGTATCA.CCGGTGGTT
TCGGTATCA.GTAGCATAC	TCGGTATCA.GTAGCATAC
TCGTAATAG.TCATCATCT	TCGTAATAG.TCATCATCT
TCGTAATAG.TCGGTATCA	TCGTAATAG.TCGGTATCA
TCGTAATAG.TGATGGACA	TCGTAATAG.TGATGGACA
TCGTACCTT.ACGACATCT	TCGTACCTT.ACGACATCT
TCGTACCTT.CATTGCAGA	TCGTACCTT.CATTGCAGA
TCGTACCTT.CTCGTTCAC	TCGTACCTT.CTCGTTCAC
TCGTAGGAA.AATGAGTCG	TCGTAGGAA.AATGAGTCG
TCGTAGGAA.ACGGACCAT	TCGTAGGAA.ACGGACCAT
TCGTAGGAA.AGGAGGTGA	TCGTAGGAA.AGGAGGTGA
TCGTAGGAA.ATCATGTTC	TCGTAGGAA.ATCATGTTC
TCGTAGGAA.CGGAATGCA	TCGTAGGAA.CGGAATGCA
TCGTAGGAA.GTCCACAAC	TCGTAGGAA.GTCCACAAC
TCGTAGGAA.TCGTCCGAT	TCGTAGGAA.TCGTCCGAT
TCGTAGGAA.TGACGGTTG	TCGTAGGAA.TGACGGTTG
TCGTCATTC.AATATCAGC	TCGTCATTC.AATATCAGC
TCGTCATTC.ATATTCGCA	TCGTCATTC.ATATTCGCA
TCGTCATTC.ATGAACTAG	TCGTCATTC.ATGAACTAG
TCGTCATTC.CAGTTGAGT	TCGTCATTC.CAGTTGAGT
TCGTCATTC.GTAGACTCT	TCGTCATTC.GTAGACTCT
TCGTCATTC.GTCAGCGTC	TCGTCATTC.GTCAGCGTC
TCGTCATTC.TAGCAGAGT	TCGTCATTC.TAGCAGAGT
TCGTCCGAT.AGTAATCAG	TCGTCCGAT.AGTAATCAG
TCGTCCGAT.ATATGCAGC	TCGTCCGAT.ATATGCAGC
TCGTCCGAT.CAGCTTACC	TCGTCCGAT.CAGCTTACC
TCGTCCGAT.GCAACACCT	TCGTCCGAT.GCAACACCT
TCGTCCGAT.GTCTGACGT	TCGTCCGAT.GTCTGACGT
TCGTCCGAT.TATTGCTAC	TCGTCCGAT.TATTGCTAC
TCGTGACGT.CGACGTGAT	TCGTGACGT.CGACGTGAT
TCGTGACGT.GCTCAGCCA	TCGTGACGT.GCTCAGCCA
TCGTGACGT.TATGACCGA	TCGTGACGT.TATGACCGA
TCGTGCCAC.AATGCTATC	TCGTGCCAC.AATGCTATC
TCGTGCCAC.CGCACTGAA	TCGTGCCAC.CGCACTGAA
TCGTGCCAC.CTCCAGCGT	TCGTGCCAC.CTCCAGCGT
TCGTGCCAC.GCTGATGTC	TCGTGCCAC.GCTGATGTC
TCGTGCCAC.GTAATCAGC	TCGTGCCAC.GTAATCAGC
TCGTGCCAC.TCAATGGAC	TCGTGCCAC.TCAATGGAC
TCGTGCCAC.TCGCCAAGC	TCGTGCCAC.TCGCCAAGC
TCGTTCTCC.ATTGATCAC	TCGTTCTCC.ATTGATCAC
TCTAATACC.AGAAGCTGC	TCTAATACC.AGAAGCTGC
TCTAATACC.AGGAATTGG	TCTAATACC.AGGAATTGG
TCTAATACC.ATATGCAGC	TCTAATACC.ATATGCAGC
TCTAATACC.ATCGTAGTG	TCTAATACC.ATCGTAGTG
TCTAATACC.GCCTTAGAG	TCTAATACC.GCCTTAGAG
TCTAATACC.GCTGAGCAG	TCTAATACC.GCTGAGCAG
TCTAATACC.TAATGTAGC	TCTAATACC.TAATGTAGC
TCTACAGTT.AATGCCTCA	TCTACAGTT.AATGCCTCA
TCTACAGTT.CACAGCGAA	TCTACAGTT.CACAGCGAA
TCTACAGTT.CACTCACTA	TCTACAGTT.CACTCACTA
TCTACAGTT.CAGTGCTGC	TCTACAGTT.CAGTGCTGC
TCTACAGTT.TGACTGAGA	TCTACAGTT.TGACTGAGA
TCTACATCC.ATACCGAAG	TCTACATCC.ATACCGAAG
TCTACATCC.TAGTCAGAC	TCTACATCC.TAGTCAGAC
TCTACATCC.TATTACTCG	TCTACATCC.TATTACTCG
TCTACGCAA.ATCACCGCA	TCTACGCAA.ATCACCGCA
TCTACGCAA.CACCTCGGA	TCTACGCAA.CACCTCGGA
TCTACGCAA.TGATGACAG	TCTACGCAA.TGATGACAG
TCTACGCAA.TTCTCCACA	TCTACGCAA.TTCTCCACA
TCTAGCTGG.AGACGCCTG	TCTAGCTGG.AGACGCCTG
TCTAGCTGG.CGCATAACT	TCTAGCTGG.CGCATAACT
TCTAGCTGG.CGTGGTACC	TCTAGCTGG.CGTGGTACC
TCTAGCTGG.CTCGTCTTG	TCTAGCTGG.CTCGTCTTG
TCTAGCTGG.TCAAGGTCG	TCTAGCTGG.TCAAGGTCG
TCTAGGATG.ACCTAGTTA	TCTAGGATG.ACCTAGTTA
TCTAGGATG.AGACGGAGG	TCTAGGATG.AGACGGAGG
TCTAGGATG.CAACGATCG	TCTAGGATG.CAACGATCG
TCTAGGATG.CATCAATAG	TCTAGGATG.CATCAATAG
TCTAGGATG.GATCTGTTC	TCTAGGATG.GATCTGTTC
TCTAGGATG.GGACGAGCA	TCTAGGATG.GGACGAGCA
TCTAGGATG.TATACGTGG	TCTAGGATG.TATACGTGG
TCTAGTGAC.ACTGGACCA	TCTAGTGAC.ACTGGACCA
TCTAGTGAC.CCGAGCTGA	TCTAGTGAC.CCGAGCTGA
TCTAGTGAC.CGACGTACG	TCTAGTGAC.CGACGTACG
TCTAGTGAC.CTCGCTACG	TCTAGTGAC.CTCGCTACG
TCTAGTGAC.GCTCAATGA	TCTAGTGAC.GCTCAATGA
TCTATGACA.AATCGTGTT	TCTATGACA.AATCGTGTT
TCTATGACA.CTTCCGGTA	TCTATGACA.CTTCCGGTA
TCTATGACA.GCTGAGCAG	TCTATGACA.GCTGAGCAG
TCTATGACA.GCTTCACTC	TCTATGACA.GCTTCACTC
TCTATGACA.TACTCGCTG	TCTATGACA.TACTCGCTG
TCTATGACA.TAGACCATG	TCTATGACA.TAGACCATG
TCTATTAGG.GAGGTCACG	TCTATTAGG.GAGGTCACG
TCTATTAGG.GTAGTGGAG	TCTATTAGG.GTAGTGGAG
TCTATTAGG.TAACACATC	TCTATTAGG.TAACACATC
TCTATTAGG.TCACACTGC	TCTATTAGG.TCACACTGC
TCTATTAGG.TCTAGCTGG	TCTATTAGG.TCTAGCTGG
TCTCAGGAT.AGCATTGTT	TCTCAGGAT.AGCATTGTT
TCTCAGGAT.GGACAGATT	TCTCAGGAT.GGACAGATT
TCTCAGGAT.TAGTCGCAT	TCTCAGGAT.TAGTCGCAT
TCTCATCGG.AGGAAGGTG	TCTCATCGG.AGGAAGGTG
TCTCATCGG.ATGCTGTCG	TCTCATCGG.ATGCTGTCG
TCTCATCGG.CCATAATCG	TCTCATCGG.CCATAATCG
TCTCATCGG.CCGATCTCT	TCTCATCGG.CCGATCTCT
TCTCATCGG.GCTTGGTTC	TCTCATCGG.GCTTGGTTC
TCTCATCGG.GTAAGGTCC	TCTCATCGG.GTAAGGTCC
TCTCCGCGT.ACTCCGTCG	TCTCCGCGT.ACTCCGTCG
TCTCCGCGT.CATTCGAAT	TCTCCGCGT.CATTCGAAT
TCTCCGCGT.CGTCATGGA	TCTCCGCGT.CGTCATGGA
TCTCCGCGT.CTCAGGTAC	TCTCCGCGT.CTCAGGTAC
TCTCCGCGT.GACGTGGTC	TCTCCGCGT.GACGTGGTC
TCTCCGCGT.TCCTGAGAC	TCTCCGCGT.TCCTGAGAC
TCTCCGCGT.TGACCAAGT	TCTCCGCGT.TGACCAAGT
TCTCGATGC.ACCGTCACG	TCTCGATGC.ACCGTCACG
TCTCGATGC.ACGCGACAG	TCTCGATGC.ACGCGACAG
TCTCGATGC.CGCACTGAA	TCTCGATGC.CGCACTGAA
TCTCGATGC.TAGTAACGG	TCTCGATGC.TAGTAACGG
TCTCGATGC.TCATCATCT	TCTCGATGC.TCATCATCT
TCTCGTATC.ATGCCTTCA	TCTCGTATC.ATGCCTTCA
TCTCGTATC.CAACGCACA	TCTCGTATC.CAACGCACA
TCTCGTATC.CGCGAGTGT	TCTCGTATC.CGCGAGTGT
TCTCGTATC.GAGTCACCA	TCTCGTATC.GAGTCACCA
TCTCGTATC.GCGTTCAGA	TCTCGTATC.GCGTTCAGA
TCTCGTATC.GCTCTCCAA	TCTCGTATC.GCTCTCCAA
TCTCGTATC.TAACACATC	TCTCGTATC.TAACACATC
TCTCGTATC.TAGTGATCC	TCTCGTATC.TAGTGATCC
TCTGAGATA.CAACTAATC	TCTGAGATA.CAACTAATC
TCTGAGATA.CGCTTCACG	TCTGAGATA.CGCTTCACG
TCTGAGATA.CTGATCCGA	TCTGAGATA.CTGATCCGA
TCTGAGATA.GGATTCGTC	TCTGAGATA.GGATTCGTC
TCTGAGATA.TCGTCCGAT	TCTGAGATA.TCGTCCGAT
TCTGATGAA.CGGTCGACA	TCTGATGAA.CGGTCGACA
TCTGATGAA.GCACAACTC	TCTGATGAA.GCACAACTC
TCTGATGAA.TGCCACCGA	TCTGATGAA.TGCCACCGA
TCTGCAACA.ATCTACATC	TCTGCAACA.ATCTACATC
TCTGCAACA.GAGTCAAGG	TCTGCAACA.GAGTCAAGG
TCTGCAACA.GTACGCGAT	TCTGCAACA.GTACGCGAT
TCTGCAACA.TAGAGCCAG	TCTGCAACA.TAGAGCCAG
TCTGCGCTG.AATACGTCT	TCTGCGCTG.AATACGTCT
TCTGCGCTG.ATCCGGTCC	TCTGCGCTG.ATCCGGTCC
TCTGCGCTG.ATTGGTTCC	TCTGCGCTG.ATTGGTTCC
TCTGCGCTG.CAGATCGAC	TCTGCGCTG.CAGATCGAC
TCTGCGCTG.CGTGCTTGA	TCTGCGCTG.CGTGCTTGA
TCTGCGCTG.GGTGAGTTC	TCTGCGCTG.GGTGAGTTC
TCTGGAGGA.ACGTAGTAT	TCTGGAGGA.ACGTAGTAT
TCTGGAGGA.ACTCTAGGA	TCTGGAGGA.ACTCTAGGA
TCTGGAGGA.ACTTCTTGG	TCTGGAGGA.ACTTCTTGG
TCTGGAGGA.CTAACACTG	TCTGGAGGA.CTAACACTG
TCTGGAGGA.CTAGAGGTA	TCTGGAGGA.CTAGAGGTA
TCTGGAGGA.GACGCCGTA	TCTGGAGGA.GACGCCGTA
TCTGGAGGA.GTGCTGACT	TCTGGAGGA.GTGCTGACT
TCTGGAGGA.TGATACCGT	TCTGGAGGA.TGATACCGT
TCTGGAGGA.TTACGCTCG	TCTGGAGGA.TTACGCTCG
TCTGTGAAG.AAGCTTGCA	TCTGTGAAG.AAGCTTGCA
TCTGTGAAG.CAGTGCTGC	TCTGTGAAG.CAGTGCTGC
TCTGTGAAG.CATCCTCTC	TCTGTGAAG.CATCCTCTC
TCTGTGAAG.GCGTGAGCT	TCTGTGAAG.GCGTGAGCT
TCTGTGAAG.GGATTACGC	TCTGTGAAG.GGATTACGC
TCTGTGAAG.TCGAACGCT	TCTGTGAAG.TCGAACGCT
TCTTAAGTG.GGAGACACA	TCTTAAGTG.GGAGACACA
TCTTAAGTG.GTACAATGC	TCTTAAGTG.GTACAATGC
TCTTAGCGA.AGTGATGCG	TCTTAGCGA.AGTGATGCG
TCTTAGCGA.TCTAATACC	TCTTAGCGA.TCTAATACC
TCTTGGTAG.AGGTCACGT	TCTTGGTAG.AGGTCACGT
TCTTGGTAG.AGTAATCAG	TCTTGGTAG.AGTAATCAG
TCTTGGTAG.ATCAGGATG	TCTTGGTAG.ATCAGGATG
TCTTGGTAG.CAATGCATT	TCTTGGTAG.CAATGCATT
TCTTGGTAG.CGGAATGCA	TCTTGGTAG.CGGAATGCA
TCTTGGTAG.CTAGACATG	TCTTGGTAG.CTAGACATG
TCTTGGTAG.GCGACCTGT	TCTTGGTAG.GCGACCTGT
TCTTGGTAG.GCTCCTAGC	TCTTGGTAG.GCTCCTAGC
TCTTGGTAG.TACAACACC	TCTTGGTAG.TACAACACC
TGAACCAAT.AAGGTGCTG	TGAACCAAT.AAGGTGCTG
TGAACCAAT.CCAGGAGTT	TGAACCAAT.CCAGGAGTT
TGAACCAAT.TAGACCGCA	TGAACCAAT.TAGACCGCA
TGAACCAAT.TCGATTCAG	TGAACCAAT.TCGATTCAG
TGAACGGTT.CGGTTGCGA	TGAACGGTT.CGGTTGCGA
TGAACGGTT.CTCTGTCAA	TGAACGGTT.CTCTGTCAA
TGAACGGTT.CTGGAGCGA	TGAACGGTT.CTGGAGCGA
TGAACGGTT.CTTACCTAG	TGAACGGTT.CTTACCTAG
TGAACGGTT.TAGATAGCC	TGAACGGTT.TAGATAGCC
TGAACGTCA.AAGTTCTCT	TGAACGTCA.AAGTTCTCT
TGAACGTCA.ACTCGTAGG	TGAACGTCA.ACTCGTAGG
TGAACGTCA.CACCTCGGA	TGAACGTCA.CACCTCGGA
TGAACGTCA.CACGATAGA	TGAACGTCA.CACGATAGA
TGAACGTCA.GGAATTGGA	TGAACGTCA.GGAATTGGA
TGAACGTCA.TCAAGGAGT	TGAACGTCA.TCAAGGAGT
TGAACGTCA.TCGCTTAAC	TGAACGTCA.TCGCTTAAC
