GACATATGT.ATGGAGGAA	GACATATGT.ATGGAGGAA
GACATATGT.CATAAGATC	GACATATGT.CATAAGATC
GACATATGT.TACCTATCC	GACATATGT.TACCTATCC
GACATATGT.TCTACGCAA	GACATATGT.TCTACGCAA
GACATATGT.TCTAGTGAC	GACATATGT.TCTAGTGAC
GACCAACAG.CACGTCATA	GACCAACAG.CACGTCATA
GACCAACAG.GGATACAAT	GACCAACAG.GGATACAAT
GACCAACAG.TACAGTTAG	GACCAACAG.TACAGTTAG
GACCACTCG.CGCTTGTAG	GACCACTCG.CGCTTGTAG
GACCACTCG.GGAGATGAG	GACCACTCG.GGAGATGAG
GACCACTCG.GTACGCGAT	GACCACTCG.GTACGCGAT
GACCAGAGA.CCAATATAC	GACCAGAGA.CCAATATAC
GACCAGAGA.GATTAGACA	GACCAGAGA.GATTAGACA
GACCAGAGA.TGTTACTGA	GACCAGAGA.TGTTACTGA
GACCGCTTC.CTAACTAAG	GACCGCTTC.CTAACTAAG
GACCGCTTC.CTTCGTGCA	GACCGCTTC.CTTCGTGCA
GACCGGTAG.ACAGAGATG	GACCGGTAG.ACAGAGATG
GACCGGTAG.CCTGTTAGC	GACCGGTAG.CCTGTTAGC
GACCGGTAG.CTAGTGCTG	GACCGGTAG.CTAGTGCTG
GACCGGTAG.GGTGTTCAT	GACCGGTAG.GGTGTTCAT
GACCGGTAG.GTAAGTGAG	GACCGGTAG.GTAAGTGAG
GACCGGTAG.GTATACAGA	GACCGGTAG.GTATACAGA
GACCGGTAG.TACCAGCCA	GACCGGTAG.TACCAGCCA
GACCGGTAG.TCTCGATGC	GACCGGTAG.TCTCGATGC
GACCGGTAG.TGCGCTGCA	GACCGGTAG.TGCGCTGCA
GACCGGTAG.TGTGTAGAG	GACCGGTAG.TGTGTAGAG
GACCGTAGT.AGTCGCGAC	GACCGTAGT.AGTCGCGAC
GACCGTAGT.ATAAGTTCG	GACCGTAGT.ATAAGTTCG
GACCGTAGT.TAGACCATG	GACCGTAGT.TAGACCATG
GACCGTAGT.TGTCTACAC	GACCGTAGT.TGTCTACAC
GACCTTGTG.AGAGGTGAA	GACCTTGTG.AGAGGTGAA
GACCTTGTG.AGTGTTCTG	GACCTTGTG.AGTGTTCTG
GACCTTGTG.GAGATTCCT	GACCTTGTG.GAGATTCCT
GACCTTGTG.GTGGACTGG	GACCTTGTG.GTGGACTGG
GACGCCGTA.AAGACTGGT	GACGCCGTA.AAGACTGGT
GACGCCGTA.AGGATCTCA	GACGCCGTA.AGGATCTCA
GACGCCGTA.CCACGTTCT	GACGCCGTA.CCACGTTCT
GACGCCGTA.GACCACTCG	GACGCCGTA.GACCACTCG
GACGCCGTA.GGAATTGGA	GACGCCGTA.GGAATTGGA
GACGCTTGC.ACTCGCTGT	GACGCTTGC.ACTCGCTGT
GACGCTTGC.AGACGCCTG	GACGCTTGC.AGACGCCTG
GACGCTTGC.ATAGTGGTT	GACGCTTGC.ATAGTGGTT
GACGCTTGC.ATCCAATGA	GACGCTTGC.ATCCAATGA
GACGCTTGC.ATGCTTCAG	GACGCTTGC.ATGCTTCAG
GACGCTTGC.CCTCCTTGT	GACGCTTGC.CCTCCTTGT
GACGCTTGC.CGCGAGTGT	GACGCTTGC.CGCGAGTGT
GACGCTTGC.GAAGAGCAC	GACGCTTGC.GAAGAGCAC
GACGCTTGC.GAGCACATT	GACGCTTGC.GAGCACATT
GACGCTTGC.GGATGCTCG	GACGCTTGC.GGATGCTCG
GACGCTTGC.TAGCGAGAA	GACGCTTGC.TAGCGAGAA
GACGCTTGC.TGCCGAACT	GACGCTTGC.TGCCGAACT
GACGGACTA.AAGGATACG	GACGGACTA.AAGGATACG
GACGGACTA.AATACGTCT	GACGGACTA.AATACGTCT
GACGGACTA.CCTCGACCT	GACGGACTA.CCTCGACCT
GACGGACTA.CTATGGATG	GACGGACTA.CTATGGATG
GACGGACTA.GATGCGGTT	GACGGACTA.GATGCGGTT
GACGGACTA.GCACGCATT	GACGGACTA.GCACGCATT
GACGGACTA.TCGAATAGA	GACGGACTA.TCGAATAGA
GACGGTGCT.ACGTTCAAT	GACGGTGCT.ACGTTCAAT
GACGTAGCA.CACACCACA	GACGTAGCA.CACACCACA
GACGTAGCA.CAGTGCTGC	GACGTAGCA.CAGTGCTGC
GACGTAGCA.CTGAGTCCA	GACGTAGCA.CTGAGTCCA
GACGTAGCA.GAACAACCA	GACGTAGCA.GAACAACCA
GACGTAGCA.GCTACAATG	GACGTAGCA.GCTACAATG
GACGTAGCA.GCTTACGTT	GACGTAGCA.GCTTACGTT
GACGTAGCA.GGAGTACAG	GACGTAGCA.GGAGTACAG
GACGTCAAT.AACTCCATG	GACGTCAAT.AACTCCATG
GACGTCAAT.CAAGTACGA	GACGTCAAT.CAAGTACGA
GACGTCAAT.GAAGGATCA	GACGTCAAT.GAAGGATCA
GACGTCAAT.GATTGAGTA	GACGTCAAT.GATTGAGTA
GACGTCAAT.TTAAGTGGT	GACGTCAAT.TTAAGTGGT
GACGTGGTC.ACGTCGCTC	GACGTGGTC.ACGTCGCTC
GACGTGGTC.CAATCATAC	GACGTGGTC.CAATCATAC
GACGTGGTC.CCAACGGAA	GACGTGGTC.CCAACGGAA
GACGTGGTC.CCTGCTCCA	GACGTGGTC.CCTGCTCCA
GACGTGGTC.TGTCCATAG	GACGTGGTC.TGTCCATAG
GACGTTCAG.ACATTCCAC	GACGTTCAG.ACATTCCAC
GACGTTCAG.CTAGAGGTA	GACGTTCAG.CTAGAGGTA
GACGTTCAG.CTCCGCATT	GACGTTCAG.CTCCGCATT
GACGTTCAG.GTCAGACCG	GACGTTCAG.GTCAGACCG
GACGTTCAG.TGCCAATGG	GACGTTCAG.TGCCAATGG
GACTAGCAT.GACCTTGTG	GACTAGCAT.GACCTTGTG
GACTAGCAT.GCAGGAGAA	GACTAGCAT.GCAGGAGAA
GACTAGCAT.TAGTAACGG	GACTAGCAT.TAGTAACGG
GACTATTGA.AATCCTCGT	GACTATTGA.AATCCTCGT
GACTATTGA.CAGTGCTGC	GACTATTGA.CAGTGCTGC
GACTATTGA.CATGCCAGT	GACTATTGA.CATGCCAGT
GACTATTGA.GAACTGCAA	GACTATTGA.GAACTGCAA
GACTATTGA.TGAGCAGAT	GACTATTGA.TGAGCAGAT
GACTATTGA.TTCCAGATT	GACTATTGA.TTCCAGATT
GACTCAGTG.ATAAGACAG	GACTCAGTG.ATAAGACAG
GACTCAGTG.CCTGCAGAT	GACTCAGTG.CCTGCAGAT
GACTCTCAC.ACTCCGGTT	GACTCTCAC.ACTCCGGTT
GACTCTCAC.AGCTTGGTG	GACTCTCAC.AGCTTGGTG
GACTCTCAC.TAGCGCAGC	GACTCTCAC.TAGCGCAGC
GACTCTGGT.ATTAGCGGT	GACTCTGGT.ATTAGCGGT
GACTCTGGT.ATTGCCGAC	GACTCTGGT.ATTGCCGAC
GACTCTGGT.CACTGTATC	GACTCTGGT.CACTGTATC
GACTCTGGT.GCGAGCAAG	GACTCTGGT.GCGAGCAAG
GACTGCCTG.ACTGGTCAG	GACTGCCTG.ACTGGTCAG
GACTGCCTG.AGGATCATG	GACTGCCTG.AGGATCATG
GACTGCCTG.CATGCCAGT	GACTGCCTG.CATGCCAGT
GACTGCCTG.CGCACTCTT	GACTGCCTG.CGCACTCTT
GACTGCCTG.TTCCTCGGT	GACTGCCTG.TTCCTCGGT
GACTGCGCA.AGTCCAGTG	GACTGCGCA.AGTCCAGTG
GACTGCGCA.ATGTCCTCC	GACTGCGCA.ATGTCCTCC
GACTGCGCA.CGATTCGAG	GACTGCGCA.CGATTCGAG
GACTGCGCA.CGTACACAC	GACTGCGCA.CGTACACAC
GACTGCGCA.GAGTCTTCG	GACTGCGCA.GAGTCTTCG
GACTGCGCA.GATAGTTCT	GACTGCGCA.GATAGTTCT
GACTGCGCA.GTAAGTGAG	GACTGCGCA.GTAAGTGAG
GACTGCGCA.GTATGATCT	GACTGCGCA.GTATGATCT
GACTGCGCA.GTGTACCGT	GACTGCGCA.GTGTACCGT
GACTGCGCA.GTTGCATGG	GACTGCGCA.GTTGCATGG
GACTGCGCA.TACACGGTC	GACTGCGCA.TACACGGTC
GACTTCACC.ACAAGGTAC	GACTTCACC.ACAAGGTAC
GACTTCACC.CCACTACCA	GACTTCACC.CCACTACCA
GACTTCACC.GAATCACAT	GACTTCACC.GAATCACAT
GACTTCACC.TAGAGACTA	GACTTCACC.TAGAGACTA
GACTTCACC.TCAGCTCAG	GACTTCACC.TCAGCTCAG
GACTTCACC.TCTGCGCTG	GACTTCACC.TCTGCGCTG
GACTTGATT.AAGCTGAGG	GACTTGATT.AAGCTGAGG
GACTTGATT.AATGCGTGC	GACTTGATT.AATGCGTGC
GACTTGATT.CCTTCCTCA	GACTTGATT.CCTTCCTCA
GACTTGATT.CTGTTACCA	GACTTGATT.CTGTTACCA
GACTTGATT.GTGTACCGT	GACTTGATT.GTGTACCGT
GACTTGATT.TAGAGACTA	GACTTGATT.TAGAGACTA
GACTTGATT.TTATCCAAG	GACTTGATT.TTATCCAAG
GAGAACAGG.CCTACTAGA	GAGAACAGG.CCTACTAGA
GAGAACAGG.TCCAGAACG	GAGAACAGG.TCCAGAACG
GAGAATCAG.GCCATACAA	GAGAATCAG.GCCATACAA
GAGACATTG.AACGAGGTG	GAGACATTG.AACGAGGTG
GAGACATTG.ACTGTAATC	GAGACATTG.ACTGTAATC
GAGACATTG.CAAGCGCAT	GAGACATTG.CAAGCGCAT
GAGACATTG.CACGATAGA	GAGACATTG.CACGATAGA
GAGACATTG.CCTCCAATC	GAGACATTG.CCTCCAATC
GAGACATTG.TATTACAGC	GAGACATTG.TATTACAGC
GAGACATTG.TCCAAGTAA	GAGACATTG.TCCAAGTAA
GAGACATTG.TGCGATACT	GAGACATTG.TGCGATACT
GAGACATTG.TGGAACTAA	GAGACATTG.TGGAACTAA
GAGACGATC.ACCATACTT	GAGACGATC.ACCATACTT
GAGACGATC.TCGACGTTG	GAGACGATC.TCGACGTTG
GAGACGATC.TCGTGCCAC	GAGACGATC.TCGTGCCAC
GAGACGATC.TGCTCACAC	GAGACGATC.TGCTCACAC
GAGACTCGA.AGAAGTCCT	GAGACTCGA.AGAAGTCCT
GAGACTCGA.CACTTCCTT	GAGACTCGA.CACTTCCTT
GAGACTCGA.CGCTTCACG	GAGACTCGA.CGCTTCACG
GAGACTCGA.GACCGTAGT	GAGACTCGA.GACCGTAGT
GAGATACAC.CTATGGATG	GAGATACAC.CTATGGATG
GAGATACAC.GCCGTCTTC	GAGATACAC.GCCGTCTTC
GAGATACAC.TGACCTCCT	GAGATACAC.TGACCTCCT
GAGATGTAT.AAGGTGCTG	GAGATGTAT.AAGGTGCTG
GAGATGTAT.GGAAGTATG	GAGATGTAT.GGAAGTATG
GAGATGTAT.GTATTACTG	GAGATGTAT.GTATTACTG
GAGATGTAT.TTCGCATCC	GAGATGTAT.TTCGCATCC
GAGATTCCT.AACCGTGAG	GAGATTCCT.AACCGTGAG
GAGATTCCT.AATTCGGAA	GAGATTCCT.AATTCGGAA
GAGATTCCT.ACACAGAAC	GAGATTCCT.ACACAGAAC
GAGATTCCT.ACGAATCGC	GAGATTCCT.ACGAATCGC
GAGATTCCT.AGAGCCGCA	GAGATTCCT.AGAGCCGCA
GAGCACATT.AACAACCTA	GAGCACATT.AACAACCTA
GAGCACATT.AACGCCTAC	GAGCACATT.AACGCCTAC
GAGCACATT.CAGTACATC	GAGCACATT.CAGTACATC
GAGCACATT.CTAGTTCCA	GAGCACATT.CTAGTTCCA
GAGCACATT.GACGTAGCA	GAGCACATT.GACGTAGCA
GAGCACATT.GCGCTACCT	GAGCACATT.GCGCTACCT
GAGCACATT.GCTACCGAG	GAGCACATT.GCTACCGAG
GAGCACATT.GGTGTGACC	GAGCACATT.GGTGTGACC
GAGCACATT.TCTTGGTAG	GAGCACATT.TCTTGGTAG
GAGCAGGAA.AGGAATTGG	GAGCAGGAA.AGGAATTGG
GAGCAGGAA.CATCTCGAT	GAGCAGGAA.CATCTCGAT
GAGCAGGAA.GCGAAGCTC	GAGCAGGAA.GCGAAGCTC
GAGCATACA.ACTCCGGTT	GAGCATACA.ACTCCGGTT
GAGCATACA.CAAGCGCAT	GAGCATACA.CAAGCGCAT
GAGCATACA.CGCAGTGTC	GAGCATACA.CGCAGTGTC
GAGCATACA.CTATTCCGT	GAGCATACA.CTATTCCGT
GAGCATACA.GACGCCGTA	GAGCATACA.GACGCCGTA
GAGCATACA.TCAAGGTCG	GAGCATACA.TCAAGGTCG
GAGCATACA.TCACCGAGG	GAGCATACA.TCACCGAGG
GAGCATACA.TCGGATGTT	GAGCATACA.TCGGATGTT
GAGCCATCC.CCGCTATCC	GAGCCATCC.CCGCTATCC
GAGCCATCC.CCTTGCTTG	GAGCCATCC.CCTTGCTTG
GAGCCATCC.CGAAGAGGT	GAGCCATCC.CGAAGAGGT
GAGCCATCC.CGCGCACAT	GAGCCATCC.CGCGCACAT
GAGCCATCC.TGCCGAACT	GAGCCATCC.TGCCGAACT
GAGCCGTTA.CATAAGATC	GAGCCGTTA.CATAAGATC
GAGCCGTTA.CCTCTGCAT	GAGCCGTTA.CCTCTGCAT
GAGCCGTTA.TATGAAGAC	GAGCCGTTA.TATGAAGAC
GAGCGACTC.CACCTCAAC	GAGCGACTC.CACCTCAAC
GAGCGACTC.CCACATTAG	GAGCGACTC.CCACATTAG
GAGCGACTC.CCGACGTCA	GAGCGACTC.CCGACGTCA
GAGCGACTC.CCGGTGGTT	GAGCGACTC.CCGGTGGTT
GAGCGACTC.CTCCAGCGT	GAGCGACTC.CTCCAGCGT
GAGCGACTC.CTCCGCATT	GAGCGACTC.CTCCGCATT
GAGCGACTC.CTTCACTGT	GAGCGACTC.CTTCACTGT
GAGCGACTC.GCTACAATG	GAGCGACTC.GCTACAATG
GAGCGACTC.GGAAGTATG	GAGCGACTC.GGAAGTATG
GAGCGACTC.TACTAGTAG	GAGCGACTC.TACTAGTAG
GAGCTCTCA.AGGTACCAA	GAGCTCTCA.AGGTACCAA
GAGCTCTCA.ATTATGCAG	GAGCTCTCA.ATTATGCAG
GAGCTCTCA.TAAGGTGAT	GAGCTCTCA.TAAGGTGAT
GAGCTCTCA.TATGATGTG	GAGCTCTCA.TATGATGTG
GAGCTCTCA.TCAGACAAG	GAGCTCTCA.TCAGACAAG
GAGCTCTCA.TGCGACGTT	GAGCTCTCA.TGCGACGTT
GAGCTCTCA.TGGAGAACC	GAGCTCTCA.TGGAGAACC
GAGGACTTA.CCACGTTCT	GAGGACTTA.CCACGTTCT
GAGGACTTA.CGAGTAGCA	GAGGACTTA.CGAGTAGCA
GAGGACTTA.TGCTCACAC	GAGGACTTA.TGCTCACAC
GAGGTCACG.AACGGAGAT	GAGGTCACG.AACGGAGAT
GAGGTCACG.AAGCCACAC	GAGGTCACG.AAGCCACAC
GAGGTCACG.AATTAGAGG	GAGGTCACG.AATTAGAGG
GAGGTCACG.ACCATCTAA	GAGGTCACG.ACCATCTAA
GAGGTCACG.ACTGTAATC	GAGGTCACG.ACTGTAATC
GAGGTCCTT.ACCGAGTAG	GAGGTCCTT.ACCGAGTAG
GAGGTCCTT.ACTCTAGGA	GAGGTCCTT.ACTCTAGGA
GAGGTCCTT.CTAGAGGTA	GAGGTCCTT.CTAGAGGTA
GAGGTCCTT.CTGGACACT	GAGGTCCTT.CTGGACACT
GAGGTCCTT.CTGTAGAAG	GAGGTCCTT.CTGTAGAAG
GAGGTCCTT.GTTCCAACA	GAGGTCCTT.GTTCCAACA
GAGGTCCTT.TTCACTGGA	GAGGTCCTT.TTCACTGGA
GAGGTGAGC.AGCATTCCA	GAGGTGAGC.AGCATTCCA
GAGGTGAGC.CCAACGGAA	GAGGTGAGC.CCAACGGAA
GAGGTGAGC.GCGCTCTAT	GAGGTGAGC.GCGCTCTAT
GAGTATCGC.GTATCCTGC	GAGTATCGC.GTATCCTGC
GAGTCAAGG.AATGCTATC	GAGTCAAGG.AATGCTATC
GAGTCAAGG.AGAGCGCGA	GAGTCAAGG.AGAGCGCGA
GAGTCAAGG.GGTTCAGAC	GAGTCAAGG.GGTTCAGAC
GAGTCAAGG.TCATATCGC	GAGTCAAGG.TCATATCGC
GAGTCAAGG.TCGGAACGA	GAGTCAAGG.TCGGAACGA
GAGTCAAGG.TTCCTAAGG	GAGTCAAGG.TTCCTAAGG
GAGTCACCA.AAGCTGAGG	GAGTCACCA.AAGCTGAGG
GAGTCACCA.CGAAGAGGT	GAGTCACCA.CGAAGAGGT
GAGTCACCA.CGACCATCA	GAGTCACCA.CGACCATCA
GAGTCACCA.GATCGCGAA	GAGTCACCA.GATCGCGAA
GAGTCACCA.TACCGATTG	GAGTCACCA.TACCGATTG
GAGTCACCA.TATCGAGCC	GAGTCACCA.TATCGAGCC
GAGTCACCA.TGCATCGGA	GAGTCACCA.TGCATCGGA
GAGTCCAAT.CACGCGTAA	GAGTCCAAT.CACGCGTAA
GAGTCCAAT.CCTTGACGG	GAGTCCAAT.CCTTGACGG
GAGTCCAAT.CTATACTAG	GAGTCCAAT.CTATACTAG
GAGTCCAAT.GTGCGAGTA	GAGTCCAAT.GTGCGAGTA
GAGTCCAAT.TGCTTACGG	GAGTCCAAT.TGCTTACGG
GAGTCGTAC.ACTGCTAGT	GAGTCGTAC.ACTGCTAGT
GAGTCGTAC.AGTCCAGTG	GAGTCGTAC.AGTCCAGTG
GAGTCGTAC.AGTTACAAG	GAGTCGTAC.AGTTACAAG
GAGTCGTAC.CGAGCCGTT	GAGTCGTAC.CGAGCCGTT
GAGTCGTAC.GATAAGCTG	GAGTCGTAC.GATAAGCTG
GAGTCGTAC.GCCTTAGAG	GAGTCGTAC.GCCTTAGAG
GAGTCGTAC.GCTTGTCCT	GAGTCGTAC.GCTTGTCCT
GAGTCGTAC.GTGAATGCC	GAGTCGTAC.GTGAATGCC
GAGTCGTAC.TACACGGTC	GAGTCGTAC.TACACGGTC
GAGTCTTCG.AGGATGCGT	GAGTCTTCG.AGGATGCGT
GAGTCTTCG.CGAACAGAG	GAGTCTTCG.CGAACAGAG
GAGTCTTCG.CTGTTACCA	GAGTCTTCG.CTGTTACCA
GAGTCTTCG.TTCTGGTGC	GAGTCTTCG.TTCTGGTGC
GAGTGCATA.AATATCAGC	GAGTGCATA.AATATCAGC
GAGTGCATA.AATTAGAGG	GAGTGCATA.AATTAGAGG
GAGTGCATA.ACCACGCTA	GAGTGCATA.ACCACGCTA
GAGTGCATA.ACCACTAGG	GAGTGCATA.ACCACTAGG
GAGTGCATA.AGGTATTCC	GAGTGCATA.AGGTATTCC
GAGTGCATA.ATAACGACA	GAGTGCATA.ATAACGACA
GAGTGCATA.ATTGCCGAC	GAGTGCATA.ATTGCCGAC
GAGTGCATA.CCAGTCTCA	GAGTGCATA.CCAGTCTCA
GAGTGCATA.CCTCTTGTA	GAGTGCATA.CCTCTTGTA
GAGTGCATA.GATCTACTT	GAGTGCATA.GATCTACTT
GAGTGCATA.GCAGCGATA	GAGTGCATA.GCAGCGATA
GAGTGCATA.GTCCTTCAT	GAGTGCATA.GTCCTTCAT
GAGTGCATA.TCGCGTCAT	GAGTGCATA.TCGCGTCAT
GAGTGCATA.TCGGACAGT	GAGTGCATA.TCGGACAGT
GAGTGCATA.TGGATAGGT	GAGTGCATA.TGGATAGGT
GAGTGTGCC.AATAACTCC	GAGTGTGCC.AATAACTCC
GAGTGTGCC.ACATGACTA	GAGTGTGCC.ACATGACTA
GAGTGTGCC.CCAACAACA	GAGTGTGCC.CCAACAACA
GAGTGTGCC.CTTAAGTTG	GAGTGTGCC.CTTAAGTTG
GAGTGTGCC.GAATCGAGA	GAGTGTGCC.GAATCGAGA
GAGTGTGCC.TATGACCGA	GAGTGTGCC.TATGACCGA
GAGTGTGCC.TCGTAATAG	GAGTGTGCC.TCGTAATAG
GAGTTAACT.ATAATGTGG	GAGTTAACT.ATAATGTGG
GAGTTAACT.CCTGACCTC	GAGTTAACT.CCTGACCTC
GAGTTAACT.CGAAGAGGT	GAGTTAACT.CGAAGAGGT
GAGTTAACT.GAGATACAC	GAGTTAACT.GAGATACAC
GAGTTAACT.GATTCTCGG	GAGTTAACT.GATTCTCGG
GAGTTAACT.TCCTCGTCG	GAGTTAACT.TCCTCGTCG
GAGTTAACT.TGATCGGAA	GAGTTAACT.TGATCGGAA
GAGTTATAG.AAGACTACC	GAGTTATAG.AAGACTACC
GAGTTATAG.CACCAGAAG	GAGTTATAG.CACCAGAAG
GAGTTATAG.CATGCCAGT	GAGTTATAG.CATGCCAGT
GATAACGTC.CGCACTCTT	GATAACGTC.CGCACTCTT
GATAACGTC.GAACATGAC	GATAACGTC.GAACATGAC
GATAACGTC.TAACTCCGA	GATAACGTC.TAACTCCGA
GATAACGTC.TGATGGACA	GATAACGTC.TGATGGACA
GATAACGTC.TGTCTACAC	GATAACGTC.TGTCTACAC
GATAACGTC.TGTGCAGTA	GATAACGTC.TGTGCAGTA
GATAAGCTG.AGAGCGCGA	GATAAGCTG.AGAGCGCGA
GATAAGCTG.AGCCTCTAG	GATAAGCTG.AGCCTCTAG
GATAAGCTG.CAACCTGGT	GATAAGCTG.CAACCTGGT
GATAAGCTG.CAATCTCCG	GATAAGCTG.CAATCTCCG
GATAAGCTG.CGCTTCACG	GATAAGCTG.CGCTTCACG
GATAAGCTG.GCTGATGTC	GATAAGCTG.GCTGATGTC
GATAAGCTG.GGTACGAGC	GATAAGCTG.GGTACGAGC
GATAAGCTG.TGGAACTAA	GATAAGCTG.TGGAACTAA
GATACACTA.CAGATCATT	GATACACTA.CAGATCATT
GATACACTA.CCTCGGTCA	GATACACTA.CCTCGGTCA
GATACACTA.GAGAATCAG	GATACACTA.GAGAATCAG
GATACACTA.GGACGAGCA	GATACACTA.GGACGAGCA
GATACACTA.GTCAGACCG	GATACACTA.GTCAGACCG
GATACACTA.TACCTCACT	GATACACTA.TACCTCACT
GATACACTA.TAGCCAGTG	GATACACTA.TAGCCAGTG
GATACCGGA.CCATATGCC	GATACCGGA.CCATATGCC
GATACCGGA.GATCTGAAT	GATACCGGA.GATCTGAAT
GATACCGGA.GCGATGGTG	GATACCGGA.GCGATGGTG
GATACCGGA.TCAGCGACC	GATACCGGA.TCAGCGACC
GATACCGGA.TGTTACTGA	GATACCGGA.TGTTACTGA
GATACTGTG.AAGGATACG	GATACTGTG.AAGGATACG
GATACTGTG.TCAACACTC	GATACTGTG.TCAACACTC
GATACTGTG.TCAATGGAC	GATACTGTG.TCAATGGAC
GATACTGTG.TGAACCAAT	GATACTGTG.TGAACCAAT
GATAGTTCT.ACGCACACT	GATAGTTCT.ACGCACACT
GATAGTTCT.CATGGTTAC	GATAGTTCT.CATGGTTAC
GATAGTTCT.CGAATCCTG	GATAGTTCT.CGAATCCTG
GATAGTTCT.GCTTACGTT	GATAGTTCT.GCTTACGTT
GATATATCC.AGATGTTGG	GATATATCC.AGATGTTGG
GATATATCC.CCGCAGAAT	GATATATCC.CCGCAGAAT
GATATATCC.CCGCAGCTA	GATATATCC.CCGCAGCTA
GATATATCC.TCGTGACGT	GATATATCC.TCGTGACGT
GATATGGAC.CAGTGCTGC	GATATGGAC.CAGTGCTGC
GATATGGAC.CATACAACC	GATATGGAC.CATACAACC
GATATGGAC.GTGGAGGTC	GATATGGAC.GTGGAGGTC
GATATGGAC.TACGGTCGT	GATATGGAC.TACGGTCGT
GATATGGAC.TTCAACTAC	GATATGGAC.TTCAACTAC
GATCCGCAC.AAGGATACG	GATCCGCAC.AAGGATACG
GATCCGCAC.GGTCTCATG	GATCCGCAC.GGTCTCATG
GATCCGCAC.TCACGCGAC	GATCCGCAC.TCACGCGAC
GATCCGCAC.TCCTCTAGT	GATCCGCAC.TCCTCTAGT
GATCCGCAC.TTCGGAGTC	GATCCGCAC.TTCGGAGTC
GATCGATAC.AACAATGCA	GATCGATAC.AACAATGCA
GATCGATAC.CGCGAGTGT	GATCGATAC.CGCGAGTGT
GATCGATAC.CGTTCGTAC	GATCGATAC.CGTTCGTAC
GATCGATAC.CTCTACGCA	GATCGATAC.CTCTACGCA
GATCGATAC.CTTACATGC	GATCGATAC.CTTACATGC
GATCGATAC.GAAGGATCA	GATCGATAC.GAAGGATCA
GATCGATAC.GACTTCACC	GATCGATAC.GACTTCACC
GATCGATAC.TGTAGCAAG	GATCGATAC.TGTAGCAAG
GATCGCACT.CAGCTCTTC	GATCGCACT.CAGCTCTTC
GATCGCACT.GGTTGCTAT	GATCGCACT.GGTTGCTAT
GATCGCGAA.ACCGTACGC	GATCGCGAA.ACCGTACGC
GATCGCGAA.ATGCGCCGT	GATCGCGAA.ATGCGCCGT
GATCGCGAA.CACATTCTG	GATCGCGAA.CACATTCTG
GATCGCGAA.CCAGATCAC	GATCGCGAA.CCAGATCAC
GATCGCGAA.CCTAAGTCT	GATCGCGAA.CCTAAGTCT
GATCGCGAA.GAATTGTTG	GATCGCGAA.GAATTGTTG
GATCGCGAA.GATTATGCG	GATCGCGAA.GATTATGCG
GATCGCGAA.GTCATTCTA	GATCGCGAA.GTCATTCTA
GATCGCGAA.GTCCGCTCA	GATCGCGAA.GTCCGCTCA
GATCGCGAA.TACATGCAC	GATCGCGAA.TACATGCAC
GATCGCGAA.TGGAAGATT	GATCGCGAA.TGGAAGATT
GATCGTTGA.ATTCGCTTA	GATCGTTGA.ATTCGCTTA
GATCGTTGA.CGTGTGTGG	GATCGTTGA.CGTGTGTGG
GATCGTTGA.GAACTGCAA	GATCGTTGA.GAACTGCAA
GATCGTTGA.GTCTCTTCA	GATCGTTGA.GTCTCTTCA
GATCTACTT.CGGTTGCGA	GATCTACTT.CGGTTGCGA
GATCTACTT.GATTCCTCT	GATCTACTT.GATTCCTCT
GATCTACTT.GGAATTCAC	GATCTACTT.GGAATTCAC
GATCTACTT.TCTCCGCGT	GATCTACTT.TCTCCGCGT
GATCTACTT.TTAACGTTC	GATCTACTT.TTAACGTTC
GATCTAGAG.AATGTGCGT	GATCTAGAG.AATGTGCGT
GATCTAGAG.AGTCGTCCG	GATCTAGAG.AGTCGTCCG
GATCTAGAG.CGACCATCA	GATCTAGAG.CGACCATCA
GATCTAGAG.CTGCAGAGC	GATCTAGAG.CTGCAGAGC
GATCTGAAT.CAAGAGAGT	GATCTGAAT.CAAGAGAGT
GATCTGAAT.CGCAACCTC	GATCTGAAT.CGCAACCTC
GATCTGAAT.GCTACAATG	GATCTGAAT.GCTACAATG
GATCTGAAT.TCCAGCAGC	GATCTGAAT.TCCAGCAGC
GATCTGAAT.TCCTTAGGT	GATCTGAAT.TCCTTAGGT
GATCTGAAT.TGCAACTCT	GATCTGAAT.TGCAACTCT
GATCTGAAT.TTATCCAAG	GATCTGAAT.TTATCCAAG
GATCTGTTC.ACGCTCTTA	GATCTGTTC.ACGCTCTTA
GATCTTCGC.AACTTAGCT	GATCTTCGC.AACTTAGCT
GATCTTCGC.ACGCAAGAT	GATCTTCGC.ACGCAAGAT
GATCTTCGC.CCGCATCCT	GATCTTCGC.CCGCATCCT
GATCTTCGC.CTCGACTGC	GATCTTCGC.CTCGACTGC
GATCTTCGC.GCCTTAGAG	GATCTTCGC.GCCTTAGAG
GATCTTCGC.TCTTAGCGA	GATCTTCGC.TCTTAGCGA
GATCTTCGC.TGATACCGT	GATCTTCGC.TGATACCGT
GATGCAGAA.AGCATTCCA	GATGCAGAA.AGCATTCCA
GATGCAGAA.CAAGAACCG	GATGCAGAA.CAAGAACCG
GATGCAGAA.CCACTTCGC	GATGCAGAA.CCACTTCGC
GATGCAGAA.GACCGTAGT	GATGCAGAA.GACCGTAGT
GATGCAGAA.GCACGCATT	GATGCAGAA.GCACGCATT
GATGCGACG.CTCGAACTG	GATGCGACG.CTCGAACTG
GATGCGACG.TATTACTCG	GATGCGACG.TATTACTCG
GATGCGACG.TGGTGGTAA	GATGCGACG.TGGTGGTAA
GATGCGGTT.ACGTGCTCG	GATGCGGTT.ACGTGCTCG
GATGCGGTT.CACGATAGA	GATGCGGTT.CACGATAGA
GATGCGGTT.CCGAGCTGA	GATGCGGTT.CCGAGCTGA
GATGCGGTT.GTCGTGTTA	GATGCGGTT.GTCGTGTTA
GATGCGGTT.TGCCGAACT	GATGCGGTT.TGCCGAACT
GATGCTCCT.ATACAACCG	GATGCTCCT.ATACAACCG
GATGCTCCT.TCAAGCGTA	GATGCTCCT.TCAAGCGTA
GATGCTCCT.TCGCTGTAA	GATGCTCCT.TCGCTGTAA
GATGTAAGG.ATAACGACA	GATGTAAGG.ATAACGACA
GATGTAAGG.CACTTCCTT	GATGTAAGG.CACTTCCTT
GATGTAAGG.GCTCTCCAA	GATGTAAGG.GCTCTCCAA
GATGTCTAG.ATTCTCTGG	GATGTCTAG.ATTCTCTGG
GATGTCTAG.CTGGACACT	GATGTCTAG.CTGGACACT
GATGTCTAG.GACGCTTGC	GATGTCTAG.GACGCTTGC
GATGTCTAG.GCATTGATC	GATGTCTAG.GCATTGATC
GATGTCTAG.TAACATTGG	GATGTCTAG.TAACATTGG
GATGTCTAG.TCCATCATT	GATGTCTAG.TCCATCATT
GATGTTACA.AATGCAGCG	GATGTTACA.AATGCAGCG
GATGTTACA.ACAATTCGG	GATGTTACA.ACAATTCGG
GATGTTACA.ACTCTAGGA	GATGTTACA.ACTCTAGGA
GATGTTACA.CCGCATCCT	GATGTTACA.CCGCATCCT
GATGTTACA.GATCTAGAG	GATGTTACA.GATCTAGAG
GATGTTACA.TGATAGAGG	GATGTTACA.TGATAGAGG
GATTAGACA.ACATCGTCC	GATTAGACA.ACATCGTCC
GATTAGACA.ACTATCCTG	GATTAGACA.ACTATCCTG
GATTAGACA.CACATTCTG	GATTAGACA.CACATTCTG
GATTAGACA.CATACAACC	GATTAGACA.CATACAACC
GATTAGACA.GAGACATTG	GATTAGACA.GAGACATTG
GATTAGACA.GATGCGGTT	GATTAGACA.GATGCGGTT
GATTAGACA.GCTTAGAAC	GATTAGACA.GCTTAGAAC
GATTAGACA.GTCCGCTCA	GATTAGACA.GTCCGCTCA
GATTAGACA.GTCGACATT	GATTAGACA.GTCGACATT
GATTAGACA.TAAGGTCCG	GATTAGACA.TAAGGTCCG
GATTAGTGT.AGTACTCTC	GATTAGTGT.AGTACTCTC
GATTAGTGT.CCGCAACAC	GATTAGTGT.CCGCAACAC
GATTAGTGT.CGGTTCGTA	GATTAGTGT.CGGTTCGTA
GATTAGTGT.GCACGCATT	GATTAGTGT.GCACGCATT
GATTATGCG.AGTAAGCCA	GATTATGCG.AGTAAGCCA
GATTATGCG.CACCTCAAC	GATTATGCG.CACCTCAAC
GATTATGCG.CAGTTACTG	GATTATGCG.CAGTTACTG
GATTATGCG.CGCCTGCAA	GATTATGCG.CGCCTGCAA
GATTATGCG.GTCGAGTAC	GATTATGCG.GTCGAGTAC
GATTCCTCT.TCCGATAAC	GATTCCTCT.TCCGATAAC
GATTCTCGG.AGCAAGTCC	GATTCTCGG.AGCAAGTCC
GATTCTCGG.AGTCGCCGA	GATTCTCGG.AGTCGCCGA
GATTCTCGG.ATTCCTACG	GATTCTCGG.ATTCCTACG
GATTCTCGG.CAGCACGTG	GATTCTCGG.CAGCACGTG
GATTCTCGG.GCACATGTT	GATTCTCGG.GCACATGTT
GATTCTCGG.GGTCTTGCA	GATTCTCGG.GGTCTTGCA
GATTCTCGG.GTCACAGAG	GATTCTCGG.GTCACAGAG
GATTCTCGG.TATCAGTGC	GATTCTCGG.TATCAGTGC
GATTCTCGG.TTCTGAATG	GATTCTCGG.TTCTGAATG
GATTGAGTA.ACTGTGTCA	GATTGAGTA.ACTGTGTCA
GATTGAGTA.AGGATTACT	GATTGAGTA.AGGATTACT
GATTGAGTA.CACGGAAGT	GATTGAGTA.CACGGAAGT
GATTGAGTA.GACTCTCAC	GATTGAGTA.GACTCTCAC
GATTGAGTA.TAACGGATA	GATTGAGTA.TAACGGATA
GATTGGAAG.ATAATCGAG	GATTGGAAG.ATAATCGAG
GATTGGAAG.GAGATTCCT	GATTGGAAG.GAGATTCCT
GATTGGAAG.TGCGTGCCA	GATTGGAAG.TGCGTGCCA
GATTGGAAG.TGTTAAGCC	GATTGGAAG.TGTTAAGCC
GCAACACCT.AACGTTCTT	GCAACACCT.AACGTTCTT
GCAACACCT.CAGCACGTG	GCAACACCT.CAGCACGTG
GCAACACCT.GGATGCTCG	GCAACACCT.GGATGCTCG
GCAACACCT.GTTATCGAT	GCAACACCT.GTTATCGAT
GCAACACCT.TAAGCACTA	GCAACACCT.TAAGCACTA
GCAACACCT.TACCATGTA	GCAACACCT.TACCATGTA
GCAACACCT.TTCCAGATT	GCAACACCT.TTCCAGATT
GCAACCAAC.AATTGGTGA	GCAACCAAC.AATTGGTGA
GCAACCAAC.ATCATAGAC	GCAACCAAC.ATCATAGAC
GCAACCAAC.GAATCGAGA	GCAACCAAC.GAATCGAGA
GCAACCAAC.GCTACAATG	GCAACCAAC.GCTACAATG
GCAACCAAC.TAGACCGCA	GCAACCAAC.TAGACCGCA
GCAACCAAC.TGGAACTAA	GCAACCAAC.TGGAACTAA
GCAACCAAC.TGGTGCCTG	GCAACCAAC.TGGTGCCTG
GCAACCAAC.TGGTTATAC	GCAACCAAC.TGGTTATAC
GCAACTCGC.CCTGTTAGC	GCAACTCGC.CCTGTTAGC
GCAACTCGC.CGAATGAGT	GCAACTCGC.CGAATGAGT
GCAACTCGC.CGGTGAGTC	GCAACTCGC.CGGTGAGTC
GCAACTCGC.CTTCCGTGG	GCAACTCGC.CTTCCGTGG
GCAACTCGC.GAGCTCTCA	GCAACTCGC.GAGCTCTCA
GCAACTCGC.TAGGTCAAC	GCAACTCGC.TAGGTCAAC
GCAATCACG.AGTCGATCA	GCAATCACG.AGTCGATCA
GCAATCACG.AGTTGTGTA	GCAATCACG.AGTTGTGTA
GCAATCACG.CCTCGAGAG	GCAATCACG.CCTCGAGAG
GCAATCACG.GCGTGAGCT	GCAATCACG.GCGTGAGCT
GCAATCACG.TTCATCCAA	GCAATCACG.TTCATCCAA
GCAATGAGA.AACAATGCA	GCAATGAGA.AACAATGCA
GCAATGAGA.AAGGATCGT	GCAATGAGA.AAGGATCGT
GCAATGAGA.AATTCGGAA	GCAATGAGA.AATTCGGAA
GCAATGAGA.GTATGCCTT	GCAATGAGA.GTATGCCTT
GCAATGAGA.TACATGCAC	GCAATGAGA.TACATGCAC
GCACAACTC.AATGTGCGT	GCACAACTC.AATGTGCGT
GCACAACTC.AGGTGTACA	GCACAACTC.AGGTGTACA
GCACAACTC.CCTGTCGAC	GCACAACTC.CCTGTCGAC
GCACAACTC.TGATAGAGG	GCACAACTC.TGATAGAGG
GCACAACTC.TGGTCGCTA	GCACAACTC.TGGTCGCTA
GCACAGTAA.ACCTGTACC	GCACAGTAA.ACCTGTACC
GCACAGTAA.ACGACGATT	GCACAGTAA.ACGACGATT
GCACAGTAA.AGACCACGC	GCACAGTAA.AGACCACGC
GCACAGTAA.AGGAATTGG	GCACAGTAA.AGGAATTGG
GCACAGTAA.CCTGCGTTA	GCACAGTAA.CCTGCGTTA
GCACAGTAA.CTTCACTGT	GCACAGTAA.CTTCACTGT
GCACAGTAA.GACCGCTTC	GCACAGTAA.GACCGCTTC
GCACAGTAA.GATTGAGTA	GCACAGTAA.GATTGAGTA
GCACAGTAA.GTAAGTGAG	GCACAGTAA.GTAAGTGAG
GCACAGTAA.TGACGGTTG	GCACAGTAA.TGACGGTTG
GCACAGTAA.TGTCAACCT	GCACAGTAA.TGTCAACCT
