AACAACCTA.GACATATGT	AACAACCTA.GACATATGT
AACAACCTA.TGCGCTGCA	AACAACCTA.TGCGCTGCA
AACAACCTA.TTGCAGTCA	AACAACCTA.TTGCAGTCA
AACAACTGG.AATCTCCTA	AACAACTGG.AATCTCCTA
AACAACTGG.CGTACATCT	AACAACTGG.CGTACATCT
AACAACTGG.TACAAGAGG	AACAACTGG.TACAAGAGG
AACAACTGG.TTGGACTTC	AACAACTGG.TTGGACTTC
AACAATGCA.AAGCCAAGT	AACAATGCA.AAGCCAAGT
AACAATGCA.AAGCTGGTC	AACAATGCA.AAGCTGGTC
AACAATGCA.CGTTACACC	AACAATGCA.CGTTACACC
AACAATGCA.GGTACTTCC	AACAATGCA.GGTACTTCC
AACAATGCA.GGTTAACAG	AACAATGCA.GGTTAACAG
AACAATGCA.GTTACTACT	AACAATGCA.GTTACTACT
AACAATGCA.TGCCAGACG	AACAATGCA.TGCCAGACG
AACACACTC.AAGCTGGTC	AACACACTC.AAGCTGGTC
AACACACTC.CCTAGAGTA	AACACACTC.CCTAGAGTA
AACAGATCG.CACAATAAC	AACAGATCG.CACAATAAC
AACAGATCG.CCGAATATG	AACAGATCG.CCGAATATG
AACAGATCG.CCTGACCTC	AACAGATCG.CCTGACCTC
AACAGATCG.CGACCATCA	AACAGATCG.CGACCATCA
AACAGATCG.GATACTGTG	AACAGATCG.GATACTGTG
AACAGATCG.GCGGTAGTC	AACAGATCG.GCGGTAGTC
AACAGATCG.TAGTCGCAT	AACAGATCG.TAGTCGCAT
AACAGATCG.TCTACAGTT	AACAGATCG.TCTACAGTT
AACAGATCG.TTGTTAGAG	AACAGATCG.TTGTTAGAG
AACAGCAGT.AGAGGTGAA	AACAGCAGT.AGAGGTGAA
AACAGCAGT.AGCCACTTC	AACAGCAGT.AGCCACTTC
AACAGCAGT.CTTAGGACT	AACAGCAGT.CTTAGGACT
AACAGCAGT.GTACCTAAC	AACAGCAGT.GTACCTAAC
AACAGCAGT.GTGCGAGTA	AACAGCAGT.GTGCGAGTA
AACAGCAGT.TACCGATTG	AACAGCAGT.TACCGATTG
AACCATGGT.ATGATAGCT	AACCATGGT.ATGATAGCT
AACCATGGT.CACCAGAAG	AACCATGGT.CACCAGAAG
AACCATGGT.CGATCCAGA	AACCATGGT.CGATCCAGA
AACCATGGT.GGTTGAAGG	AACCATGGT.GGTTGAAGG
AACCGCTGA.AATCTCCTA	AACCGCTGA.AATCTCCTA
AACCGCTGA.ATTCATGTG	AACCGCTGA.ATTCATGTG
AACCGCTGA.CTGTCACTT	AACCGCTGA.CTGTCACTT
AACCGCTGA.GAGGTGAGC	AACCGCTGA.GAGGTGAGC
AACCGTGAG.ATGAGTGTG	AACCGTGAG.ATGAGTGTG
AACCGTGAG.GGATCGTTC	AACCGTGAG.GGATCGTTC
AACCGTGAG.GTACAATGC	AACCGTGAG.GTACAATGC
AACGAGAAT.ACGCTCTTA	AACGAGAAT.ACGCTCTTA
AACGAGAAT.AGTGAACGG	AACGAGAAT.AGTGAACGG
AACGAGAAT.CAAGTCGAA	AACGAGAAT.CAAGTCGAA
AACGAGAAT.CCATACGAT	AACGAGAAT.CCATACGAT
AACGAGAAT.CGCGTACTA	AACGAGAAT.CGCGTACTA
AACGAGAAT.TCGGATGTT	AACGAGAAT.TCGGATGTT
AACGAGGTG.ACTATCCTG	AACGAGGTG.ACTATCCTG
AACGAGGTG.AGCCAGGAC	AACGAGGTG.AGCCAGGAC
AACGAGGTG.CCACGGATC	AACGAGGTG.CCACGGATC
AACGAGGTG.GTCGACATT	AACGAGGTG.GTCGACATT
AACGAGGTG.GTGGAGGTC	AACGAGGTG.GTGGAGGTC
AACGATGAC.ACGCACACT	AACGATGAC.ACGCACACT
AACGATGAC.ACTCCGTCG	AACGATGAC.ACTCCGTCG
AACGATGAC.ATCCTCCGA	AACGATGAC.ATCCTCCGA
AACGATGAC.CTGAGTAGC	AACGATGAC.CTGAGTAGC
AACGATGAC.CTGGTCGGT	AACGATGAC.CTGGTCGGT
AACGATGAC.CTTGCGACC	AACGATGAC.CTTGCGACC
AACGATGAC.TTCCTAAGG	AACGATGAC.TTCCTAAGG
AACGCATTG.AGAAGTCCT	AACGCATTG.AGAAGTCCT
AACGCATTG.CATGCCAGT	AACGCATTG.CATGCCAGT
AACGCATTG.CCAACGGAA	AACGCATTG.CCAACGGAA
AACGCATTG.CCACGTTCT	AACGCATTG.CCACGTTCT
AACGCATTG.CCATTACAG	AACGCATTG.CCATTACAG
AACGCATTG.TACCATGTA	AACGCATTG.TACCATGTA
AACGCATTG.TCTGTGAAG	AACGCATTG.TCTGTGAAG
AACGCATTG.TTACACCTT	AACGCATTG.TTACACCTT
AACGCCTAC.ATCGTAGTG	AACGCCTAC.ATCGTAGTG
AACGCCTAC.ATGCGTGGA	AACGCCTAC.ATGCGTGGA
AACGCCTAC.CATCCTCTC	AACGCCTAC.CATCCTCTC
AACGCCTAC.CGACAGACC	AACGCCTAC.CGACAGACC
AACGCCTAC.CTACCTGCG	AACGCCTAC.CTACCTGCG
AACGCCTAC.GTCAACTGA	AACGCCTAC.GTCAACTGA
AACGCTCAA.AAGAGAGAG	AACGCTCAA.AAGAGAGAG
AACGCTCAA.ACATTCCAC	AACGCTCAA.ACATTCCAC
AACGCTCAA.ATGCCTTCA	AACGCTCAA.ATGCCTTCA
AACGCTCAA.CCACTTCGC	AACGCTCAA.CCACTTCGC
AACGCTCAA.CGAGCTTAC	AACGCTCAA.CGAGCTTAC
AACGCTCAA.CTGCTGCTT	AACGCTCAA.CTGCTGCTT
AACGCTCAA.GTGCCATGA	AACGCTCAA.GTGCCATGA
AACGCTCAA.TCAGGACTG	AACGCTCAA.TCAGGACTG
AACGCTCAA.TGACCTCCT	AACGCTCAA.TGACCTCCT
AACGGAGAT.AGAGAGTGG	AACGGAGAT.AGAGAGTGG
AACGGAGAT.CAGTCTAAC	AACGGAGAT.CAGTCTAAC
AACGGAGAT.CGAGTAGCA	AACGGAGAT.CGAGTAGCA
AACGGAGAT.CTACGTTGG	AACGGAGAT.CTACGTTGG
AACGGAGAT.GGAGTTAGC	AACGGAGAT.GGAGTTAGC
AACGGAGAT.GGTGTTCAT	AACGGAGAT.GGTGTTCAT
AACGGAGAT.GTCTTCTCG	AACGGAGAT.GTCTTCTCG
AACGGTAGC.ATGCTGTCG	AACGGTAGC.ATGCTGTCG
AACGGTAGC.CCTTAATTC	AACGGTAGC.CCTTAATTC
AACGGTAGC.GTCAAGATC	AACGGTAGC.GTCAAGATC
AACGGTAGC.TAACACATC	AACGGTAGC.TAACACATC
AACGTCGAG.ACGCTAGTG	AACGTCGAG.ACGCTAGTG
AACGTCGAG.ATTGGTTCC	AACGTCGAG.ATTGGTTCC
AACGTCGAG.CGATACTCT	AACGTCGAG.CGATACTCT
AACGTCGAG.CGTCTGCTG	AACGTCGAG.CGTCTGCTG
AACGTCGAG.TGCCACCGA	AACGTCGAG.TGCCACCGA
AACGTTCTT.AAGTCATGA	AACGTTCTT.AAGTCATGA
AACGTTCTT.CTTCCGTGG	AACGTTCTT.CTTCCGTGG
AACGTTCTT.GATGTTACA	AACGTTCTT.GATGTTACA
AACGTTCTT.TGTGAGTAT	AACGTTCTT.TGTGAGTAT
AACGTTCTT.TGTGTCTAC	AACGTTCTT.TGTGTCTAC
AACTAACTG.ACTAAGTTC	AACTAACTG.ACTAAGTTC
AACTAACTG.TGTGTCTAC	AACTAACTG.TGTGTCTAC
AACTCCATG.CCATAGCCA	AACTCCATG.CCATAGCCA
AACTCCATG.CTCAGGTAC	AACTCCATG.CTCAGGTAC
AACTCCATG.TCGCGTCAT	AACTCCATG.TCGCGTCAT
AACTCCATG.TTAAGTGGT	AACTCCATG.TTAAGTGGT
AACTGATTC.AAGCTGGTC	AACTGATTC.AAGCTGGTC
AACTGATTC.AGCACCAGC	AACTGATTC.AGCACCAGC
AACTGATTC.AGCATATGG	AACTGATTC.AGCATATGG
AACTGATTC.CACTCACTA	AACTGATTC.CACTCACTA
AACTGATTC.GTGCACGAG	AACTGATTC.GTGCACGAG
AACTGATTC.TCGTAATAG	AACTGATTC.TCGTAATAG
AACTGCGAC.ACTCGTAGG	AACTGCGAC.ACTCGTAGG
AACTGCGAC.AGTAATGGT	AACTGCGAC.AGTAATGGT
AACTGCGAC.ATGTGAGAC	AACTGCGAC.ATGTGAGAC
AACTGCGAC.GATACTGTG	AACTGCGAC.GATACTGTG
AACTGCGAC.TGCAGTTCA	AACTGCGAC.TGCAGTTCA
AACTTAGCT.AACCATGGT	AACTTAGCT.AACCATGGT
AACTTAGCT.AACGGAGAT	AACTTAGCT.AACGGAGAT
AACTTAGCT.CCGCTATCC	AACTTAGCT.CCGCTATCC
AACTTAGCT.CCTCGAGAG	AACTTAGCT.CCTCGAGAG
AACTTAGCT.CGTAATGAC	AACTTAGCT.CGTAATGAC
AACTTAGCT.GTGACTCTC	AACTTAGCT.GTGACTCTC
AACTTAGCT.GTGGACTGG	AACTTAGCT.GTGGACTGG
AACTTAGCT.TCGTGACGT	AACTTAGCT.TCGTGACGT
AACTTCTGC.GCGATGGTG	AACTTCTGC.GCGATGGTG
AACTTCTGC.TATCATGCT	AACTTCTGC.TATCATGCT
AACTTGTCG.ACCGACGGT	AACTTGTCG.ACCGACGGT
AACTTGTCG.CGAGCCGTT	AACTTGTCG.CGAGCCGTT
AACTTGTCG.CTCTCGATA	AACTTGTCG.CTCTCGATA
AACTTGTCG.GAGCATACA	AACTTGTCG.GAGCATACA
AACTTGTCG.TAGACACGT	AACTTGTCG.TAGACACGT
AAGACGAAG.AGATCTTCA	AAGACGAAG.AGATCTTCA
AAGACGAAG.AGCGCATGA	AAGACGAAG.AGCGCATGA
AAGACGAAG.ATATCCGAT	AAGACGAAG.ATATCCGAT
AAGACGAAG.CACCTAGCG	AAGACGAAG.CACCTAGCG
AAGACGAAG.CCATACGAT	AAGACGAAG.CCATACGAT
AAGACGAAG.CCGATCTCT	AAGACGAAG.CCGATCTCT
AAGACGAAG.CGTATAGCG	AAGACGAAG.CGTATAGCG
AAGACGAAG.CTGCTGCTT	AAGACGAAG.CTGCTGCTT
AAGACGAAG.GAACTGCAA	AAGACGAAG.GAACTGCAA
AAGACGAAG.GAGTCGTAC	AAGACGAAG.GAGTCGTAC
AAGACGAAG.TCATCATCT	AAGACGAAG.TCATCATCT
AAGACGAAG.TGATTGTGC	AAGACGAAG.TGATTGTGC
AAGACTACC.CTGGTAATC	AAGACTACC.CTGGTAATC
AAGACTACC.GCCTTAGAG	AAGACTACC.GCCTTAGAG
AAGACTACC.GCTACAATG	AAGACTACC.GCTACAATG
AAGACTGGT.CGCACTGAA	AAGACTGGT.CGCACTGAA
AAGACTGGT.CGTGTGTGG	AAGACTGGT.CGTGTGTGG
AAGACTGGT.CTGCAAGCC	AAGACTGGT.CTGCAAGCC
AAGACTGGT.GCGTAACAA	AAGACTGGT.GCGTAACAA
AAGACTGGT.GGTACTTCC	AAGACTGGT.GGTACTTCC
AAGACTGGT.TAGTGATCC	AAGACTGGT.TAGTGATCC
AAGACTGGT.TCTGCGCTG	AAGACTGGT.TCTGCGCTG
AAGAGAACT.AGGAGGTGA	AAGAGAACT.AGGAGGTGA
AAGAGAACT.GATCCGCAC	AAGAGAACT.GATCCGCAC
AAGAGAACT.GCACGCATT	AAGAGAACT.GCACGCATT
AAGAGAACT.GTCTTCTCG	AAGAGAACT.GTCTTCTCG
AAGAGAACT.TTAGGAAGG	AAGAGAACT.TTAGGAAGG
AAGAGAGAG.AACGTTCTT	AAGAGAGAG.AACGTTCTT
AAGAGAGAG.ACGTCGCTC	AAGAGAGAG.ACGTCGCTC
AAGAGAGAG.ACTGGACCA	AAGAGAGAG.ACTGGACCA
AAGAGAGAG.ATAGTCTCC	AAGAGAGAG.ATAGTCTCC
AAGAGAGAG.CTACGAGAA	AAGAGAGAG.CTACGAGAA
AAGAGAGAG.GAATAAGAG	AAGAGAGAG.GAATAAGAG
AAGAGAGAG.GATTAGTGT	AAGAGAGAG.GATTAGTGT
AAGAGAGAG.GCTTACTAG	AAGAGAGAG.GCTTACTAG
AAGAGAGAG.GGTAGCATC	AAGAGAGAG.GGTAGCATC
AAGAGAGAG.TGCCGAACT	AAGAGAGAG.TGCCGAACT
AAGCAACTA.CCGCAGCTA	AAGCAACTA.CCGCAGCTA
AAGCAACTA.CGAGCTTAC	AAGCAACTA.CGAGCTTAC
AAGCAACTA.GCTCAATGA	AAGCAACTA.GCTCAATGA
AAGCAACTA.GGTGGAGCT	AAGCAACTA.GGTGGAGCT
AAGCAACTA.GTAACGCGA	AAGCAACTA.GTAACGCGA
AAGCAACTA.TTAACGTTC	AAGCAACTA.TTAACGTTC
AAGCAATCG.AGCGGTAAG	AAGCAATCG.AGCGGTAAG
AAGCAATCG.AGTCCGTGT	AAGCAATCG.AGTCCGTGT
AAGCAATCG.CACGTCATA	AAGCAATCG.CACGTCATA
AAGCAATCG.CGTGAGACT	AAGCAATCG.CGTGAGACT
AAGCAATCG.CTTAGAAGG	AAGCAATCG.CTTAGAAGG
AAGCACAAC.ACATGACTA	AAGCACAAC.ACATGACTA
AAGCACAAC.CGGTTCTAT	AAGCACAAC.CGGTTCTAT
AAGCACAAC.GGACACTGG	AAGCACAAC.GGACACTGG
AAGCACAAC.TCAGACAAG	AAGCACAAC.TCAGACAAG
AAGCACAAC.TGTGAGTAT	AAGCACAAC.TGTGAGTAT
AAGCAGCAT.AGTAATCAG	AAGCAGCAT.AGTAATCAG
AAGCAGCAT.AGTGTGCAC	AAGCAGCAT.AGTGTGCAC
AAGCAGCAT.CACATGTGC	AAGCAGCAT.CACATGTGC
AAGCAGCAT.TAGTAGTCT	AAGCAGCAT.TAGTAGTCT
AAGCAGCAT.TGTCCATAG	AAGCAGCAT.TGTCCATAG
AAGCAGCAT.TTATGAGGA	AAGCAGCAT.TTATGAGGA
AAGCATTGC.ACTCCAACT	AAGCATTGC.ACTCCAACT
AAGCATTGC.AGCCGGATC	AAGCATTGC.AGCCGGATC
AAGCATTGC.CACATGTGC	AAGCATTGC.CACATGTGC
AAGCATTGC.CATTCAGTT	AAGCATTGC.CATTCAGTT
AAGCATTGC.GTAGACTCT	AAGCATTGC.GTAGACTCT
AAGCATTGC.GTCTTATGC	AAGCATTGC.GTCTTATGC
AAGCCAAGT.AATACCTTG	AAGCCAAGT.AATACCTTG
AAGCCAAGT.CCAAGTCGA	AAGCCAAGT.CCAAGTCGA
AAGCCAAGT.CCTATTCAA	AAGCCAAGT.CCTATTCAA
AAGCCAAGT.CGCTTGTAG	AAGCCAAGT.CGCTTGTAG
AAGCCAAGT.GAGATTCCT	AAGCCAAGT.GAGATTCCT
AAGCCAAGT.GTAGAAGTT	AAGCCAAGT.GTAGAAGTT
AAGCCAAGT.TAGCACTAT	AAGCCAAGT.TAGCACTAT
AAGCCACAC.AACGGAGAT	AAGCCACAC.AACGGAGAT
AAGCCACAC.AGGTACCAA	AAGCCACAC.AGGTACCAA
AAGCCACAC.AGTCCAGTG	AAGCCACAC.AGTCCAGTG
AAGCCACAC.ATTCACCTC	AAGCCACAC.ATTCACCTC
AAGCCACAC.CAGTACATC	AAGCCACAC.CAGTACATC
AAGCCACAC.CCTCGGTCA	AAGCCACAC.CCTCGGTCA
AAGCCACAC.CCTGTCATT	AAGCCACAC.CCTGTCATT
AAGCCACAC.CTACGGTAT	AAGCCACAC.CTACGGTAT
AAGCCACAC.CTCAGCTGG	AAGCCACAC.CTCAGCTGG
AAGCCACAC.CTGCGTCAC	AAGCCACAC.CTGCGTCAC
AAGCCACAC.GAGACTCGA	AAGCCACAC.GAGACTCGA
AAGCCACAC.TGTTGTCGA	AAGCCACAC.TGTTGTCGA
AAGCTGAGG.TAATGTAGC	AAGCTGAGG.TAATGTAGC
AAGCTGAGG.TATGTACCT	AAGCTGAGG.TATGTACCT
AAGCTGAGG.TCACGCGAC	AAGCTGAGG.TCACGCGAC
AAGCTGGTC.AGCGTAGAA	AAGCTGGTC.AGCGTAGAA
AAGCTGGTC.CCACGGATC	AAGCTGGTC.CCACGGATC
AAGCTGGTC.CCTCATAAC	AAGCTGGTC.CCTCATAAC
AAGCTGGTC.GAATTCAGT	AAGCTGGTC.GAATTCAGT
AAGCTGGTC.GAGGTGAGC	AAGCTGGTC.GAGGTGAGC
AAGCTGGTC.TACAGTTAG	AAGCTGGTC.TACAGTTAG
AAGCTGGTC.TATTACTCG	AAGCTGGTC.TATTACTCG
AAGCTGGTC.TGAACGTCA	AAGCTGGTC.TGAACGTCA
AAGCTTGCA.AGCATATGG	AAGCTTGCA.AGCATATGG
AAGCTTGCA.GTTGCATGG	AAGCTTGCA.GTTGCATGG
AAGCTTGCA.TACAACACC	AAGCTTGCA.TACAACACC
AAGCTTGCA.TCGTCCGAT	AAGCTTGCA.TCGTCCGAT
AAGGAACAG.AGTCGCGAC	AAGGAACAG.AGTCGCGAC
AAGGAACAG.CATCCTCTC	AAGGAACAG.CATCCTCTC
AAGGAACAG.CCTTGACGG	AAGGAACAG.CCTTGACGG
AAGGAACAG.CGCGATGTA	AAGGAACAG.CGCGATGTA
AAGGAACAG.GTGTATCTG	AAGGAACAG.GTGTATCTG
AAGGAACAG.GTGTCGAGC	AAGGAACAG.GTGTCGAGC
AAGGAAGTC.CACGATAGA	AAGGAAGTC.CACGATAGA
AAGGAAGTC.CCGATGTTC	AAGGAAGTC.CCGATGTTC
AAGGAAGTC.CTTCCTGAT	AAGGAAGTC.CTTCCTGAT
AAGGAAGTC.GATCTGTTC	AAGGAAGTC.GATCTGTTC
AAGGAAGTC.TGATTGTGC	AAGGAAGTC.TGATTGTGC
AAGGATACG.GGAGTTAGC	AAGGATACG.GGAGTTAGC
AAGGATACG.TATACGTGG	AAGGATACG.TATACGTGG
AAGGATACG.TGGTAGCAG	AAGGATACG.TGGTAGCAG
AAGGATACG.TTCATCCAA	AAGGATACG.TTCATCCAA
AAGGATCGT.CCTCTGCAT	AAGGATCGT.CCTCTGCAT
AAGGATCGT.GCGGAGATT	AAGGATCGT.GCGGAGATT
AAGGATCGT.TACGTTACC	AAGGATCGT.TACGTTACC
AAGGATCGT.TCAATGGAC	AAGGATCGT.TCAATGGAC
AAGGATCGT.TCAGCGACC	AAGGATCGT.TCAGCGACC
AAGGTCTGA.CAATCTCCG	AAGGTCTGA.CAATCTCCG
AAGGTCTGA.CCTGTTAGC	AAGGTCTGA.CCTGTTAGC
AAGGTCTGA.GGTAACTAC	AAGGTCTGA.GGTAACTAC
AAGGTCTGA.TAGTCGCAT	AAGGTCTGA.TAGTCGCAT
AAGGTCTGA.TGCCATCTC	AAGGTCTGA.TGCCATCTC
AAGGTGCTG.ACACAGAAC	AAGGTGCTG.ACACAGAAC
AAGGTGCTG.ACGTAGTAT	AAGGTGCTG.ACGTAGTAT
AAGGTGCTG.AGAGGTGAA	AAGGTGCTG.AGAGGTGAA
AAGGTGCTG.ATATAGCGT	AAGGTGCTG.ATATAGCGT
AAGGTGCTG.ATGGTTCGA	AAGGTGCTG.ATGGTTCGA
AAGGTGCTG.ATTCTCTGG	AAGGTGCTG.ATTCTCTGG
AAGGTGCTG.CACCTTCCT	AAGGTGCTG.CACCTTCCT
AAGGTGCTG.GCTGACAGA	AAGGTGCTG.GCTGACAGA
AAGGTGCTG.GTACCACAA	AAGGTGCTG.GTACCACAA
AAGGTGCTG.GTCGTTGCG	AAGGTGCTG.GTCGTTGCG
AAGGTGCTG.TATTGACTG	AAGGTGCTG.TATTGACTG
AAGTACAGA.AGTGAGAGA	AAGTACAGA.AGTGAGAGA
AAGTACAGA.TAACGTGTC	AAGTACAGA.TAACGTGTC
AAGTAGGAC.CCGAGCTGA	AAGTAGGAC.CCGAGCTGA
AAGTAGGAC.GCGACAACC	AAGTAGGAC.GCGACAACC
AAGTAGGAC.GTAGCCTTG	AAGTAGGAC.GTAGCCTTG
AAGTAGGAC.TAAGTACAC	AAGTAGGAC.TAAGTACAC
AAGTAGGAC.TACAGGACT	AAGTAGGAC.TACAGGACT
AAGTAGGAC.TTAGGAAGG	AAGTAGGAC.TTAGGAAGG
AAGTCATGA.CACCAGAAG	AAGTCATGA.CACCAGAAG
AAGTTCTCT.GTCGTCGAC	AAGTTCTCT.GTCGTCGAC
AAGTTCTCT.TGCATCGGA	AAGTTCTCT.TGCATCGGA
AAGTTCTCT.TGTTAAGCC	AAGTTCTCT.TGTTAAGCC
AAGTTGCCA.CCTGCAGAT	AAGTTGCCA.CCTGCAGAT
AAGTTGCCA.GCGACACAG	AAGTTGCCA.GCGACACAG
AAGTTGCCA.TCACTCGCT	AAGTTGCCA.TCACTCGCT
AATAACTCC.ACACCGCCA	AATAACTCC.ACACCGCCA
AATAACTCC.ACAGCGTAT	AATAACTCC.ACAGCGTAT
AATAACTCC.GCCACGAGT	AATAACTCC.GCCACGAGT
AATAACTCC.GCTACAATG	AATAACTCC.GCTACAATG
AATAACTCC.GTAATCAGC	AATAACTCC.GTAATCAGC
AATAACTCC.GTTAGATTG	AATAACTCC.GTTAGATTG
AATAACTCC.TCCAACGTG	AATAACTCC.TCCAACGTG
AATAACTCC.TTCACCTTG	AATAACTCC.TTCACCTTG
AATACCTTG.CGGAGACTT	AATACCTTG.CGGAGACTT
AATACCTTG.GATCTAGAG	AATACCTTG.GATCTAGAG
AATACCTTG.GCTTCTGAA	AATACCTTG.GCTTCTGAA
AATACGTCT.AACTCCATG	AATACGTCT.AACTCCATG
AATACGTCT.CCTAAGAAG	AATACGTCT.CCTAAGAAG
AATACGTCT.CGAACAGAG	AATACGTCT.CGAACAGAG
AATACGTCT.GTAGAAGTT	AATACGTCT.GTAGAAGTT
AATACGTCT.TATGACCGA	AATACGTCT.TATGACCGA
AATACGTCT.TCAAGGTCG	AATACGTCT.TCAAGGTCG
AATACGTCT.TCAGCGACC	AATACGTCT.TCAGCGACC
AATACTCCG.ACCGTCCTA	AATACTCCG.ACCGTCCTA
AATACTCCG.AGTTAGGTC	AATACTCCG.AGTTAGGTC
AATACTCCG.ATAAGACAG	AATACTCCG.ATAAGACAG
AATACTCCG.ATCAAGCAT	AATACTCCG.ATCAAGCAT
AATACTCCG.CTAGAGTCG	AATACTCCG.CTAGAGTCG
AATACTCCG.GTGGTACGG	AATACTCCG.GTGGTACGG
AATACTCCG.TAGAGACTA	AATACTCCG.TAGAGACTA
AATACTCCG.TCTTGGTAG	AATACTCCG.TCTTGGTAG
AATAGACGC.AATCGCCAT	AATAGACGC.AATCGCCAT
AATAGACGC.AGTAATGGT	AATAGACGC.AGTAATGGT
AATATCAGC.GCCATCGCT	AATATCAGC.GCCATCGCT
AATATCAGC.TAGGATGCC	AATATCAGC.TAGGATGCC
AATATCAGC.TCGCTGATT	AATATCAGC.TCGCTGATT
AATATCAGC.TGGAGAACC	AATATCAGC.TGGAGAACC
AATATCAGC.TGTCACATA	AATATCAGC.TGTCACATA
AATATCGCT.AGAATCAGA	AATATCGCT.AGAATCAGA
AATATCGCT.AGGTCAGCA	AATATCGCT.AGGTCAGCA
AATATCGCT.ATAATCGAG	AATATCGCT.ATAATCGAG
AATATCGCT.GTAGCTACA	AATATCGCT.GTAGCTACA
AATATCGCT.TTACACCTT	AATATCGCT.TTACACCTT
AATCAGGAG.ACTAAGTTC	AATCAGGAG.ACTAAGTTC
AATCAGGAG.CGCATAACT	AATCAGGAG.CGCATAACT
AATCAGGAG.GTAAGGTCC	AATCAGGAG.GTAAGGTCC
AATCAGGAG.TAGCTGTTG	AATCAGGAG.TAGCTGTTG
AATCAGGAG.TATGAGACC	AATCAGGAG.TATGAGACC
AATCAGGAG.TGGAATCGT	AATCAGGAG.TGGAATCGT
AATCCGCTG.AGTAATCAG	AATCCGCTG.AGTAATCAG
AATCCGCTG.CCACTGAAG	AATCCGCTG.CCACTGAAG
AATCCGCTG.CGTGTATTC	AATCCGCTG.CGTGTATTC
AATCCGCTG.CTCTGCGGT	AATCCGCTG.CTCTGCGGT
AATCCGCTG.GCACTGGAT	AATCCGCTG.GCACTGGAT
AATCCGCTG.TGCCGACTA	AATCCGCTG.TGCCGACTA
AATCCTCGT.AGTGATGCG	AATCCTCGT.AGTGATGCG
AATCCTCGT.CCTAAGAAG	AATCCTCGT.CCTAAGAAG
AATCCTCGT.GATATATCC	AATCCTCGT.GATATATCC
AATCCTCGT.GGTGTGACC	AATCCTCGT.GGTGTGACC
AATCCTCGT.GTCCACAAC	AATCCTCGT.GTCCACAAC
AATCCTCGT.TGCGTAATC	AATCCTCGT.TGCGTAATC
AATCCTCGT.TTCCAGATT	AATCCTCGT.TTCCAGATT
AATCGCCAT.ATGAACTAG	AATCGCCAT.ATGAACTAG
AATCGCCAT.ATGGACGTT	AATCGCCAT.ATGGACGTT
AATCGCCAT.ATGGATATC	AATCGCCAT.ATGGATATC
AATCGCCAT.ATGTCGCCT	AATCGCCAT.ATGTCGCCT
AATCGCCAT.CGCTTGTAG	AATCGCCAT.CGCTTGTAG
AATCGCCAT.TATCTAGGT	AATCGCCAT.TATCTAGGT
AATCGCCAT.TGCGCACTG	AATCGCCAT.TGCGCACTG
AATCGCCAT.TGGTAGCAG	AATCGCCAT.TGGTAGCAG
AATCGTGTT.CAGATCATT	AATCGTGTT.CAGATCATT
AATCGTGTT.GTAGCATAC	AATCGTGTT.GTAGCATAC
AATCGTGTT.GTAGCTACA	AATCGTGTT.GTAGCTACA
AATCGTGTT.TCACCGAGG	AATCGTGTT.TCACCGAGG
AATCGTGTT.TCGTCATTC	AATCGTGTT.TCGTCATTC
AATCGTGTT.TGTTGTCGA	AATCGTGTT.TGTTGTCGA
AATCTCCTA.ACAGCGGTC	AATCTCCTA.ACAGCGGTC
AATCTCCTA.AGGTCCGTC	AATCTCCTA.AGGTCCGTC
AATCTCCTA.AGTTATCGC	AATCTCCTA.AGTTATCGC
AATCTCCTA.GTATGCCTT	AATCTCCTA.GTATGCCTT
AATCTCCTA.TCAGCGACC	AATCTCCTA.TCAGCGACC
AATCTCCTA.TTCTGGTGC	AATCTCCTA.TTCTGGTGC
AATCTGACC.CGCCACCAT	AATCTGACC.CGCCACCAT
AATCTGACC.CTCAGCTGG	AATCTGACC.CTCAGCTGG
AATCTGACC.TCGTCCGAT	AATCTGACC.TCGTCCGAT
AATGAGTCG.ACCTGCAGA	AATGAGTCG.ACCTGCAGA
AATGAGTCG.CAGTCTAAC	AATGAGTCG.CAGTCTAAC
AATGAGTCG.GCTACAATG	AATGAGTCG.GCTACAATG
AATGAGTCG.GTAGAGAGC	AATGAGTCG.GTAGAGAGC
AATGAGTCG.TAGGAGCTA	AATGAGTCG.TAGGAGCTA
AATGAGTCG.TCATCATCT	AATGAGTCG.TCATCATCT
AATGCACTT.AGACCAGCT	AATGCACTT.AGACCAGCT
AATGCACTT.AGCAAGTCC	AATGCACTT.AGCAAGTCC
AATGCACTT.AGGATTGAG	AATGCACTT.AGGATTGAG
AATGCAGCG.CATGGTTAC	AATGCAGCG.CATGGTTAC
AATGCAGCG.TACAACACC	AATGCAGCG.TACAACACC
AATGCAGCG.TGATGTGTG	AATGCAGCG.TGATGTGTG
AATGCCTCA.AAGTTCTCT	AATGCCTCA.AAGTTCTCT
AATGCCTCA.ACACACCGT	AATGCCTCA.ACACACCGT
AATGCCTCA.AGCGACACC	AATGCCTCA.AGCGACACC
AATGCCTCA.CATCCTCTC	AATGCCTCA.CATCCTCTC
AATGCCTCA.GTCAGTTGT	AATGCCTCA.GTCAGTTGT
AATGCCTCA.TCTATGACA	AATGCCTCA.TCTATGACA
AATGCGTGC.ACGTCTATG	AATGCGTGC.ACGTCTATG
AATGCGTGC.AGCCAGGAC	AATGCGTGC.AGCCAGGAC
AATGCGTGC.CCTCTTGTA	AATGCGTGC.CCTCTTGTA
AATGCGTGC.GTATGATCT	AATGCGTGC.GTATGATCT
AATGCGTGC.TCCACGTGC	AATGCGTGC.TCCACGTGC
AATGCTATC.ACGTCTATG	AATGCTATC.ACGTCTATG
AATGCTATC.AGCGACACC	AATGCTATC.AGCGACACC
AATGCTATC.CTTGCACAA	AATGCTATC.CTTGCACAA
AATGCTATC.GGTGAGTTC	AATGCTATC.GGTGAGTTC
AATGCTATC.GTCCACAAC	AATGCTATC.GTCCACAAC
AATGCTATC.TACAACACC	AATGCTATC.TACAACACC
AATGCTGAT.AGCGGAACA	AATGCTGAT.AGCGGAACA
AATGCTGAT.CAGTCCTAA	AATGCTGAT.CAGTCCTAA
AATGCTGAT.CCTGACCTC	AATGCTGAT.CCTGACCTC
AATGCTGAT.CTGAGTAGC	AATGCTGAT.CTGAGTAGC
AATGCTGAT.GCGGAGATT	AATGCTGAT.GCGGAGATT
AATGCTGAT.TACCGATTG	AATGCTGAT.TACCGATTG
AATGCTGAT.TGACGATGA	AATGCTGAT.TGACGATGA
AATGCTGAT.TTGTAATGC	AATGCTGAT.TTGTAATGC
AATGTGCGT.CACAACGCT	AATGTGCGT.CACAACGCT
AATGTGCGT.CCATCACGA	AATGTGCGT.CCATCACGA
AATGTGCGT.GATCTAGAG	AATGTGCGT.GATCTAGAG
AATGTGCGT.TGTGAGTAT	AATGTGCGT.TGTGAGTAT
AATTAGAGG.AAGTCATGA	AATTAGAGG.AAGTCATGA
AATTAGAGG.GAGCATACA	AATTAGAGG.GAGCATACA
AATTAGAGG.GTCAGTTGT	AATTAGAGG.GTCAGTTGT
AATTCGGAA.ACCATACTT	AATTCGGAA.ACCATACTT
AATTCGGAA.ATAGCACGG	AATTCGGAA.ATAGCACGG
AATTCGGAA.CGCGATGTA	AATTCGGAA.CGCGATGTA
AATTCGGAA.CTGATCAAG	AATTCGGAA.CTGATCAAG
AATTCGGAA.GCTCTCCAA	AATTCGGAA.GCTCTCCAA
AATTGGATC.AGCCAGGAC	AATTGGATC.AGCCAGGAC
AATTGGATC.ATTGATCAC	AATTGGATC.ATTGATCAC
AATTGGATC.CTGGACACT	AATTGGATC.CTGGACACT
AATTGGATC.TAGACACGT	AATTGGATC.TAGACACGT
AATTGGATC.TATCTAGGT	AATTGGATC.TATCTAGGT
AATTGGTGA.CGGAACGAG	AATTGGTGA.CGGAACGAG
AATTGGTGA.CGTGTATTC	AATTGGTGA.CGTGTATTC
AATTGGTGA.CTGGTAATC	AATTGGTGA.CTGGTAATC
AATTGGTGA.GAGTGCATA	AATTGGTGA.GAGTGCATA
AATTGGTGA.TCAGGTGCA	AATTGGTGA.TCAGGTGCA
ACAACCGGA.AATGCAGCG	ACAACCGGA.AATGCAGCG
ACAACCGGA.ACCATCTAA	ACAACCGGA.ACCATCTAA
ACAACCGGA.ATGCGGATT	ACAACCGGA.ATGCGGATT
ACAACCGGA.ATTGATTGG	ACAACCGGA.ATTGATTGG
ACAACCGGA.CTAGTTCCA	ACAACCGGA.CTAGTTCCA
ACAACCGGA.GCGACCTGT	ACAACCGGA.GCGACCTGT
ACAACCGGA.GTGCCATGA	ACAACCGGA.GTGCCATGA
ACAACCGGA.TAGACCTAC	ACAACCGGA.TAGACCTAC
ACAACCGGA.TGTGTAGAG	ACAACCGGA.TGTGTAGAG
ACAACCGGA.TTGCCGTAG	ACAACCGGA.TTGCCGTAG
ACAACGAGC.ACTCGCTGT	ACAACGAGC.ACTCGCTGT
ACAACGAGC.CATGGTTAC	ACAACGAGC.CATGGTTAC
ACAACGAGC.CGGTGAGTC	ACAACGAGC.CGGTGAGTC
ACAAGAATG.ACTTCAGTA	ACAAGAATG.ACTTCAGTA
ACAAGAATG.ATAGTGGTT	ACAAGAATG.ATAGTGGTT
ACAAGAATG.CCTGACCTC	ACAAGAATG.CCTGACCTC
ACAAGAATG.GATAAGCTG	ACAAGAATG.GATAAGCTG
ACAAGAATG.GCTAGTGGA	ACAAGAATG.GCTAGTGGA
ACAAGGTAC.AATTGGATC	ACAAGGTAC.AATTGGATC
ACAAGGTAC.ACCTGCAGA	ACAAGGTAC.ACCTGCAGA
ACAAGGTAC.AGTACTACA	ACAAGGTAC.AGTACTACA
ACAAGGTAC.ATACCGCTT	ACAAGGTAC.ATACCGCTT
ACAAGGTAC.CAAGAGAGT	ACAAGGTAC.CAAGAGAGT
ACAAGGTAC.GCAACACCT	ACAAGGTAC.GCAACACCT
ACAAGGTAC.GCGCTACCT	ACAAGGTAC.GCGCTACCT
ACAAGTACA.ACAAGAATG	ACAAGTACA.ACAAGAATG
ACAAGTACA.ATCCAATGA	ACAAGTACA.ATCCAATGA
ACAAGTACA.ATCGATCCT	ACAAGTACA.ATCGATCCT
ACAAGTACA.GATGTTACA	ACAAGTACA.GATGTTACA
ACAAGTACA.GATTGAGTA	ACAAGTACA.GATTGAGTA
ACAAGTACA.GCGCTACCT	ACAAGTACA.GCGCTACCT
ACAAGTACA.GTAGAGAGC	ACAAGTACA.GTAGAGAGC
ACAAGTACA.GTCCGTAAG	ACAAGTACA.GTCCGTAAG
ACAAGTACA.TTCCGAGCG	ACAAGTACA.TTCCGAGCG
ACAATAGGT.ATATCAGCC	ACAATAGGT.ATATCAGCC
ACAATAGGT.GTCCTTCAT	ACAATAGGT.GTCCTTCAT
ACAATAGGT.TACGACTTG	ACAATAGGT.TACGACTTG
ACAATAGGT.TGCTCCTCC	ACAATAGGT.TGCTCCTCC
ACAATAGGT.TTAACGGAG	ACAATAGGT.TTAACGGAG
ACAATTCGG.ATCTCTGCT	ACAATTCGG.ATCTCTGCT
ACAATTCGG.CGTGCCTAT	ACAATTCGG.CGTGCCTAT
ACAATTCGG.CTATCCATC	ACAATTCGG.CTATCCATC
ACAATTCGG.GCGTGATAC	ACAATTCGG.GCGTGATAC
ACAATTCGG.GTCTTATGC	ACAATTCGG.GTCTTATGC
ACAATTCGG.TACGAACTC	ACAATTCGG.TACGAACTC
ACAATTCGG.TTCATTCGC	ACAATTCGG.TTCATTCGC
ACACACCGT.AACGTTCTT	ACACACCGT.AACGTTCTT
ACACACCGT.ACTTCGCAG	ACACACCGT.ACTTCGCAG
ACACACCGT.ATGACACAA	ACACACCGT.ATGACACAA
ACACACCGT.CACGTAGAC	ACACACCGT.CACGTAGAC
ACACACCGT.CACGTCATA	ACACACCGT.CACGTCATA
ACACACCGT.CGCGCACAT	ACACACCGT.CGCGCACAT
ACACACCGT.CTCTAAGAG	ACACACCGT.CTCTAAGAG
ACACACCGT.TCGAATAGA	ACACACCGT.TCGAATAGA
ACACACGTC.ACACTAACG	ACACACGTC.ACACTAACG
ACACACGTC.TGCGCTGCA	ACACACGTC.TGCGCTGCA
ACACAGAAC.AGGTACCAA	ACACAGAAC.AGGTACCAA
ACACAGAAC.CGTACATCT	ACACAGAAC.CGTACATCT
ACACAGAAC.TAATCTGGA	ACACAGAAC.TAATCTGGA
ACACAGAAC.TGAGACAGC	ACACAGAAC.TGAGACAGC
ACACAGAAC.TTACTTACG	ACACAGAAC.TTACTTACG
ACACATCTG.CTCGACTGC	ACACATCTG.CTCGACTGC
ACACATCTG.GATCTACTT	ACACATCTG.GATCTACTT
ACACATCTG.GTGGACTGG	ACACATCTG.GTGGACTGG
ACACATCTG.TAGGAGGAT	ACACATCTG.TAGGAGGAT
ACACCACAT.AATCCTCGT	ACACCACAT.AATCCTCGT
ACACCACAT.CTTGGATCA	ACACCACAT.CTTGGATCA
ACACCGCCA.ACCATACTT	ACACCGCCA.ACCATACTT
ACACCGCCA.AGCACCGTG	ACACCGCCA.AGCACCGTG
ACACCGCCA.CAACGCACA	ACACCGCCA.CAACGCACA
ACACCGCCA.CACTGGTCC	ACACCGCCA.CACTGGTCC
ACACCGCCA.CAGCTGGAG	ACACCGCCA.CAGCTGGAG
ACACCGCCA.TCAGACAAG	ACACCGCCA.TCAGACAAG
ACACGTTGC.AACGGAGAT	ACACGTTGC.AACGGAGAT
ACACGTTGC.ACACCGCCA	ACACGTTGC.ACACCGCCA
