CAGAAGTGA.GAGACATTG	CAGAAGTGA.GAGACATTG
CAGAAGTGA.GGTTAACAG	CAGAAGTGA.GGTTAACAG
CAGAAGTGA.TCACTACGT	CAGAAGTGA.TCACTACGT
CAGAGCACC.AGCATTCCA	CAGAGCACC.AGCATTCCA
CAGAGCACC.AGTTGAGCG	CAGAGCACC.AGTTGAGCG
CAGAGCACC.CGTATAGCG	CAGAGCACC.CGTATAGCG
CAGAGCACC.TACGGTCGT	CAGAGCACC.TACGGTCGT
CAGAGCACC.TCTAGTGAC	CAGAGCACC.TCTAGTGAC
CAGAGCACC.TGTTAAGCC	CAGAGCACC.TGTTAAGCC
CAGAGCACC.TTACACCTT	CAGAGCACC.TTACACCTT
CAGATCATT.CCAATGCCT	CAGATCATT.CCAATGCCT
CAGATCATT.GACGTTCAG	CAGATCATT.GACGTTCAG
CAGATCATT.GCCACATGG	CAGATCATT.GCCACATGG
CAGATCATT.GTACCACAA	CAGATCATT.GTACCACAA
CAGATCGAC.ATTCGCTTA	CAGATCGAC.ATTCGCTTA
CAGATCGAC.CATCCGACA	CAGATCGAC.CATCCGACA
CAGATCGAC.CTCCTGACG	CAGATCGAC.CTCCTGACG
CAGATCGAC.CTTACATGC	CAGATCGAC.CTTACATGC
CAGATCGAC.GCGAACTCG	CAGATCGAC.GCGAACTCG
CAGATCGAC.GGATACCTA	CAGATCGAC.GGATACCTA
CAGATCGAC.TCGCCAAGC	CAGATCGAC.TCGCCAAGC
CAGCACGTG.CCTACTAGA	CAGCACGTG.CCTACTAGA
CAGCACGTG.GAGACGATC	CAGCACGTG.GAGACGATC
CAGCACGTG.TGCTCAGCG	CAGCACGTG.TGCTCAGCG
CAGCAGTAC.ATGGTTCGA	CAGCAGTAC.ATGGTTCGA
CAGCAGTAC.ATTAAGACC	CAGCAGTAC.ATTAAGACC
CAGCAGTAC.CCTAGCAAT	CAGCAGTAC.CCTAGCAAT
CAGCCGCAA.ACACATCTG	CAGCCGCAA.ACACATCTG
CAGCCGCAA.AGACCAGCT	CAGCCGCAA.AGACCAGCT
CAGCCGCAA.AGCAAGTCC	CAGCCGCAA.AGCAAGTCC
CAGCCGCAA.AGGAGCAAT	CAGCCGCAA.AGGAGCAAT
CAGCCGCAA.ATGCGCTAC	CAGCCGCAA.ATGCGCTAC
CAGCCGCAA.CCGATCAGC	CAGCCGCAA.CCGATCAGC
CAGCCGCAA.GCGACCTGT	CAGCCGCAA.GCGACCTGT
CAGCCGCAA.TATTACTCG	CAGCCGCAA.TATTACTCG
CAGCGACGT.CCGCAGAAT	CAGCGACGT.CCGCAGAAT
CAGCGACGT.CCTACTAGA	CAGCGACGT.CCTACTAGA
CAGCGACGT.CGGACAAGT	CAGCGACGT.CGGACAAGT
CAGCGACGT.CTGATGCAC	CAGCGACGT.CTGATGCAC
CAGCGACGT.GAGTGCATA	CAGCGACGT.GAGTGCATA
CAGCGACGT.GGAATTCAC	CAGCGACGT.GGAATTCAC
CAGCGACGT.GGTTCGCAA	CAGCGACGT.GGTTCGCAA
CAGCGACGT.TCAGTAAGC	CAGCGACGT.TCAGTAAGC
CAGCGACGT.TTCCATACC	CAGCGACGT.TTCCATACC
CAGCGTAAG.ACCTTGAAG	CAGCGTAAG.ACCTTGAAG
CAGCGTAAG.ATTAGCCAC	CAGCGTAAG.ATTAGCCAC
CAGCGTAAG.CTCGCAAGA	CAGCGTAAG.CTCGCAAGA
CAGCGTAAG.CTTAGAAGG	CAGCGTAAG.CTTAGAAGG
CAGCGTAAG.GGTAGCATC	CAGCGTAAG.GGTAGCATC
CAGCTAGTT.AATGCGTGC	CAGCTAGTT.AATGCGTGC
CAGCTAGTT.CCGCACTCA	CAGCTAGTT.CCGCACTCA
CAGCTAGTT.CCGCAGAAT	CAGCTAGTT.CCGCAGAAT
CAGCTAGTT.GGTAGACAT	CAGCTAGTT.GGTAGACAT
CAGCTCTTC.ATTAGCCAC	CAGCTCTTC.ATTAGCCAC
CAGCTCTTC.CACAGCGAA	CAGCTCTTC.CACAGCGAA
CAGCTGGAG.ATAGCTTGC	CAGCTGGAG.ATAGCTTGC
CAGCTGGAG.TGGTAGCAG	CAGCTGGAG.TGGTAGCAG
CAGCTTACC.ACGTTCAAT	CAGCTTACC.ACGTTCAAT
CAGCTTACC.CAAGAGAGT	CAGCTTACC.CAAGAGAGT
CAGCTTACC.CCGGTTCTA	CAGCTTACC.CCGGTTCTA
CAGCTTACC.GTATTACTG	CAGCTTACC.GTATTACTG
CAGCTTCGA.CTGATCAAG	CAGCTTCGA.CTGATCAAG
CAGCTTCGA.CTTAGAAGG	CAGCTTCGA.CTTAGAAGG
CAGCTTCGA.GAGAACAGG	CAGCTTCGA.GAGAACAGG
CAGCTTCGA.GCATACTCC	CAGCTTCGA.GCATACTCC
CAGCTTCGA.GGAACTGCT	CAGCTTCGA.GGAACTGCT
CAGCTTCGA.GGTGGAGCT	CAGCTTCGA.GGTGGAGCT
CAGGAGCCT.AACAGATCG	CAGGAGCCT.AACAGATCG
CAGGAGCCT.ACGTGTAGT	CAGGAGCCT.ACGTGTAGT
CAGGAGCCT.ACTTGATCT	CAGGAGCCT.ACTTGATCT
CAGGAGCCT.GCTGGTTCG	CAGGAGCCT.GCTGGTTCG
CAGGAGCCT.GTTAGAGAC	CAGGAGCCT.GTTAGAGAC
CAGGAGCCT.TATGAGACC	CAGGAGCCT.TATGAGACC
CAGGATCAA.AACAGCAGT	CAGGATCAA.AACAGCAGT
CAGGATCAA.ACAACCGGA	CAGGATCAA.ACAACCGGA
CAGGATCAA.CTCCTATCT	CAGGATCAA.CTCCTATCT
CAGGATCAA.CTGGACTAA	CAGGATCAA.CTGGACTAA
CAGGATCAA.GAGTCAAGG	CAGGATCAA.GAGTCAAGG
CAGGATCAA.GCCGAACCA	CAGGATCAA.GCCGAACCA
CAGGATCAA.TTCACCTTG	CAGGATCAA.TTCACCTTG
CAGGTATCG.CCTCCTTGT	CAGGTATCG.CCTCCTTGT
CAGGTATCG.GAGCAGGAA	CAGGTATCG.GAGCAGGAA
CAGGTATCG.GGTAGACAT	CAGGTATCG.GGTAGACAT
CAGGTTGTC.AGTTCAACC	CAGGTTGTC.AGTTCAACC
CAGGTTGTC.ATAACGACA	CAGGTTGTC.ATAACGACA
CAGGTTGTC.CCTGTCATT	CAGGTTGTC.CCTGTCATT
CAGGTTGTC.GTTACTACT	CAGGTTGTC.GTTACTACT
CAGGTTGTC.TGCCGAACT	CAGGTTGTC.TGCCGAACT
CAGGTTGTC.TGGAAGATT	CAGGTTGTC.TGGAAGATT
CAGTAATGT.AACGGAGAT	CAGTAATGT.AACGGAGAT
CAGTAATGT.AATACTCCG	CAGTAATGT.AATACTCCG
CAGTAATGT.CGTTCGTAC	CAGTAATGT.CGTTCGTAC
CAGTAATGT.CTGATGCAC	CAGTAATGT.CTGATGCAC
CAGTAATGT.GTCCGCTCA	CAGTAATGT.GTCCGCTCA
CAGTAATGT.TCAGGACTG	CAGTAATGT.TCAGGACTG
CAGTACATC.ACGTATGTC	CAGTACATC.ACGTATGTC
CAGTACATC.CATTCAGTT	CAGTACATC.CATTCAGTT
CAGTACATC.CCAATGCCT	CAGTACATC.CCAATGCCT
CAGTACATC.CGATAGGTG	CAGTACATC.CGATAGGTG
CAGTACATC.CGCGAGTGT	CAGTACATC.CGCGAGTGT
CAGTACATC.CTCTAAGAG	CAGTACATC.CTCTAAGAG
CAGTACATC.GGAGTACAG	CAGTACATC.GGAGTACAG
CAGTACATC.GTGACTCTC	CAGTACATC.GTGACTCTC
CAGTACATC.TGGAGAGTG	CAGTACATC.TGGAGAGTG
CAGTATGAT.AGTACTACA	CAGTATGAT.AGTACTACA
CAGTATGAT.CAAGAGAGT	CAGTATGAT.CAAGAGAGT
CAGTATGAT.GAGTTAACT	CAGTATGAT.GAGTTAACT
CAGTATGAT.GGTTGCTAT	CAGTATGAT.GGTTGCTAT
CAGTATGAT.TCACCGAGG	CAGTATGAT.TCACCGAGG
CAGTCCTAA.AAGGATCGT	CAGTCCTAA.AAGGATCGT
CAGTCCTAA.ACTTCTAAC	CAGTCCTAA.ACTTCTAAC
CAGTCCTAA.GGAAGAAGC	CAGTCCTAA.GGAAGAAGC
CAGTCCTAA.GTCAGCGTC	CAGTCCTAA.GTCAGCGTC
CAGTCGGTA.ACTAACCGA	CAGTCGGTA.ACTAACCGA
CAGTCGGTA.CACATTCTG	CAGTCGGTA.CACATTCTG
CAGTCGGTA.CCTGTTAGC	CAGTCGGTA.CCTGTTAGC
CAGTCGGTA.GGAAGTATG	CAGTCGGTA.GGAAGTATG
CAGTCGGTA.TCTCGATGC	CAGTCGGTA.TCTCGATGC
CAGTCGGTA.TGGACGAGA	CAGTCGGTA.TGGACGAGA
CAGTCTAAC.AATGTGCGT	CAGTCTAAC.AATGTGCGT
CAGTCTAAC.AGATCGAGT	CAGTCTAAC.AGATCGAGT
CAGTCTAAC.CTGAGGTTA	CAGTCTAAC.CTGAGGTTA
CAGTCTAAC.GAGAATCAG	CAGTCTAAC.GAGAATCAG
CAGTCTAAC.GGAGATGAG	CAGTCTAAC.GGAGATGAG
CAGTGAGGA.AATAACTCC	CAGTGAGGA.AATAACTCC
CAGTGAGGA.ACGTGTAGT	CAGTGAGGA.ACGTGTAGT
CAGTGAGGA.AGCAACATT	CAGTGAGGA.AGCAACATT
CAGTGAGGA.ATTCCGTAC	CAGTGAGGA.ATTCCGTAC
CAGTGAGGA.TTGGACTTC	CAGTGAGGA.TTGGACTTC
CAGTGCCAT.AATACGTCT	CAGTGCCAT.AATACGTCT
CAGTGCCAT.AATATCGCT	CAGTGCCAT.AATATCGCT
CAGTGCCAT.ATGCTGTCG	CAGTGCCAT.ATGCTGTCG
CAGTGCCAT.CTCATTAGT	CAGTGCCAT.CTCATTAGT
CAGTGCCAT.GCCGCCTAA	CAGTGCCAT.GCCGCCTAA
CAGTGCCAT.TCGCTGATT	CAGTGCCAT.TCGCTGATT
CAGTGCTGC.AGAGCGGAG	CAGTGCTGC.AGAGCGGAG
CAGTGCTGC.CAGTTACTG	CAGTGCTGC.CAGTTACTG
CAGTGCTGC.GAGATTCCT	CAGTGCTGC.GAGATTCCT
CAGTGCTGC.GTACTCTAC	CAGTGCTGC.GTACTCTAC
CAGTGCTGC.TTGCCAGAT	CAGTGCTGC.TTGCCAGAT
CAGTTACTG.AGACTAGTA	CAGTTACTG.AGACTAGTA
CAGTTACTG.ATCTCGTGA	CAGTTACTG.ATCTCGTGA
CAGTTACTG.CCATTACAG	CAGTTACTG.CCATTACAG
CAGTTACTG.CTCCTATCT	CAGTTACTG.CTCCTATCT
CAGTTACTG.TGGTAACCA	CAGTTACTG.TGGTAACCA
CAGTTGAGT.AACTTCTGC	CAGTTGAGT.AACTTCTGC
CAGTTGAGT.CTGTCACTT	CAGTTGAGT.CTGTCACTT
CAGTTGAGT.GCGCTACCT	CAGTTGAGT.GCGCTACCT
CAGTTGAGT.TAAGGTGAT	CAGTTGAGT.TAAGGTGAT
CATAAGATC.ACTCCGGTT	CATAAGATC.ACTCCGGTT
CATAAGATC.CCATCACGA	CATAAGATC.CCATCACGA
CATAAGATC.CGCCTGCAA	CATAAGATC.CGCCTGCAA
CATAAGATC.CTAGTGCTG	CATAAGATC.CTAGTGCTG
CATAAGATC.CTGGACTAA	CATAAGATC.CTGGACTAA
CATAAGATC.GCGACACAG	CATAAGATC.GCGACACAG
CATAAGATC.GTCCTTCAT	CATAAGATC.GTCCTTCAT
CATAAGATC.GTCTACCAA	CATAAGATC.GTCTACCAA
CATAAGATC.TGCGTAATC	CATAAGATC.TGCGTAATC
CATAAGATC.TTGATCGTA	CATAAGATC.TTGATCGTA
CATAATTGG.AAGTTGCCA	CATAATTGG.AAGTTGCCA
CATAATTGG.ACGCGTGAC	CATAATTGG.ACGCGTGAC
CATAATTGG.AGACTAGTA	CATAATTGG.AGACTAGTA
CATAATTGG.AGAGGTGAA	CATAATTGG.AGAGGTGAA
CATAATTGG.AGCCGGATC	CATAATTGG.AGCCGGATC
CATAATTGG.GCGTAACAA	CATAATTGG.GCGTAACAA
CATAATTGG.GTGGTTACC	CATAATTGG.GTGGTTACC
CATAATTGG.TATTACAGC	CATAATTGG.TATTACAGC
CATAATTGG.TGATGACAG	CATAATTGG.TGATGACAG
CATAATTGG.TTCTGGTGC	CATAATTGG.TTCTGGTGC
CATACAACC.AATCCGCTG	CATACAACC.AATCCGCTG
CATACAACC.ATATGCAGC	CATACAACC.ATATGCAGC
CATACAACC.CACCTTCCT	CATACAACC.CACCTTCCT
CATACAACC.CATAATTGG	CATACAACC.CATAATTGG
CATACAACC.CCATTCTGC	CATACAACC.CCATTCTGC
CATACAACC.CGTGTGTGG	CATACAACC.CGTGTGTGG
CATACAACC.GTCGTGTTA	CATACAACC.GTCGTGTTA
CATACGCAG.AGTCAGTTG	CATACGCAG.AGTCAGTTG
CATACGCAG.ATTAAGACC	CATACGCAG.ATTAAGACC
CATACGCAG.CAACACCTA	CATACGCAG.CAACACCTA
CATAGAGAT.CACGTCATA	CATAGAGAT.CACGTCATA
CATAGAGAT.CCAGTCTCA	CATAGAGAT.CCAGTCTCA
CATAGAGAT.CTTCGTGCA	CATAGAGAT.CTTCGTGCA
CATAGAGAT.TCCTGTCCG	CATAGAGAT.TCCTGTCCG
CATAGGTGT.AAGGATACG	CATAGGTGT.AAGGATACG
CATAGGTGT.AGAAGCTGC	CATAGGTGT.AGAAGCTGC
CATAGGTGT.ATGTGACGA	CATAGGTGT.ATGTGACGA
CATAGGTGT.CTCCAGCGT	CATAGGTGT.CTCCAGCGT
CATAGGTGT.CTCTTCAGC	CATAGGTGT.CTCTTCAGC
CATAGGTGT.GTCGTGTTA	CATAGGTGT.GTCGTGTTA
CATAGGTGT.TAACATTGG	CATAGGTGT.TAACATTGG
CATAGGTGT.TTCTGCCGA	CATAGGTGT.TTCTGCCGA
CATAGGTGT.TTCTGGTGC	CATAGGTGT.TTCTGGTGC
CATAGTATG.ACAGAAGAG	CATAGTATG.ACAGAAGAG
CATAGTATG.CACTCACTA	CATAGTATG.CACTCACTA
CATAGTATG.CTCTGCGGT	CATAGTATG.CTCTGCGGT
CATAGTATG.GAGACATTG	CATAGTATG.GAGACATTG
CATAGTATG.GATTAGACA	CATAGTATG.GATTAGACA
CATAGTATG.GGAACTGCT	CATAGTATG.GGAACTGCT
CATAGTATG.GTGCTAAGC	CATAGTATG.GTGCTAAGC
CATATGCGA.AGCCGTTCT	CATATGCGA.AGCCGTTCT
CATATGCGA.GCACTGGAT	CATATGCGA.GCACTGGAT
CATATGCGA.GGAGCATCT	CATATGCGA.GGAGCATCT
CATATGCGA.TAACTCCGA	CATATGCGA.TAACTCCGA
CATATGCGA.TGCACGATG	CATATGCGA.TGCACGATG
CATATGTCG.ATACCGCTT	CATATGTCG.ATACCGCTT
CATATGTCG.GGATCAGGT	CATATGTCG.GGATCAGGT
CATATGTCG.TACATGCAC	CATATGTCG.TACATGCAC
CATCAATAG.CATATGTCG	CATCAATAG.CATATGTCG
CATCAATAG.CGATTGAAC	CATCAATAG.CGATTGAAC
CATCAATAG.GTAGAGAGC	CATCAATAG.GTAGAGAGC
CATCCACCG.AGTTCAACC	CATCCACCG.AGTTCAACC
CATCCACCG.ATGCAGTTC	CATCCACCG.ATGCAGTTC
CATCCACCG.CCAATGCCT	CATCCACCG.CCAATGCCT
CATCCACCG.GCGCTCTAT	CATCCACCG.GCGCTCTAT
CATCCACCG.TGGAAGATT	CATCCACCG.TGGAAGATT
CATCCACCG.TGTCATAGC	CATCCACCG.TGTCATAGC
CATCCACCG.TTGATGAGT	CATCCACCG.TTGATGAGT
CATCCAGGA.GAATCAACC	CATCCAGGA.GAATCAACC
CATCCAGGA.GAGAACAGG	CATCCAGGA.GAGAACAGG
CATCCAGGA.TACCTCACT	CATCCAGGA.TACCTCACT
CATCCAGGA.TATACGTGG	CATCCAGGA.TATACGTGG
CATCCAGGA.TGAGCAGAT	CATCCAGGA.TGAGCAGAT
CATCCAGGA.TGTGCAGTA	CATCCAGGA.TGTGCAGTA
CATCCGACA.AGTCAGTTG	CATCCGACA.AGTCAGTTG
CATCCGACA.CAGGTTGTC	CATCCGACA.CAGGTTGTC
CATCCGACA.CCTGTCATT	CATCCGACA.CCTGTCATT
CATCCGACA.GACAATGTT	CATCCGACA.GACAATGTT
CATCCGACA.GGAGTACAG	CATCCGACA.GGAGTACAG
CATCCGACA.TAAGTGTAG	CATCCGACA.TAAGTGTAG
CATCCTCTC.AACTTCTGC	CATCCTCTC.AACTTCTGC
CATCCTCTC.AGTGAGAGA	CATCCTCTC.AGTGAGAGA
CATCCTCTC.ATATCAGCC	CATCCTCTC.ATATCAGCC
CATCCTCTC.GAGGTCACG	CATCCTCTC.GAGGTCACG
CATCCTCTC.TAGTGATCC	CATCCTCTC.TAGTGATCC
CATCCTCTC.TCTGTGAAG	CATCCTCTC.TCTGTGAAG
CATCGAAGC.AATCGCCAT	CATCGAAGC.AATCGCCAT
CATCGAAGC.AGGATCTCA	CATCGAAGC.AGGATCTCA
CATCGAAGC.CAGATCATT	CATCGAAGC.CAGATCATT
CATCGAAGC.TAGAGACTA	CATCGAAGC.TAGAGACTA
CATCGAAGC.TCCAGCAGC	CATCGAAGC.TCCAGCAGC
CATCGAAGC.TTGACCTGA	CATCGAAGC.TTGACCTGA
CATCGCTGG.CGCAACCTC	CATCGCTGG.CGCAACCTC
CATCGCTGG.GTAGAGAGC	CATCGCTGG.GTAGAGAGC
CATCGCTGG.TACTTCCAG	CATCGCTGG.TACTTCCAG
CATCGCTGG.TCTGGAGGA	CATCGCTGG.TCTGGAGGA
CATCTCACG.AACAGCAGT	CATCTCACG.AACAGCAGT
CATCTCACG.GATTGGAAG	CATCTCACG.GATTGGAAG
CATCTCACG.GCCACATGG	CATCTCACG.GCCACATGG
CATCTCACG.GCTACCTTA	CATCTCACG.GCTACCTTA
CATCTCACG.TTGACCTGA	CATCTCACG.TTGACCTGA
CATCTCGAT.ACTTCTAAC	CATCTCGAT.ACTTCTAAC
CATCTCGAT.AGCTTCGAT	CATCTCGAT.AGCTTCGAT
CATCTCGAT.ATGCGTGGA	CATCTCGAT.ATGCGTGGA
CATCTCGAT.GCTGATGTC	CATCTCGAT.GCTGATGTC
CATCTCGAT.GCTTGTCCT	CATCTCGAT.GCTTGTCCT
CATCTCGAT.GGAGAATGA	CATCTCGAT.GGAGAATGA
CATGACGTT.ACGCACACT	CATGACGTT.ACGCACACT
CATGACGTT.ACTCACGAA	CATGACGTT.ACTCACGAA
CATGACGTT.AGTTATCGC	CATGACGTT.AGTTATCGC
CATGACGTT.CAGTAATGT	CATGACGTT.CAGTAATGT
CATGACGTT.GACTCTCAC	CATGACGTT.GACTCTCAC
CATGACGTT.GAGGTCCTT	CATGACGTT.GAGGTCCTT
CATGACGTT.GCGAACTCG	CATGACGTT.GCGAACTCG
CATGACGTT.TATGACCGA	CATGACGTT.TATGACCGA
CATGACGTT.TCTGCAACA	CATGACGTT.TCTGCAACA
CATGCCAGT.ATGAGATCC	CATGCCAGT.ATGAGATCC
CATGCCAGT.CCATAATCG	CATGCCAGT.CCATAATCG
CATGCCAGT.CGTAATGAC	CATGCCAGT.CGTAATGAC
CATGCCAGT.CTACGTTGG	CATGCCAGT.CTACGTTGG
CATGCCAGT.CTCTGTCAA	CATGCCAGT.CTCTGTCAA
CATGCCAGT.TAGACACGT	CATGCCAGT.TAGACACGT
CATGCCAGT.TCATCAGAG	CATGCCAGT.TCATCAGAG
CATGGACTC.ATCCTGCCT	CATGGACTC.ATCCTGCCT
CATGGACTC.TGCCAGACG	CATGGACTC.TGCCAGACG
CATGGTCGA.AAGTTCTCT	CATGGTCGA.AAGTTCTCT
CATGGTCGA.ACAGGAACT	CATGGTCGA.ACAGGAACT
CATGGTCGA.ATGGTTCGA	CATGGTCGA.ATGGTTCGA
CATGGTCGA.ATTCACCTC	CATGGTCGA.ATTCACCTC
CATGGTCGA.CAAGCCTCG	CATGGTCGA.CAAGCCTCG
CATGGTCGA.CATCAATAG	CATGGTCGA.CATCAATAG
CATGGTCGA.CATCTCACG	CATGGTCGA.CATCTCACG
CATGGTCGA.CCGGTTCTA	CATGGTCGA.CCGGTTCTA
CATGGTCGA.CGAATCCTG	CATGGTCGA.CGAATCCTG
CATGGTCGA.CTCGCTACG	CATGGTCGA.CTCGCTACG
CATGGTCGA.TCAGCGACC	CATGGTCGA.TCAGCGACC
CATGGTCGA.TCGTCATTC	CATGGTCGA.TCGTCATTC
CATGGTCGA.TCTGATGAA	CATGGTCGA.TCTGATGAA
CATGGTCGA.TGGAGAACC	CATGGTCGA.TGGAGAACC
CATGGTTAC.CAAGAGAGT	CATGGTTAC.CAAGAGAGT
CATGGTTAC.CACTAGACT	CATGGTTAC.CACTAGACT
CATGGTTAC.CACTGGTCC	CATGGTTAC.CACTGGTCC
CATGGTTAC.TGTAGCAAG	CATGGTTAC.TGTAGCAAG
CATGGTTAC.TTGTTAGAG	CATGGTTAC.TTGTTAGAG
CATGTCCTG.ACCATACTT	CATGTCCTG.ACCATACTT
CATGTCCTG.ACGCACACT	CATGTCCTG.ACGCACACT
CATGTCCTG.ATCTGCGTA	CATGTCCTG.ATCTGCGTA
CATGTCCTG.CCGTCAGGT	CATGTCCTG.CCGTCAGGT
CATGTCCTG.CTTCACTGT	CATGTCCTG.CTTCACTGT
CATGTCCTG.GGACACTGG	CATGTCCTG.GGACACTGG
CATGTCCTG.GTGTATCTG	CATGTCCTG.GTGTATCTG
CATGTGAAC.CAGATCGAC	CATGTGAAC.CAGATCGAC
CATGTGAAC.GGATACAAT	CATGTGAAC.GGATACAAT
CATTATGTC.ACTCTGCTC	CATTATGTC.ACTCTGCTC
CATTATGTC.CCTCGAGAG	CATTATGTC.CCTCGAGAG
CATTCAGTT.AACGAGAAT	CATTCAGTT.AACGAGAAT
CATTCAGTT.ACTCCAACT	CATTCAGTT.ACTCCAACT
CATTCAGTT.CGTTGATCC	CATTCAGTT.CGTTGATCC
CATTCAGTT.CTCGCAAGA	CATTCAGTT.CTCGCAAGA
CATTCAGTT.GCTTCTACG	CATTCAGTT.GCTTCTACG
CATTCCGAG.AACGATGAC	CATTCCGAG.AACGATGAC
CATTCCGAG.ACACTAACG	CATTCCGAG.ACACTAACG
CATTCCGAG.ATCAAGCAT	CATTCCGAG.ATCAAGCAT
CATTCCGAG.CACGTAGAC	CATTCCGAG.CACGTAGAC
CATTCCGAG.CCATGCGTC	CATTCCGAG.CCATGCGTC
CATTCCGAG.CGCAACCTC	CATTCCGAG.CGCAACCTC
CATTCCGAG.TAATTCGTG	CATTCCGAG.TAATTCGTG
CATTCCGAG.TGTAACAGT	CATTCCGAG.TGTAACAGT
CATTCCGAG.TGTGTCTAC	CATTCCGAG.TGTGTCTAC
CATTCCGAG.TTACACCTT	CATTCCGAG.TTACACCTT
CATTCGAAT.ACGTGCTCG	CATTCGAAT.ACGTGCTCG
CATTCGAAT.AGTGGAATG	CATTCGAAT.AGTGGAATG
CATTCGAAT.CGTACATCT	CATTCGAAT.CGTACATCT
CATTCGAAT.CTCGACGAT	CATTCGAAT.CTCGACGAT
CATTCGAAT.GCGTATAGG	CATTCGAAT.GCGTATAGG
CATTCGAAT.TCACGCGAC	CATTCGAAT.TCACGCGAC
CATTGACAA.AAGAGAACT	CATTGACAA.AAGAGAACT
CATTGACAA.AGAGCGCGA	CATTGACAA.AGAGCGCGA
CATTGACAA.AGGAGCAAT	CATTGACAA.AGGAGCAAT
CATTGACAA.ATCCTCCGA	CATTGACAA.ATCCTCCGA
CATTGACAA.CAGGATCAA	CATTGACAA.CAGGATCAA
CATTGACAA.CCAGATCAC	CATTGACAA.CCAGATCAC
CATTGACAA.CCGCAACAC	CATTGACAA.CCGCAACAC
CATTGACAA.CGGAACGAG	CATTGACAA.CGGAACGAG
CATTGACAA.TGCTCAGCG	CATTGACAA.TGCTCAGCG
CATTGCAGA.CTCTCAGTC	CATTGCAGA.CTCTCAGTC
CATTGCAGA.CTGTTACCA	CATTGCAGA.CTGTTACCA
CATTGTTCA.TATTACTCG	CATTGTTCA.TATTACTCG
CCAACAACA.ATGGATATC	CCAACAACA.ATGGATATC
CCAACAACA.CCAACAACA	CCAACAACA.CCAACAACA
CCAACGGAA.AGAAGTCCT	CCAACGGAA.AGAAGTCCT
CCAACGGAA.CTATCTTGA	CCAACGGAA.CTATCTTGA
CCAACGGAA.GTTAGAGAC	CCAACGGAA.GTTAGAGAC
CCAAGCGAG.ACCGGTTAC	CCAAGCGAG.ACCGGTTAC
CCAAGCGAG.AGGATCTCA	CCAAGCGAG.AGGATCTCA
CCAAGCGAG.CATTATGTC	CCAAGCGAG.CATTATGTC
CCAAGCGAG.GCTACCGAG	CCAAGCGAG.GCTACCGAG
CCAAGCGAG.GTCGTGTTA	CCAAGCGAG.GTCGTGTTA
CCAAGTCGA.AGTTATCGC	CCAAGTCGA.AGTTATCGC
CCAAGTCGA.CCTCATAAC	CCAAGTCGA.CCTCATAAC
CCAAGTCGA.TGTAGGTTA	CCAAGTCGA.TGTAGGTTA
CCAATATAC.AGGAGGTGA	CCAATATAC.AGGAGGTGA
CCAATATAC.ATGGAGAGT	CCAATATAC.ATGGAGAGT
CCAATATAC.TACCTCCTC	CCAATATAC.TACCTCCTC
CCAATATAC.TTCGCATCC	CCAATATAC.TTCGCATCC
CCAATGCCT.CACAACCAG	CCAATGCCT.CACAACCAG
CCAATGCCT.CGCCTGCAA	CCAATGCCT.CGCCTGCAA
CCAATGCCT.GGTCGGATA	CCAATGCCT.GGTCGGATA
CCAATGCCT.TCGTAGGAA	CCAATGCCT.TCGTAGGAA
CCACACAGA.CCACGCCAT	CCACACAGA.CCACGCCAT
CCACACAGA.GATCTAGAG	CCACACAGA.GATCTAGAG
CCACACAGA.TAGACCTAC	CCACACAGA.TAGACCTAC
CCACACAGA.TCGTTCTCC	CCACACAGA.TCGTTCTCC
CCACATTAG.CAACTCCAG	CCACATTAG.CAACTCCAG
CCACATTAG.GACTTCACC	CCACATTAG.GACTTCACC
CCACATTAG.TCCACCGGT	CCACATTAG.TCCACCGGT
CCACATTAG.TGCGTAATC	CCACATTAG.TGCGTAATC
CCACCATGC.CATCTCGAT	CCACCATGC.CATCTCGAT
CCACCATGC.GTTACTACT	CCACCATGC.GTTACTACT
CCACGAAGG.ACAGCGTAT	CCACGAAGG.ACAGCGTAT
CCACGAAGG.TACCAGCCA	CCACGAAGG.TACCAGCCA
CCACGAAGG.TCTAATACC	CCACGAAGG.TCTAATACC
CCACGAAGG.TGCGTCTTA	CCACGAAGG.TGCGTCTTA
CCACGAAGG.TTCACCTTG	CCACGAAGG.TTCACCTTG
CCACGCCAT.AGTCGCCGA	CCACGCCAT.AGTCGCCGA
CCACGCCAT.GAAGGATCA	CCACGCCAT.GAAGGATCA
CCACGCCAT.GAATCAACC	CCACGCCAT.GAATCAACC
CCACGCCAT.GACACCGAT	CCACGCCAT.GACACCGAT
CCACGCCAT.GCCTTCCAT	CCACGCCAT.GCCTTCCAT
CCACGCCAT.TAGTGCACT	CCACGCCAT.TAGTGCACT
CCACGGATC.ATTCATGTG	CCACGGATC.ATTCATGTG
CCACGGATC.CCAGCCAAT	CCACGGATC.CCAGCCAAT
CCACGGATC.GGTTCGCAA	CCACGGATC.GGTTCGCAA
CCACGTTCT.AACGAGAAT	CCACGTTCT.AACGAGAAT
CCACGTTCT.AACGAGGTG	CCACGTTCT.AACGAGGTG
CCACGTTCT.ACAATTCGG	CCACGTTCT.ACAATTCGG
CCACGTTCT.AGTAACGTA	CCACGTTCT.AGTAACGTA
CCACGTTCT.ATCAAGAGA	CCACGTTCT.ATCAAGAGA
CCACGTTCT.CCTCGGTCA	CCACGTTCT.CCTCGGTCA
CCACGTTCT.CTACGAGAA	CCACGTTCT.CTACGAGAA
CCACGTTCT.GATACTGTG	CCACGTTCT.GATACTGTG
CCACGTTCT.GCTTACTAG	CCACGTTCT.GCTTACTAG
CCACGTTCT.GTCGCAGGT	CCACGTTCT.GTCGCAGGT
CCACGTTCT.TCGGACAGT	CCACGTTCT.TCGGACAGT
CCACGTTCT.TGGAAGATT	CCACGTTCT.TGGAAGATT
CCACTACCA.AACGCTCAA	CCACTACCA.AACGCTCAA
CCACTACCA.ACCGGAGTA	CCACTACCA.ACCGGAGTA
CCACTACCA.ATCCAGCTG	CCACTACCA.ATCCAGCTG
CCACTACCA.CCGATGTTC	CCACTACCA.CCGATGTTC
CCACTACCA.TCCACCTCA	CCACTACCA.TCCACCTCA
CCACTGAAG.ACCTTGAAG	CCACTGAAG.ACCTTGAAG
CCACTGAAG.ATTCGAAGA	CCACTGAAG.ATTCGAAGA
CCACTGAAG.GCGACCTGT	CCACTGAAG.GCGACCTGT
CCACTGAAG.TCATGCAGG	CCACTGAAG.TCATGCAGG
CCACTGAAG.TCGGTATCA	CCACTGAAG.TCGGTATCA
CCACTTCGC.CCTACTAGA	CCACTTCGC.CCTACTAGA
CCACTTCGC.CGACCTAGC	CCACTTCGC.CGACCTAGC
CCACTTCGC.CGGTCGACA	CCACTTCGC.CGGTCGACA
CCACTTCGC.TCCAGAACG	CCACTTCGC.TCCAGAACG
CCAGATCAC.ACGGACCAT	CCAGATCAC.ACGGACCAT
CCAGATCAC.ACTTCTAAC	CCAGATCAC.ACTTCTAAC
CCAGATCAC.ATAGTGGTT	CCAGATCAC.ATAGTGGTT
CCAGATCAC.CACTAGACT	CCAGATCAC.CACTAGACT
CCAGATCAC.CCTCGGTCA	CCAGATCAC.CCTCGGTCA
CCAGCCAAT.AGTACGAAT	CCAGCCAAT.AGTACGAAT
CCAGCCAAT.CACTGGTCC	CCAGCCAAT.CACTGGTCC
CCAGCCAAT.CAGAGCACC	CCAGCCAAT.CAGAGCACC
CCAGCCAAT.CCGTCCACT	CCAGCCAAT.CCGTCCACT
CCAGCCAAT.GTGTTGGAA	CCAGCCAAT.GTGTTGGAA
CCAGCCAAT.TAAGCCATT	CCAGCCAAT.TAAGCCATT
CCAGGAGTT.CAATCTCCG	CCAGGAGTT.CAATCTCCG
CCAGGAGTT.GGAGATGAG	CCAGGAGTT.GGAGATGAG
CCAGGAGTT.GGTGAGCGT	CCAGGAGTT.GGTGAGCGT
CCAGGAGTT.GTAGTGGAG	CCAGGAGTT.GTAGTGGAG
CCAGGAGTT.GTTAGTCAA	CCAGGAGTT.GTTAGTCAA
CCAGGAGTT.TTCCGCCAG	CCAGGAGTT.TTCCGCCAG
CCAGTACTC.ACGTGCTCG	CCAGTACTC.ACGTGCTCG
CCAGTACTC.CAGCAGTAC	CCAGTACTC.CAGCAGTAC
CCAGTACTC.CCGATCTCT	CCAGTACTC.CCGATCTCT
CCAGTACTC.CGCGCACAT	CCAGTACTC.CGCGCACAT
CCAGTACTC.CGTCTGTCC	CCAGTACTC.CGTCTGTCC
CCAGTACTC.CTGTGGTGG	CCAGTACTC.CTGTGGTGG
CCAGTACTC.TAATCACGC	CCAGTACTC.TAATCACGC
CCAGTACTC.TGATAGAGG	CCAGTACTC.TGATAGAGG
CCAGTCTCA.ATGCGCCGT	CCAGTCTCA.ATGCGCCGT
CCAGTCTCA.TATACCACT	CCAGTCTCA.TATACCACT
CCAGTCTCA.TGCAGATGC	CCAGTCTCA.TGCAGATGC
CCAGTTACG.ATCGCCTCT	CCAGTTACG.ATCGCCTCT
CCAGTTACG.GCACATGTT	CCAGTTACG.GCACATGTT
CCAGTTACG.TGGAAGATT	CCAGTTACG.TGGAAGATT
CCATAAGTA.CACTAGACT	CCATAAGTA.CACTAGACT
CCATAAGTA.CGCGATGTA	CCATAAGTA.CGCGATGTA
CCATAAGTA.TGCTCACAC	CCATAAGTA.TGCTCACAC
CCATAAGTA.TGGATTAGC	CCATAAGTA.TGGATTAGC
CCATAATCG.ACACACCGT	CCATAATCG.ACACACCGT
CCATAATCG.ACAGAGATG	CCATAATCG.ACAGAGATG
CCATAATCG.ACCATGTCT	CCATAATCG.ACCATGTCT
CCATAATCG.ATGCGTGGA	CCATAATCG.ATGCGTGGA
CCATAATCG.CAACACCTA	CCATAATCG.CAACACCTA
CCATAATCG.CTATTAAGG	CCATAATCG.CTATTAAGG
CCATAATCG.TAACACGAG	CCATAATCG.TAACACGAG
CCATAATCG.TAGTAGTCT	CCATAATCG.TAGTAGTCT
CCATACGAT.CCGGTTCTA	CCATACGAT.CCGGTTCTA
CCATACGAT.CGTATAGCG	CCATACGAT.CGTATAGCG
CCATACGAT.CTGTCACTT	CCATACGAT.CTGTCACTT
CCATACGAT.GATGCGGTT	CCATACGAT.GATGCGGTT
CCATACGAT.GTGCATCAA	CCATACGAT.GTGCATCAA
CCATACGAT.TGGAGAACC	CCATACGAT.TGGAGAACC
CCATAGCCA.CCGAATATG	CCATAGCCA.CCGAATATG
CCATAGCCA.GATTGAGTA	CCATAGCCA.GATTGAGTA
CCATAGCCA.TCCTTCGTA	CCATAGCCA.TCCTTCGTA
CCATAGCCA.TGTACACGA	CCATAGCCA.TGTACACGA
CCATATCTT.CGGTGAGTC	CCATATCTT.CGGTGAGTC
CCATATCTT.GAACTATGG	CCATATCTT.GAACTATGG
CCATATCTT.GAATTGTTG	CCATATCTT.GAATTGTTG
CCATATCTT.GGTCCTGGT	CCATATCTT.GGTCCTGGT
CCATATCTT.GTAGGACGC	CCATATCTT.GTAGGACGC
CCATATGCC.ACACCACAT	CCATATGCC.ACACCACAT
CCATATGCC.CACTGGTCC	CCATATGCC.CACTGGTCC
CCATATGCC.CGTGAGACT	CCATATGCC.CGTGAGACT
CCATATGCC.CTCCACGTC	CCATATGCC.CTCCACGTC
CCATATGCC.GACGCCGTA	CCATATGCC.GACGCCGTA
CCATATGCC.GTACAATGC	CCATATGCC.GTACAATGC
CCATCACGA.AACGCTCAA	CCATCACGA.AACGCTCAA
CCATCACGA.CCTGCTCCA	CCATCACGA.CCTGCTCCA
CCATCACGA.CTCGTGTCC	CCATCACGA.CTCGTGTCC
CCATCTAGG.AACGCTCAA	CCATCTAGG.AACGCTCAA
CCATCTAGG.ACATTGACA	CCATCTAGG.ACATTGACA
CCATCTAGG.TCTATGACA	CCATCTAGG.TCTATGACA
CCATGATGT.AGCAGACAA	CCATGATGT.AGCAGACAA
CCATGATGT.AGTAATCAG	CCATGATGT.AGTAATCAG
CCATGATGT.ATCATAGAC	CCATGATGT.ATCATAGAC
CCATGATGT.CATGCCAGT	CCATGATGT.CATGCCAGT
CCATGATGT.CGACCATCA	CCATGATGT.CGACCATCA
CCATGATGT.TACATGCAC	CCATGATGT.TACATGCAC
CCATGATGT.TGGTGGATC	CCATGATGT.TGGTGGATC
CCATGCGTC.ACCATCTAA	CCATGCGTC.ACCATCTAA
CCATGCGTC.CAAGCCTCG	CCATGCGTC.CAAGCCTCG
CCATGCGTC.GTCGTTGCG	CCATGCGTC.GTCGTTGCG
CCATGCGTC.GTTGACCAT	CCATGCGTC.GTTGACCAT
CCATTACAG.CATTCAGTT	CCATTACAG.CATTCAGTT
CCATTACAG.GTGGTTACC	CCATTACAG.GTGGTTACC
CCATTACAG.TCCTATTCC	CCATTACAG.TCCTATTCC
CCATTCTGC.CACAACGCT	CCATTCTGC.CACAACGCT
CCATTCTGC.CACGACTCA	CCATTCTGC.CACGACTCA
CCATTCTGC.GTCGACATT	CCATTCTGC.GTCGACATT
CCATTCTGC.GTCTGAGCC	CCATTCTGC.GTCTGAGCC
CCATTCTGC.TAGTGCACT	CCATTCTGC.TAGTGCACT
CCGAAGCGT.CGTACACAC	CCGAAGCGT.CGTACACAC
CCGAAGCGT.CTAACACTG	CCGAAGCGT.CTAACACTG
CCGAAGCGT.GCTTGTCCT	CCGAAGCGT.GCTTGTCCT
