GCACAGTAA.TGTCATAGC	GCACAGTAA.TGTCATAGC
GCACAGTAA.TTAACGGAG	GCACAGTAA.TTAACGGAG
GCACATGTT.AAGTACAGA	GCACATGTT.AAGTACAGA
GCACATGTT.AGAAGCTGC	GCACATGTT.AGAAGCTGC
GCACATGTT.CTTGGATCA	GCACATGTT.CTTGGATCA
GCACATGTT.GTAGAAGTT	GCACATGTT.GTAGAAGTT
GCACATGTT.GTTATCGAT	GCACATGTT.GTTATCGAT
GCACATGTT.TCACGCGAC	GCACATGTT.TCACGCGAC
GCACATGTT.TGAGCTAGA	GCACATGTT.TGAGCTAGA
GCACATGTT.TTACGGACC	GCACATGTT.TTACGGACC
GCACCATCG.AGTCGCCGA	GCACCATCG.AGTCGCCGA
GCACCATCG.CAACCTGGT	GCACCATCG.CAACCTGGT
GCACCATCG.CCACACAGA	GCACCATCG.CCACACAGA
GCACGCATT.AGAAGAGTC	GCACGCATT.AGAAGAGTC
GCACGCATT.AGGATCTCA	GCACGCATT.AGGATCTCA
GCACGCATT.CACGCGTAA	GCACGCATT.CACGCGTAA
GCACGCATT.CATTGCAGA	GCACGCATT.CATTGCAGA
GCACGCATT.CTGCAGAGC	GCACGCATT.CTGCAGAGC
GCACGCATT.GATATGGAC	GCACGCATT.GATATGGAC
GCACGCATT.GCCAACAAT	GCACGCATT.GCCAACAAT
GCACGCATT.GTGATGTGC	GCACGCATT.GTGATGTGC
GCACGCATT.GTTCACTCC	GCACGCATT.GTTCACTCC
GCACGCATT.TATGAGACC	GCACGCATT.TATGAGACC
GCACGCATT.TGAGAGGAC	GCACGCATT.TGAGAGGAC
GCACGTAGA.AAGGAAGTC	GCACGTAGA.AAGGAAGTC
GCACGTAGA.CCACGCCAT	GCACGTAGA.CCACGCCAT
GCACGTAGA.CTCTACGCA	GCACGTAGA.CTCTACGCA
GCACGTAGA.GCACAACTC	GCACGTAGA.GCACAACTC
GCACGTAGA.GGAGCTCAA	GCACGTAGA.GGAGCTCAA
GCACGTAGA.GTAACGCGA	GCACGTAGA.GTAACGCGA
GCACTGGAT.ACCTTGAAG	GCACTGGAT.ACCTTGAAG
GCACTGGAT.CACTACAGG	GCACTGGAT.CACTACAGG
GCACTGGAT.CATACGCAG	GCACTGGAT.CATACGCAG
GCACTGGAT.CGGTTCGTA	GCACTGGAT.CGGTTCGTA
GCACTGGAT.CTCGTTCAC	GCACTGGAT.CTCGTTCAC
GCACTGGAT.TGCGCTGCA	GCACTGGAT.TGCGCTGCA
GCAGATCCG.CTGACGATG	GCAGATCCG.CTGACGATG
GCAGATCCG.TAATCTGGA	GCAGATCCG.TAATCTGGA
GCAGATCCG.TATGTATGC	GCAGATCCG.TATGTATGC
GCAGCAGTG.AACAGCAGT	GCAGCAGTG.AACAGCAGT
GCAGCAGTG.CGGTTGCGA	GCAGCAGTG.CGGTTGCGA
GCAGCAGTG.GATACTGTG	GCAGCAGTG.GATACTGTG
GCAGCAGTG.GGATGCTCG	GCAGCAGTG.GGATGCTCG
GCAGCAGTG.GTAAGGTCC	GCAGCAGTG.GTAAGGTCC
GCAGCAGTG.TGCCGAACT	GCAGCAGTG.TGCCGAACT
GCAGCAGTG.TTGTATCAC	GCAGCAGTG.TTGTATCAC
GCAGCGATA.GCAGCGATA	GCAGCGATA.GCAGCGATA
GCAGCGATA.TAGTTGACG	GCAGCGATA.TAGTTGACG
GCAGCTCTT.ACAGGTATC	GCAGCTCTT.ACAGGTATC
GCAGCTCTT.AGTACGAAT	GCAGCTCTT.AGTACGAAT
GCAGCTCTT.ATAGCCTAA	GCAGCTCTT.ATAGCCTAA
GCAGCTCTT.CCACGGATC	GCAGCTCTT.CCACGGATC
GCAGCTCTT.GCACGTAGA	GCAGCTCTT.GCACGTAGA
GCAGCTCTT.TGCCTGGTT	GCAGCTCTT.TGCCTGGTT
GCAGCTTGA.ACACTAACG	GCAGCTTGA.ACACTAACG
GCAGCTTGA.CAAGTCGAA	GCAGCTTGA.CAAGTCGAA
GCAGCTTGA.CCTCCTTGT	GCAGCTTGA.CCTCCTTGT
GCAGCTTGA.GAGATTCCT	GCAGCTTGA.GAGATTCCT
GCAGCTTGA.GATAACGTC	GCAGCTTGA.GATAACGTC
GCAGCTTGA.GATCGCACT	GCAGCTTGA.GATCGCACT
GCAGCTTGA.GCATGTAAG	GCAGCTTGA.GCATGTAAG
GCAGCTTGA.GCGTAACAA	GCAGCTTGA.GCGTAACAA
GCAGCTTGA.GTAGACTCT	GCAGCTTGA.GTAGACTCT
GCAGCTTGA.TAATCTGGA	GCAGCTTGA.TAATCTGGA
GCAGGAGAA.ATGCCTTCA	GCAGGAGAA.ATGCCTTCA
GCAGGAGAA.CGTATCGAA	GCAGGAGAA.CGTATCGAA
GCAGGAGAA.GCCAACAAT	GCAGGAGAA.GCCAACAAT
GCAGGAGAA.TAATGTAGC	GCAGGAGAA.TAATGTAGC
GCAGGAGAA.TTACGCTCG	GCAGGAGAA.TTACGCTCG
GCATACATG.AAGTAGGAC	GCATACATG.AAGTAGGAC
GCATACATG.ATTCGCTTA	GCATACATG.ATTCGCTTA
GCATACATG.CGGAATGCA	GCATACATG.CGGAATGCA
GCATACATG.CTAGACATG	GCATACATG.CTAGACATG
GCATACATG.CTAGGTACT	GCATACATG.CTAGGTACT
GCATACATG.GCATGTGGT	GCATACATG.GCATGTGGT
GCATACATG.GTGCACGAG	GCATACATG.GTGCACGAG
GCATACATG.TACTCGACC	GCATACATG.TACTCGACC
GCATACATG.TGGAAGATT	GCATACATG.TGGAAGATT
GCATACTCC.AGACGCTAT	GCATACTCC.AGACGCTAT
GCATACTCC.CACGTAGAC	GCATACTCC.CACGTAGAC
GCATACTCC.GAACTGCAA	GCATACTCC.GAACTGCAA
GCATACTCC.TTCAACTAC	GCATACTCC.TTCAACTAC
GCATACTCC.TTCCGCCAG	GCATACTCC.TTCCGCCAG
GCATACTCC.TTGCGAACA	GCATACTCC.TTGCGAACA
GCATGTAAG.AAGTAGGAC	GCATGTAAG.AAGTAGGAC
GCATGTAAG.AGTTAGGTC	GCATGTAAG.AGTTAGGTC
GCATGTAAG.CATGTCCTG	GCATGTAAG.CATGTCCTG
GCATGTAAG.CCGAAGCGT	GCATGTAAG.CCGAAGCGT
GCATGTAAG.GCCATTAAG	GCATGTAAG.GCCATTAAG
GCATGTAAG.GTGTCCGTG	GCATGTAAG.GTGTCCGTG
GCATGTAAG.TACAACACC	GCATGTAAG.TACAACACC
GCATGTAAG.TATCGGAAC	GCATGTAAG.TATCGGAAC
GCATGTAAG.TCACGACAA	GCATGTAAG.TCACGACAA
GCATGTAAG.TGAGAATCC	GCATGTAAG.TGAGAATCC
GCATGTGGT.AACTAACTG	GCATGTGGT.AACTAACTG
GCATGTGGT.ACCGTCACG	GCATGTGGT.ACCGTCACG
GCATGTGGT.AGACTAGTA	GCATGTGGT.AGACTAGTA
GCATGTGGT.AGTCATACT	GCATGTGGT.AGTCATACT
GCATGTGGT.CCTAAGTCT	GCATGTGGT.CCTAAGTCT
GCATGTGGT.CTTGGTCAT	GCATGTGGT.CTTGGTCAT
GCATGTGGT.GTCAATACA	GCATGTGGT.GTCAATACA
GCATGTGGT.TCAGTAAGC	GCATGTGGT.TCAGTAAGC
GCATGTGGT.TGACTGAGA	GCATGTGGT.TGACTGAGA
GCATTGATC.CTCAGTGAT	GCATTGATC.CTCAGTGAT
GCCAACAAT.CAGTACATC	GCCAACAAT.CAGTACATC
GCCAACAAT.GAATCACAT	GCCAACAAT.GAATCACAT
GCCAACAAT.TACGAGTGA	GCCAACAAT.TACGAGTGA
GCCAACAAT.TGCCGCTAC	GCCAACAAT.TGCCGCTAC
GCCAACAAT.TTAAGTGGT	GCCAACAAT.TTAAGTGGT
GCCAATGAA.AGCGGTAAG	GCCAATGAA.AGCGGTAAG
GCCAATGAA.GATAAGCTG	GCCAATGAA.GATAAGCTG
GCCAATGAA.GTAATATCG	GCCAATGAA.GTAATATCG
GCCAATGAA.TCAGGTGCA	GCCAATGAA.TCAGGTGCA
GCCACATGG.AAGACTACC	GCCACATGG.AAGACTACC
GCCACATGG.AGATCGAGT	GCCACATGG.AGATCGAGT
GCCACATGG.CCTCAGGTG	GCCACATGG.CCTCAGGTG
GCCACATGG.GATGTAAGG	GCCACATGG.GATGTAAGG
GCCACATGG.GTGTCGAGC	GCCACATGG.GTGTCGAGC
GCCACGAGT.GCTACCGAG	GCCACGAGT.GCTACCGAG
GCCACGAGT.GGTGAGCGT	GCCACGAGT.GGTGAGCGT
GCCACGAGT.GTGTCGAGC	GCCACGAGT.GTGTCGAGC
GCCACGAGT.TAAGTACAC	GCCACGAGT.TAAGTACAC
GCCACGAGT.TTCACTGGA	GCCACGAGT.TTCACTGGA
GCCATACAA.GACCAGAGA	GCCATACAA.GACCAGAGA
GCCATACAA.GAGAACAGG	GCCATACAA.GAGAACAGG
GCCATCGCT.TCATGCTCA	GCCATCGCT.TCATGCTCA
GCCATTAAG.AAGGAACAG	GCCATTAAG.AAGGAACAG
GCCATTAAG.ATAACGACA	GCCATTAAG.ATAACGACA
GCCATTAAG.CCACATTAG	GCCATTAAG.CCACATTAG
GCCATTAAG.GTCAGCGTC	GCCATTAAG.GTCAGCGTC
GCCATTAAG.TGATGACAG	GCCATTAAG.TGATGACAG
GCCGAACCA.ACCATTCAC	GCCGAACCA.ACCATTCAC
GCCGAACCA.AGCATTCCA	GCCGAACCA.AGCATTCCA
GCCGAACCA.CACTTCCTT	GCCGAACCA.CACTTCCTT
GCCGAACCA.CAGTGCCAT	GCCGAACCA.CAGTGCCAT
GCCGAACCA.CGTGTATTC	GCCGAACCA.CGTGTATTC
GCCGAACCA.CTTAGGACT	GCCGAACCA.CTTAGGACT
GCCGAACCA.GCACATGTT	GCCGAACCA.GCACATGTT
GCCGAACCA.TCACTACGT	GCCGAACCA.TCACTACGT
GCCGAACCA.TCCACCGGT	GCCGAACCA.TCCACCGGT
GCCGAGTCT.ATTGATCAC	GCCGAGTCT.ATTGATCAC
GCCGAGTCT.CCAGATCAC	GCCGAGTCT.CCAGATCAC
GCCGAGTCT.CGTTCGTAC	GCCGAGTCT.CGTTCGTAC
GCCGAGTCT.CTAACACTG	GCCGAGTCT.CTAACACTG
GCCGAGTCT.CTCTCAGTC	GCCGAGTCT.CTCTCAGTC
GCCGAGTCT.GCAGGAGAA	GCCGAGTCT.GCAGGAGAA
GCCGCCTAA.CAGAGCACC	GCCGCCTAA.CAGAGCACC
GCCGCCTAA.CGTCAGCAC	GCCGCCTAA.CGTCAGCAC
GCCGCCTAA.CTGACAGCA	GCCGCCTAA.CTGACAGCA
GCCGCCTAA.GGATAGTCA	GCCGCCTAA.GGATAGTCA
GCCGCCTAA.GTACGAACG	GCCGCCTAA.GTACGAACG
GCCGCCTAA.GTGCACGAG	GCCGCCTAA.GTGCACGAG
GCCGCCTAA.TCTATTAGG	GCCGCCTAA.TCTATTAGG
GCCGCTATC.ACCGGTTAC	GCCGCTATC.ACCGGTTAC
GCCGCTATC.ACTCACGAA	GCCGCTATC.ACTCACGAA
GCCGCTATC.ACTCCGTCG	GCCGCTATC.ACTCCGTCG
GCCGCTATC.CGACCACTT	GCCGCTATC.CGACCACTT
GCCGCTATC.CTAATACGC	GCCGCTATC.CTAATACGC
GCCGCTATC.CTACTGTCA	GCCGCTATC.CTACTGTCA
GCCGCTATC.GCATTGATC	GCCGCTATC.GCATTGATC
GCCGCTATC.GGAAGGTAT	GCCGCTATC.GGAAGGTAT
GCCGCTATC.TAGTAACGG	GCCGCTATC.TAGTAACGG
GCCGCTATC.TGTTGTCGA	GCCGCTATC.TGTTGTCGA
GCCGTCTTC.CTAACCGGT	GCCGTCTTC.CTAACCGGT
GCCGTCTTC.CTAGTATAG	GCCGTCTTC.CTAGTATAG
GCCGTCTTC.CTGAGATAG	GCCGTCTTC.CTGAGATAG
GCCGTCTTC.GATTAGTGT	GCCGTCTTC.GATTAGTGT
GCCGTCTTC.TATCAGTGC	GCCGTCTTC.TATCAGTGC
GCCGTGAAC.AACCATGGT	GCCGTGAAC.AACCATGGT
GCCGTGAAC.ATCCACAGT	GCCGTGAAC.ATCCACAGT
GCCGTGAAC.CAGCACGTG	GCCGTGAAC.CAGCACGTG
GCCGTGAAC.GCAGCGATA	GCCGTGAAC.GCAGCGATA
GCCGTGAAC.GCGACAACC	GCCGTGAAC.GCGACAACC
GCCGTGAAC.TTCCTAAGG	GCCGTGAAC.TTCCTAAGG
GCCGTTGTT.CCTCGACCT	GCCGTTGTT.CCTCGACCT
GCCGTTGTT.TCCTGTCCG	GCCGTTGTT.TCCTGTCCG
GCCGTTGTT.TGTACACGA	GCCGTTGTT.TGTACACGA
GCCTAACGG.CGGTTGCGA	GCCTAACGG.CGGTTGCGA
GCCTAACGG.CTACGTTGG	GCCTAACGG.CTACGTTGG
GCCTAACGG.GTGCTCGGA	GCCTAACGG.GTGCTCGGA
GCCTAACGG.GTGTCCGTG	GCCTAACGG.GTGTCCGTG
GCCTAACGG.TCGTCCGAT	GCCTAACGG.TCGTCCGAT
GCCTAACGG.TTCCTCGGT	GCCTAACGG.TTCCTCGGT
GCCTGCATC.ACTCTCACA	GCCTGCATC.ACTCTCACA
GCCTGCATC.AGCCTCGCA	GCCTGCATC.AGCCTCGCA
GCCTGCATC.CCATTCTGC	GCCTGCATC.CCATTCTGC
GCCTGCATC.GAATTGTTG	GCCTGCATC.GAATTGTTG
GCCTGCATC.GCGACACAG	GCCTGCATC.GCGACACAG
GCCTGCATC.GCTGACAGA	GCCTGCATC.GCTGACAGA
GCCTGCATC.GGAAGGTAT	GCCTGCATC.GGAAGGTAT
GCCTGCATC.GTACAATGC	GCCTGCATC.GTACAATGC
GCCTGCATC.TCTCCGCGT	GCCTGCATC.TCTCCGCGT
GCCTGCATC.TGGATTAGC	GCCTGCATC.TGGATTAGC
GCCTGGAAT.ATCCAGCTG	GCCTGGAAT.ATCCAGCTG
GCCTGGAAT.CCGAATATG	GCCTGGAAT.CCGAATATG
GCCTGGAAT.CTGAGATAG	GCCTGGAAT.CTGAGATAG
GCCTGGAAT.GGAGCATCT	GCCTGGAAT.GGAGCATCT
GCCTGGAAT.GTACGCGAT	GCCTGGAAT.GTACGCGAT
GCCTGGAAT.TTCTGGTGC	GCCTGGAAT.TTCTGGTGC
GCCTGGAAT.TTGTAATGC	GCCTGGAAT.TTGTAATGC
GCCTTAGAG.ACTTCTAAC	GCCTTAGAG.ACTTCTAAC
GCCTTAGAG.CAACGATCG	GCCTTAGAG.CAACGATCG
GCCTTAGAG.GGTGGAGCT	GCCTTAGAG.GGTGGAGCT
GCCTTAGAG.TCCAATCAT	GCCTTAGAG.TCCAATCAT
GCCTTAGAG.TTGGAGAAC	GCCTTAGAG.TTGGAGAAC
GCCTTATCT.ACTCCTGAG	GCCTTATCT.ACTCCTGAG
GCCTTATCT.ATCAAGAGA	GCCTTATCT.ATCAAGAGA
GCCTTATCT.CCGGTGGTT	GCCTTATCT.CCGGTGGTT
GCCTTCCAT.ACACCACAT	GCCTTCCAT.ACACCACAT
GCCTTCCAT.ACCGAGACA	GCCTTCCAT.ACCGAGACA
GCCTTCCAT.CAACACTCC	GCCTTCCAT.CAACACTCC
GCCTTCCAT.CCTGTCATT	GCCTTCCAT.CCTGTCATT
GCCTTCCAT.GTGGATAAG	GCCTTCCAT.GTGGATAAG
GCCTTCCAT.TAGTGCACT	GCCTTCCAT.TAGTGCACT
GCCTTCCAT.TGGTAGCAG	GCCTTCCAT.TGGTAGCAG
GCCTTCCAT.TTGTTAGAG	GCCTTCCAT.TTGTTAGAG
GCCTTGTGA.CTGACAGCA	GCCTTGTGA.CTGACAGCA
GCCTTGTGA.GAACGCTGT	GCCTTGTGA.GAACGCTGT
GCGAACTCG.GCGAGCAAG	GCGAACTCG.GCGAGCAAG
GCGAACTCG.GCTACCTTA	GCGAACTCG.GCTACCTTA
GCGAAGACA.AACCGCTGA	GCGAAGACA.AACCGCTGA
GCGAAGACA.ACTAAGTTC	GCGAAGACA.ACTAAGTTC
GCGAAGACA.CAACCTGGT	GCGAAGACA.CAACCTGGT
GCGAAGCTC.ATGACACAA	GCGAAGCTC.ATGACACAA
GCGAAGCTC.CAGTGCCAT	GCGAAGCTC.CAGTGCCAT
GCGAAGCTC.GACTATTGA	GCGAAGCTC.GACTATTGA
GCGAAGCTC.TACCATGTA	GCGAAGCTC.TACCATGTA
GCGAAGCTC.TGACCTATG	GCGAAGCTC.TGACCTATG
GCGAAGCTC.TGCTTACGG	GCGAAGCTC.TGCTTACGG
GCGACAACC.ATCTCTGCT	GCGACAACC.ATCTCTGCT
GCGACAACC.ATCTGCGTA	GCGACAACC.ATCTGCGTA
GCGACAACC.TCCACCTCA	GCGACAACC.TCCACCTCA
GCGACAACC.TTACAGTGT	GCGACAACC.TTACAGTGT
GCGACACAG.ACCAGCGTT	GCGACACAG.ACCAGCGTT
GCGACACAG.AGACATATC	GCGACACAG.AGACATATC
GCGACACAG.CCTAGCAAT	GCGACACAG.CCTAGCAAT
GCGACACAG.GCAGCTCTT	GCGACACAG.GCAGCTCTT
GCGACCTGT.AGGAATTGG	GCGACCTGT.AGGAATTGG
GCGACCTGT.AGTGTTCTG	GCGACCTGT.AGTGTTCTG
GCGACCTGT.CTCGCTACG	GCGACCTGT.CTCGCTACG
GCGACCTGT.TAGTGCACT	GCGACCTGT.TAGTGCACT
GCGACCTGT.TGCCAGACG	GCGACCTGT.TGCCAGACG
GCGAGCAAG.ATAATCGAG	GCGAGCAAG.ATAATCGAG
GCGAGCAAG.ATATCCGAT	GCGAGCAAG.ATATCCGAT
GCGAGCAAG.CAACACTCC	GCGAGCAAG.CAACACTCC
GCGAGCAAG.CCATGCGTC	GCGAGCAAG.CCATGCGTC
GCGAGCAAG.CCGCTATCC	GCGAGCAAG.CCGCTATCC
GCGAGCAAG.CTATTCCGT	GCGAGCAAG.CTATTCCGT
GCGAGCAAG.GAAGTGTGA	GCGAGCAAG.GAAGTGTGA
GCGAGCAAG.GTGCGTTCC	GCGAGCAAG.GTGCGTTCC
GCGAGCAAG.TCAGAGTCA	GCGAGCAAG.TCAGAGTCA
GCGAGCAAG.TCCAGCAGC	GCGAGCAAG.TCCAGCAGC
GCGAGCAAG.TCCGATAAC	GCGAGCAAG.TCCGATAAC
GCGAGCAAG.TGAGCAGAT	GCGAGCAAG.TGAGCAGAT
GCGAGCAAG.TGATCTCGG	GCGAGCAAG.TGATCTCGG
GCGAGCAAG.TGCGCTGCA	GCGAGCAAG.TGCGCTGCA
GCGAGTCTA.CATCCAGGA	GCGAGTCTA.CATCCAGGA
GCGAGTCTA.GCACCATCG	GCGAGTCTA.GCACCATCG
GCGAGTCTA.TCGACGTTG	GCGAGTCTA.TCGACGTTG
GCGAGTCTA.TGCCTGGTT	GCGAGTCTA.TGCCTGGTT
GCGATATGA.AGGATTGAG	GCGATATGA.AGGATTGAG
GCGATATGA.CATCGAAGC	GCGATATGA.CATCGAAGC
GCGATATGA.CTATCTTGA	GCGATATGA.CTATCTTGA
GCGATATGA.GTAAGGTCC	GCGATATGA.GTAAGGTCC
GCGATGGTG.ACGCGACAG	GCGATGGTG.ACGCGACAG
GCGATGGTG.AGCTACTCA	GCGATGGTG.AGCTACTCA
GCGATGGTG.GCTAGCTCC	GCGATGGTG.GCTAGCTCC
GCGATGGTG.GGTGCGTAG	GCGATGGTG.GGTGCGTAG
GCGATGGTG.GTGTACCGT	GCGATGGTG.GTGTACCGT
GCGATGGTG.TATTGACTG	GCGATGGTG.TATTGACTG
GCGCATTAC.AGCTTGGTG	GCGCATTAC.AGCTTGGTG
GCGCATTAC.ATCCGTCTC	GCGCATTAC.ATCCGTCTC
GCGCATTAC.TACCTCACT	GCGCATTAC.TACCTCACT
GCGCATTAC.TCAGACAAG	GCGCATTAC.TCAGACAAG
GCGCTACCT.ACTACCATC	GCGCTACCT.ACTACCATC
GCGCTACCT.AGACTTCGT	GCGCTACCT.AGACTTCGT
GCGCTACCT.AGATCTTCA	GCGCTACCT.AGATCTTCA
GCGCTACCT.GTTAGATTG	GCGCTACCT.GTTAGATTG
GCGCTAGAA.CTATCCATC	GCGCTAGAA.CTATCCATC
GCGCTAGAA.GATACACTA	GCGCTAGAA.GATACACTA
GCGCTAGAA.TGAGCAGAT	GCGCTAGAA.TGAGCAGAT
GCGCTCTAT.AGCTTGGTG	GCGCTCTAT.AGCTTGGTG
GCGCTCTAT.AGTGTGCAC	GCGCTCTAT.AGTGTGCAC
GCGCTCTAT.ATCCGTCTC	GCGCTCTAT.ATCCGTCTC
GCGCTCTAT.CACCTAGCG	GCGCTCTAT.CACCTAGCG
GCGCTTCTC.AGCGGTCTA	GCGCTTCTC.AGCGGTCTA
GCGCTTCTC.CCGAAGCGT	GCGCTTCTC.CCGAAGCGT
GCGCTTCTC.GAGGTCCTT	GCGCTTCTC.GAGGTCCTT
GCGCTTCTC.GCTTCACTC	GCGCTTCTC.GCTTCACTC
GCGGACGAA.ATAAGACAG	GCGGACGAA.ATAAGACAG
GCGGACGAA.CCGTACGGA	GCGGACGAA.CCGTACGGA
GCGGACGAA.CGAACAATC	GCGGACGAA.CGAACAATC
GCGGACGAA.GACGTTCAG	GCGGACGAA.GACGTTCAG
GCGGACGAA.GCCTTAGAG	GCGGACGAA.GCCTTAGAG
GCGGACGAA.TTGGACTTC	GCGGACGAA.TTGGACTTC
GCGGAGATT.AACGTTCTT	GCGGAGATT.AACGTTCTT
GCGGAGATT.AAGGTGCTG	GCGGAGATT.AAGGTGCTG
GCGGAGATT.ATGAACTAG	GCGGAGATT.ATGAACTAG
GCGGAGATT.ATGTCCTCC	GCGGAGATT.ATGTCCTCC
GCGGTAAGT.AAGCCACAC	GCGGTAAGT.AAGCCACAC
GCGGTAAGT.AGTAAGCCA	GCGGTAAGT.AGTAAGCCA
GCGGTAAGT.GAGACGATC	GCGGTAAGT.GAGACGATC
GCGGTAAGT.GATCTAGAG	GCGGTAAGT.GATCTAGAG
GCGGTAAGT.GTAGCATAC	GCGGTAAGT.GTAGCATAC
GCGGTAAGT.GTTAGATTG	GCGGTAAGT.GTTAGATTG
GCGGTAAGT.TGATTCACC	GCGGTAAGT.TGATTCACC
GCGGTAAGT.TGCATACAT	GCGGTAAGT.TGCATACAT
GCGGTAAGT.TTCGCATCC	GCGGTAAGT.TTCGCATCC
GCGGTAGTC.AATCAGGAG	GCGGTAGTC.AATCAGGAG
GCGGTAGTC.CATGGTCGA	GCGGTAGTC.CATGGTCGA
GCGGTAGTC.GGAACCTAG	GCGGTAGTC.GGAACCTAG
GCGTAACAA.AACCGTGAG	GCGTAACAA.AACCGTGAG
GCGTAACAA.ACTCTCACA	GCGTAACAA.ACTCTCACA
GCGTAACAA.AGGATCTCA	GCGTAACAA.AGGATCTCA
GCGTAACAA.GAAGAGCAC	GCGTAACAA.GAAGAGCAC
GCGTAACAA.GAGCCATCC	GCGTAACAA.GAGCCATCC
GCGTAACAA.TCTGCGCTG	GCGTAACAA.TCTGCGCTG
GCGTAACAA.TGTCACATA	GCGTAACAA.TGTCACATA
GCGTATAGG.CACACTGCC	GCGTATAGG.CACACTGCC
GCGTATAGG.GATGTAAGG	GCGTATAGG.GATGTAAGG
GCGTCGTCT.CACACCTGT	GCGTCGTCT.CACACCTGT
GCGTCGTCT.CACTCACTA	GCGTCGTCT.CACTCACTA
GCGTCGTCT.CCGGTGGTT	GCGTCGTCT.CCGGTGGTT
GCGTCGTCT.TAGCACTAT	GCGTCGTCT.TAGCACTAT
GCGTCGTCT.TCCACGTGC	GCGTCGTCT.TCCACGTGC
GCGTCGTCT.TCTAGGATG	GCGTCGTCT.TCTAGGATG
GCGTCGTCT.TGCGCACTG	GCGTCGTCT.TGCGCACTG
GCGTCGTCT.TGTATGTAG	GCGTCGTCT.TGTATGTAG
GCGTCGTCT.TTAGATCGG	GCGTCGTCT.TTAGATCGG
GCGTGAGCT.AAGACTACC	GCGTGAGCT.AAGACTACC
GCGTGAGCT.AAGGATCGT	GCGTGAGCT.AAGGATCGT
GCGTGAGCT.CCGTAGTTG	GCGTGAGCT.CCGTAGTTG
GCGTGAGCT.TCGCCAAGC	GCGTGAGCT.TCGCCAAGC
GCGTGATAC.AAGGATACG	GCGTGATAC.AAGGATACG
GCGTGATAC.AGCTTCGAT	GCGTGATAC.AGCTTCGAT
GCGTGATAC.CAATGCATT	GCGTGATAC.CAATGCATT
GCGTGATAC.CATGTCCTG	GCGTGATAC.CATGTCCTG
GCGTGATAC.CATTGCAGA	GCGTGATAC.CATTGCAGA
GCGTGATAC.GAATCAACC	GCGTGATAC.GAATCAACC
GCGTGATAC.TACTTACCA	GCGTGATAC.TACTTACCA
GCGTGATAC.TGCTATGAA	GCGTGATAC.TGCTATGAA
GCGTGATAC.TGTCACATA	GCGTGATAC.TGTCACATA
GCGTTCAGA.AACGAGGTG	GCGTTCAGA.AACGAGGTG
GCGTTCAGA.AGTAGAGGA	GCGTTCAGA.AGTAGAGGA
GCGTTCAGA.CCTACTAGA	GCGTTCAGA.CCTACTAGA
GCGTTCAGA.CTCTTCAGC	GCGTTCAGA.CTCTTCAGC
GCGTTCAGA.GAGTTATAG	GCGTTCAGA.GAGTTATAG
GCGTTCAGA.GCTTAGAAC	GCGTTCAGA.GCTTAGAAC
GCGTTCAGA.GTTCACTCC	GCGTTCAGA.GTTCACTCC
GCGTTCAGA.TCGTCATTC	GCGTTCAGA.TCGTCATTC
GCTACAATG.AGAGCCGCA	GCTACAATG.AGAGCCGCA
GCTACAATG.CCACCATGC	GCTACAATG.CCACCATGC
GCTACCGAG.AATCTGACC	GCTACCGAG.AATCTGACC
GCTACCGAG.ACTATTGTC	GCTACCGAG.ACTATTGTC
GCTACCGAG.ACTGGTCAG	GCTACCGAG.ACTGGTCAG
GCTACCGAG.GTTGATGCA	GCTACCGAG.GTTGATGCA
GCTACCTTA.AGCGGTCTA	GCTACCTTA.AGCGGTCTA
GCTACCTTA.CATCTCACG	GCTACCTTA.CATCTCACG
GCTACCTTA.GGATCAGGT	GCTACCTTA.GGATCAGGT
GCTAGCTCC.AACGTCGAG	GCTAGCTCC.AACGTCGAG
GCTAGCTCC.ATGAGGTAT	GCTAGCTCC.ATGAGGTAT
GCTAGCTCC.CCTCCAATC	GCTAGCTCC.CCTCCAATC
GCTAGCTCC.CGACCTGTA	GCTAGCTCC.CGACCTGTA
GCTAGCTCC.CTCCTATCT	GCTAGCTCC.CTCCTATCT
GCTAGCTCC.CTCGAACTG	GCTAGCTCC.CTCGAACTG
GCTAGCTCC.GATCGATAC	GCTAGCTCC.GATCGATAC
GCTAGCTCC.GGTGAGTTC	GCTAGCTCC.GGTGAGTTC
GCTAGTGGA.AGTCGTCCG	GCTAGTGGA.AGTCGTCCG
GCTAGTGGA.GTGTACCGT	GCTAGTGGA.GTGTACCGT
GCTATGTAA.AACCGCTGA	GCTATGTAA.AACCGCTGA
GCTATGTAA.ACCACGCTA	GCTATGTAA.ACCACGCTA
GCTATGTAA.ACTTCAGTA	GCTATGTAA.ACTTCAGTA
GCTATGTAA.CTGGTGACA	GCTATGTAA.CTGGTGACA
GCTATGTAA.TAACACGAG	GCTATGTAA.TAACACGAG
GCTATGTAA.TGACCTATG	GCTATGTAA.TGACCTATG
GCTATGTAA.TTCCGAGCG	GCTATGTAA.TTCCGAGCG
GCTCAATGA.AATTGGATC	GCTCAATGA.AATTGGATC
GCTCAATGA.AGTTGAGCG	GCTCAATGA.AGTTGAGCG
GCTCAATGA.ATAGAGCAG	GCTCAATGA.ATAGAGCAG
GCTCAATGA.CATCGAAGC	GCTCAATGA.CATCGAAGC
GCTCAATGA.GGAACTGCT	GCTCAATGA.GGAACTGCT
GCTCAATGA.TATCTGTCA	GCTCAATGA.TATCTGTCA
GCTCAATGA.TATTGACTG	GCTCAATGA.TATTGACTG
GCTCAATGA.TTAGCGTCT	GCTCAATGA.TTAGCGTCT
GCTCAGCCA.ACTCGCTGT	GCTCAGCCA.ACTCGCTGT
GCTCAGCCA.CAGCTCTTC	GCTCAGCCA.CAGCTCTTC
GCTCAGCCA.CCACTTCGC	GCTCAGCCA.CCACTTCGC
GCTCAGCCA.GCTTACTAG	GCTCAGCCA.GCTTACTAG
GCTCAGCCA.GTCAAGATC	GCTCAGCCA.GTCAAGATC
GCTCCTAGC.CAAGTACGA	GCTCCTAGC.CAAGTACGA
GCTCCTAGC.CCTTATCCG	GCTCCTAGC.CCTTATCCG
GCTCCTAGC.GTTCACTCC	GCTCCTAGC.GTTCACTCC
GCTCCTAGC.TACTTACCA	GCTCCTAGC.TACTTACCA
GCTCCTAGC.TGTGAGTAT	GCTCCTAGC.TGTGAGTAT
GCTCTCCAA.ACATGACTA	GCTCTCCAA.ACATGACTA
GCTCTCCAA.ACGCGTGAC	GCTCTCCAA.ACGCGTGAC
GCTCTCCAA.CAGTAATGT	GCTCTCCAA.CAGTAATGT
GCTCTCCAA.CATAAGATC	GCTCTCCAA.CATAAGATC
GCTCTCCAA.GCTTAGAAC	GCTCTCCAA.GCTTAGAAC
GCTCTCCAA.TAGTAACGG	GCTCTCCAA.TAGTAACGG
GCTCTCCAA.TGTCTACAC	GCTCTCCAA.TGTCTACAC
GCTCTGTGT.AGCAGACAA	GCTCTGTGT.AGCAGACAA
GCTCTGTGT.AGTCTAAGC	GCTCTGTGT.AGTCTAAGC
GCTCTGTGT.ATGTCCTCC	GCTCTGTGT.ATGTCCTCC
GCTCTGTGT.GTTGCATGG	GCTCTGTGT.GTTGCATGG
GCTCTGTGT.TAGATAGCC	GCTCTGTGT.TAGATAGCC
GCTCTGTGT.TATCCTCAG	GCTCTGTGT.TATCCTCAG
GCTCTGTGT.TCGGTATCA	GCTCTGTGT.TCGGTATCA
GCTGACAGA.CCGAGTACT	GCTGACAGA.CCGAGTACT
GCTGACAGA.CTAGAGTCG	GCTGACAGA.CTAGAGTCG
GCTGACAGA.CTGTGGTGG	GCTGACAGA.CTGTGGTGG
GCTGACAGA.GCGCTACCT	GCTGACAGA.GCGCTACCT
GCTGACAGA.TGATACCGT	GCTGACAGA.TGATACCGT
GCTGACAGA.TGGTCGCTA	GCTGACAGA.TGGTCGCTA
GCTGAGCAG.AGCCTCGCA	GCTGAGCAG.AGCCTCGCA
GCTGAGCAG.ATCAAGAGA	GCTGAGCAG.ATCAAGAGA
GCTGAGCAG.CACCTCGGA	GCTGAGCAG.CACCTCGGA
GCTGAGCAG.CATACAACC	GCTGAGCAG.CATACAACC
GCTGAGCAG.CGGAATGCA	GCTGAGCAG.CGGAATGCA
GCTGAGCAG.GAATCGAGA	GCTGAGCAG.GAATCGAGA
GCTGATGTC.CCAGATCAC	GCTGATGTC.CCAGATCAC
GCTGATGTC.CTCTGTCAA	GCTGATGTC.CTCTGTCAA
GCTGATGTC.GACTTCACC	GCTGATGTC.GACTTCACC
GCTGATGTC.GCATGTGGT	GCTGATGTC.GCATGTGGT
GCTGATGTC.TCATCAGAG	GCTGATGTC.TCATCAGAG
GCTGATGTC.TCGGATGTT	GCTGATGTC.TCGGATGTT
GCTGGTAAC.AACTAACTG	GCTGGTAAC.AACTAACTG
GCTGGTAAC.AATATCGCT	GCTGGTAAC.AATATCGCT
GCTGGTAAC.CCATCTAGG	GCTGGTAAC.CCATCTAGG
GCTGGTAAC.CTGATCAAG	GCTGGTAAC.CTGATCAAG
GCTGGTAAC.GATGCTCCT	GCTGGTAAC.GATGCTCCT
GCTGGTAAC.GCATACATG	GCTGGTAAC.GCATACATG
GCTGGTAAC.GGAGATGAG	GCTGGTAAC.GGAGATGAG
GCTGGTAAC.TAGGAGGAT	GCTGGTAAC.TAGGAGGAT
GCTGGTAAC.TCAGTGTTC	GCTGGTAAC.TCAGTGTTC
GCTGGTAAC.TCGTAGGAA	GCTGGTAAC.TCGTAGGAA
GCTGGTAAC.TGCGACGTT	GCTGGTAAC.TGCGACGTT
GCTGGTTCG.ACCGACGGT	GCTGGTTCG.ACCGACGGT
GCTGGTTCG.AGCTACTCA	GCTGGTTCG.AGCTACTCA
GCTGGTTCG.AGGAGGTGA	GCTGGTTCG.AGGAGGTGA
GCTGGTTCG.ATAGCCTAA	GCTGGTTCG.ATAGCCTAA
GCTGGTTCG.CGAGTAGCA	GCTGGTTCG.CGAGTAGCA
GCTGGTTCG.CTGTAGAAG	GCTGGTTCG.CTGTAGAAG
GCTGGTTCG.TAGCGAGAA	GCTGGTTCG.TAGCGAGAA
GCTGGTTCG.TAGTACGTA	GCTGGTTCG.TAGTACGTA
GCTGGTTCG.TTCCTAAGG	GCTGGTTCG.TTCCTAAGG
GCTGTTCGG.AGATCGAGT	GCTGTTCGG.AGATCGAGT
GCTGTTCGG.ATACGAGGT	GCTGTTCGG.ATACGAGGT
GCTGTTCGG.CACCAAGAT	GCTGTTCGG.CACCAAGAT
GCTGTTCGG.CCGCAACAC	GCTGTTCGG.CCGCAACAC
GCTGTTCGG.CCGTACGGA	GCTGTTCGG.CCGTACGGA
GCTGTTCGG.CTATACTAG	GCTGTTCGG.CTATACTAG
GCTGTTCGG.GAGCATACA	GCTGTTCGG.GAGCATACA
GCTGTTCGG.GCCGAACCA	GCTGTTCGG.GCCGAACCA
GCTGTTCGG.GTAATATCG	GCTGTTCGG.GTAATATCG
GCTGTTCGG.TCTCATCGG	GCTGTTCGG.TCTCATCGG
GCTTACGTT.CACTTCCTT	GCTTACGTT.CACTTCCTT
GCTTACGTT.CTCGACTGC	GCTTACGTT.CTCGACTGC
GCTTACGTT.CTCTAAGAG	GCTTACGTT.CTCTAAGAG
GCTTACGTT.GCCATACAA	GCTTACGTT.GCCATACAA
GCTTACGTT.GCGCTAGAA	GCTTACGTT.GCGCTAGAA
GCTTACGTT.GTCCGTAAG	GCTTACGTT.GTCCGTAAG
GCTTACGTT.GTGTCACAC	GCTTACGTT.GTGTCACAC
GCTTACGTT.TATAGTGCG	GCTTACGTT.TATAGTGCG
GCTTACGTT.TCAGAGCGT	GCTTACGTT.TCAGAGCGT
GCTTACGTT.TCTGAGATA	GCTTACGTT.TCTGAGATA
GCTTACGTT.TGAGTTAAG	GCTTACGTT.TGAGTTAAG
GCTTACGTT.TGCGACGTT	GCTTACGTT.TGCGACGTT
GCTTACTAG.ACAACCGGA	GCTTACTAG.ACAACCGGA
GCTTACTAG.ACTCGTCTA	GCTTACTAG.ACTCGTCTA
GCTTACTAG.GTGAACCAC	GCTTACTAG.GTGAACCAC
GCTTACTAG.TGGTTATAC	GCTTACTAG.TGGTTATAC
GCTTAGAAC.ACAAGTACA	GCTTAGAAC.ACAAGTACA
GCTTAGAAC.CCGCAGCTA	GCTTAGAAC.CCGCAGCTA
GCTTAGAAC.CTAGTCGTC	GCTTAGAAC.CTAGTCGTC
GCTTAGAAC.GACCGGTAG	GCTTAGAAC.GACCGGTAG
GCTTAGAAC.GACTCTCAC	GCTTAGAAC.GACTCTCAC
GCTTAGAAC.GTACTCTAC	GCTTAGAAC.GTACTCTAC
GCTTAGAAC.TACGACCAT	GCTTAGAAC.TACGACCAT
GCTTAGAAC.TGATGTGTG	GCTTAGAAC.TGATGTGTG
GCTTCACTC.CCGCATCCT	GCTTCACTC.CCGCATCCT
GCTTCACTC.CGACCTAGC	GCTTCACTC.CGACCTAGC
GCTTCACTC.GAAGTGTGA	GCTTCACTC.GAAGTGTGA
GCTTCACTC.GCGGAGATT	GCTTCACTC.GCGGAGATT
GCTTCACTC.GGTTAGATG	GCTTCACTC.GGTTAGATG
GCTTCTACG.AAGGATACG	GCTTCTACG.AAGGATACG
GCTTCTACG.AGCCACTTC	GCTTCTACG.AGCCACTTC
GCTTCTACG.GTCTCTTCA	GCTTCTACG.GTCTCTTCA
GCTTCTACG.TACCGATTG	GCTTCTACG.TACCGATTG
GCTTCTACG.TTCCAGGAG	GCTTCTACG.TTCCAGGAG
GCTTCTACG.TTCGTGATG	GCTTCTACG.TTCGTGATG
GCTTCTGAA.AGTCGCGAC	GCTTCTGAA.AGTCGCGAC
GCTTCTGAA.CAGTCTAAC	GCTTCTGAA.CAGTCTAAC
GCTTCTGAA.CCTATTCAA	GCTTCTGAA.CCTATTCAA
GCTTCTGAA.TAGTGCACT	GCTTCTGAA.TAGTGCACT
GCTTCTGAA.TATTGACTG	GCTTCTGAA.TATTGACTG
GCTTCTGAA.TGACCTATG	GCTTCTGAA.TGACCTATG
GCTTCTGAA.TGTCTACAC	GCTTCTGAA.TGTCTACAC
GCTTGGTTC.AATCTCCTA	GCTTGGTTC.AATCTCCTA
GCTTGGTTC.ACACCGCCA	GCTTGGTTC.ACACCGCCA
