CTCCTGACG.ATTAGCACA	CTCCTGACG.ATTAGCACA
CTCCTGACG.GGAACCTAG	CTCCTGACG.GGAACCTAG
CTCCTGACG.GTAGCCTTG	CTCCTGACG.GTAGCCTTG
CTCCTGACG.TCGTTCTCC	CTCCTGACG.TCGTTCTCC
CTCGAACTG.ACCGTCCTA	CTCGAACTG.ACCGTCCTA
CTCGAACTG.ATCCTCCGA	CTCGAACTG.ATCCTCCGA
CTCGAACTG.ATGCTTCAG	CTCGAACTG.ATGCTTCAG
CTCGAACTG.CTGATCAAG	CTCGAACTG.CTGATCAAG
CTCGAACTG.GAGACGATC	CTCGAACTG.GAGACGATC
CTCGAACTG.GATGTTACA	CTCGAACTG.GATGTTACA
CTCGAACTG.TGTATCGTG	CTCGAACTG.TGTATCGTG
CTCGAACTG.TGTCATAGC	CTCGAACTG.TGTCATAGC
CTCGACGAT.AATGCGTGC	CTCGACGAT.AATGCGTGC
CTCGACGAT.ACTACCATC	CTCGACGAT.ACTACCATC
CTCGACGAT.ACTCCTGAG	CTCGACGAT.ACTCCTGAG
CTCGACGAT.CGATTGAAC	CTCGACGAT.CGATTGAAC
CTCGACGAT.GAGATGTAT	CTCGACGAT.GAGATGTAT
CTCGACGAT.GCCATACAA	CTCGACGAT.GCCATACAA
CTCGACGAT.GTACTCTAC	CTCGACGAT.GTACTCTAC
CTCGACGAT.TCGTGACGT	CTCGACGAT.TCGTGACGT
CTCGACGAT.TGCAGATGC	CTCGACGAT.TGCAGATGC
CTCGACTGC.ACTCTAGGA	CTCGACTGC.ACTCTAGGA
CTCGACTGC.CCTCCTTGT	CTCGACTGC.CCTCCTTGT
CTCGACTGC.CTGTGGTGG	CTCGACTGC.CTGTGGTGG
CTCGACTGC.GAATTCAGT	CTCGACTGC.GAATTCAGT
CTCGCAAGA.CCTATTCAA	CTCGCAAGA.CCTATTCAA
CTCGCAAGA.CGTACACAC	CTCGCAAGA.CGTACACAC
CTCGCAAGA.GTAAGGTCC	CTCGCAAGA.GTAAGGTCC
CTCGCAAGA.GTAGCCTTG	CTCGCAAGA.GTAGCCTTG
CTCGCAAGA.TCGTAATAG	CTCGCAAGA.TCGTAATAG
CTCGCAAGA.TGGATTAGC	CTCGCAAGA.TGGATTAGC
CTCGCAAGA.TTGCCAGAT	CTCGCAAGA.TTGCCAGAT
CTCGCTACG.ATAGCACGG	CTCGCTACG.ATAGCACGG
CTCGCTACG.CATGACGTT	CTCGCTACG.CATGACGTT
CTCGCTACG.CGTACATCT	CTCGCTACG.CGTACATCT
CTCGCTACG.GCGATGGTG	CTCGCTACG.GCGATGGTG
CTCGCTACG.TAATTCGTG	CTCGCTACG.TAATTCGTG
CTCGCTACG.TCTACAGTT	CTCGCTACG.TCTACAGTT
CTCGTCTTG.CGACCACTT	CTCGTCTTG.CGACCACTT
CTCGTCTTG.TCTGGAGGA	CTCGTCTTG.TCTGGAGGA
CTCGTGTCC.AAGTAGGAC	CTCGTGTCC.AAGTAGGAC
CTCGTGTCC.ACGTTCAAT	CTCGTGTCC.ACGTTCAAT
CTCGTGTCC.CTTATCTCA	CTCGTGTCC.CTTATCTCA
CTCGTGTCC.GACTTCACC	CTCGTGTCC.GACTTCACC
CTCGTGTCC.TGTCATAGC	CTCGTGTCC.TGTCATAGC
CTCGTTCAC.ATCATAGAC	CTCGTTCAC.ATCATAGAC
CTCGTTCAC.CTAGTCGTC	CTCGTTCAC.CTAGTCGTC
CTCGTTCAC.GTTACTACT	CTCGTTCAC.GTTACTACT
CTCTAAGAG.AACACACTC	CTCTAAGAG.AACACACTC
CTCTAAGAG.AACGTCGAG	CTCTAAGAG.AACGTCGAG
CTCTAAGAG.AGCACCGTG	CTCTAAGAG.AGCACCGTG
CTCTAAGAG.CGTGCTTGA	CTCTAAGAG.CGTGCTTGA
CTCTAAGAG.GCCTTATCT	CTCTAAGAG.GCCTTATCT
CTCTAAGAG.TGCCGACTA	CTCTAAGAG.TGCCGACTA
CTCTAAGAG.TGTCAACCT	CTCTAAGAG.TGTCAACCT
CTCTACGCA.AAGGAAGTC	CTCTACGCA.AAGGAAGTC
CTCTACGCA.ACATTCCAC	CTCTACGCA.ACATTCCAC
CTCTACGCA.CCTCAGGTG	CTCTACGCA.CCTCAGGTG
CTCTACGCA.CCTCCAATC	CTCTACGCA.CCTCCAATC
CTCTACGCA.CGAACAATC	CTCTACGCA.CGAACAATC
CTCTACGCA.GAGGTCCTT	CTCTACGCA.GAGGTCCTT
CTCTACGCA.TGCTCCTCC	CTCTACGCA.TGCTCCTCC
CTCTAGTAA.ACAGTATTG	CTCTAGTAA.ACAGTATTG
CTCTAGTAA.ACTCTAGGA	CTCTAGTAA.ACTCTAGGA
CTCTAGTAA.AGAAGTAAC	CTCTAGTAA.AGAAGTAAC
CTCTAGTAA.ATAGTCTCC	CTCTAGTAA.ATAGTCTCC
CTCTAGTAA.GTGACGTAA	CTCTAGTAA.GTGACGTAA
CTCTAGTAA.TACATGCAC	CTCTAGTAA.TACATGCAC
CTCTCAGTC.CTGAGATAG	CTCTCAGTC.CTGAGATAG
CTCTCAGTC.GGATCAGGT	CTCTCAGTC.GGATCAGGT
CTCTCAGTC.TCAGCTCAG	CTCTCAGTC.TCAGCTCAG
CTCTCGATA.CACGACTCA	CTCTCGATA.CACGACTCA
CTCTCGATA.CTCGACTGC	CTCTCGATA.CTCGACTGC
CTCTCGATA.TGAGCTAGA	CTCTCGATA.TGAGCTAGA
CTCTCGATA.TGGATAGGT	CTCTCGATA.TGGATAGGT
CTCTGCAAG.AACTTAGCT	CTCTGCAAG.AACTTAGCT
CTCTGCAAG.AGGATCATG	CTCTGCAAG.AGGATCATG
CTCTGCAAG.CAGGATCAA	CTCTGCAAG.CAGGATCAA
CTCTGCAAG.CCTCCTTGT	CTCTGCAAG.CCTCCTTGT
CTCTGCAAG.TAATCACGC	CTCTGCAAG.TAATCACGC
CTCTGCGGT.AGGAATTGG	CTCTGCGGT.AGGAATTGG
CTCTGCGGT.ATAGTCAGT	CTCTGCGGT.ATAGTCAGT
CTCTGCGGT.CATTGACAA	CTCTGCGGT.CATTGACAA
CTCTGCGGT.CCGACTTGG	CTCTGCGGT.CCGACTTGG
CTCTGCGGT.CCTAGTCTC	CTCTGCGGT.CCTAGTCTC
CTCTGCGGT.GATGTAAGG	CTCTGCGGT.GATGTAAGG
CTCTGCGGT.GCACGCATT	CTCTGCGGT.GCACGCATT
CTCTGCGGT.GTAACCATA	CTCTGCGGT.GTAACCATA
CTCTGCGGT.TCTTGGTAG	CTCTGCGGT.TCTTGGTAG
CTCTGTCAA.AATATCGCT	CTCTGTCAA.AATATCGCT
CTCTGTCAA.CGTGACCAG	CTCTGTCAA.CGTGACCAG
CTCTGTCAA.CTCTCGATA	CTCTGTCAA.CTCTCGATA
CTCTGTCAA.GCCACGAGT	CTCTGTCAA.GCCACGAGT
CTCTTCAGC.GCATACATG	CTCTTCAGC.GCATACATG
CTCTTCAGC.TCTAGTGAC	CTCTTCAGC.TCTAGTGAC
CTGACAGCA.AGCACCGTG	CTGACAGCA.AGCACCGTG
CTGACAGCA.ATGACACAA	CTGACAGCA.ATGACACAA
CTGACAGCA.ATTGCCGAC	CTGACAGCA.ATTGCCGAC
CTGACAGCA.CATAATTGG	CTGACAGCA.CATAATTGG
CTGACAGCA.CCGCAGAAT	CTGACAGCA.CCGCAGAAT
CTGACAGCA.TCGTACCTT	CTGACAGCA.TCGTACCTT
CTGACAGCA.TGCGTCTTA	CTGACAGCA.TGCGTCTTA
CTGACGATG.AGTCGCGAC	CTGACGATG.AGTCGCGAC
CTGACGATG.GCTGAGCAG	CTGACGATG.GCTGAGCAG
CTGACGATG.GCTGTTCGG	CTGACGATG.GCTGTTCGG
CTGACGATG.GTCGACATT	CTGACGATG.GTCGACATT
CTGACGATG.TAGCTAAGA	CTGACGATG.TAGCTAAGA
CTGACGATG.TTCCAATTC	CTGACGATG.TTCCAATTC
CTGACGGAT.AGTACTACA	CTGACGGAT.AGTACTACA
CTGACGGAT.GACACGCAA	CTGACGGAT.GACACGCAA
CTGACGGAT.GCAATGAGA	CTGACGGAT.GCAATGAGA
CTGACGGAT.GCGTTCAGA	CTGACGGAT.GCGTTCAGA
CTGACGGAT.TATGTATGC	CTGACGGAT.TATGTATGC
CTGACGGAT.TGCTCACAC	CTGACGGAT.TGCTCACAC
CTGAGATAG.AGGAAGGTG	CTGAGATAG.AGGAAGGTG
CTGAGATAG.ATAGTCAGT	CTGAGATAG.ATAGTCAGT
CTGAGATAG.CAACGCACA	CTGAGATAG.CAACGCACA
CTGAGATAG.CCGAGTACT	CTGAGATAG.CCGAGTACT
CTGAGATAG.GAGCAGGAA	CTGAGATAG.GAGCAGGAA
CTGAGATAG.GGAACCTAG	CTGAGATAG.GGAACCTAG
CTGAGATAG.GTATTACTG	CTGAGATAG.GTATTACTG
CTGAGATAG.GTCTCCAGG	CTGAGATAG.GTCTCCAGG
CTGAGATAG.GTTGATGCA	CTGAGATAG.GTTGATGCA
CTGAGATAG.TGCAGATGC	CTGAGATAG.TGCAGATGC
CTGAGATAG.TTACACCTT	CTGAGATAG.TTACACCTT
CTGAGGTTA.CCTGACCTC	CTGAGGTTA.CCTGACCTC
CTGAGGTTA.TTCCAATTC	CTGAGGTTA.TTCCAATTC
CTGAGTAGC.ATGGACGTT	CTGAGTAGC.ATGGACGTT
CTGAGTAGC.GGAACCTAG	CTGAGTAGC.GGAACCTAG
CTGAGTAGC.TCCTGTCCG	CTGAGTAGC.TCCTGTCCG
CTGAGTAGC.TCTGATGAA	CTGAGTAGC.TCTGATGAA
CTGAGTAGC.TGCGACGTT	CTGAGTAGC.TGCGACGTT
CTGAGTCCA.ACCGAGACA	CTGAGTCCA.ACCGAGACA
CTGAGTCCA.AGTCGCCGA	CTGAGTCCA.AGTCGCCGA
CTGAGTCCA.CACGTAGAC	CTGAGTCCA.CACGTAGAC
CTGAGTCCA.GCAGGAGAA	CTGAGTCCA.GCAGGAGAA
CTGAGTCCA.GCGCTTCTC	CTGAGTCCA.GCGCTTCTC
CTGAGTCCA.TCCTGTGGA	CTGAGTCCA.TCCTGTGGA
CTGAGTCCA.TGTCTACAC	CTGAGTCCA.TGTCTACAC
CTGATCAAG.AGTATGACG	CTGATCAAG.AGTATGACG
CTGATCAAG.CCTCGGTCA	CTGATCAAG.CCTCGGTCA
CTGATCAAG.CCTCTGCAT	CTGATCAAG.CCTCTGCAT
CTGATCAAG.TGCGTCTTA	CTGATCAAG.TGCGTCTTA
CTGATCCGA.ACCGTCACG	CTGATCCGA.ACCGTCACG
CTGATCCGA.CTGAGATAG	CTGATCCGA.CTGAGATAG
CTGATCCGA.GACTTCACC	CTGATCCGA.GACTTCACC
CTGATCCGA.GAGAATCAG	CTGATCCGA.GAGAATCAG
CTGATCCGA.GTAAGGTCC	CTGATCCGA.GTAAGGTCC
CTGATCCGA.GTAATCAGC	CTGATCCGA.GTAATCAGC
CTGATCCGA.TTCTGAATG	CTGATCCGA.TTCTGAATG
CTGATGCAC.ACGCTCTTA	CTGATGCAC.ACGCTCTTA
CTGATGCAC.GACGTTCAG	CTGATGCAC.GACGTTCAG
CTGATGCAC.GATAACGTC	CTGATGCAC.GATAACGTC
CTGATGCAC.GCCTTGTGA	CTGATGCAC.GCCTTGTGA
CTGATGCAC.GGTACTTCC	CTGATGCAC.GGTACTTCC
CTGATGCAC.GTTAGTCAA	CTGATGCAC.GTTAGTCAA
CTGATGCAC.TTACTAGTC	CTGATGCAC.TTACTAGTC
CTGCAAGCC.AACGTCGAG	CTGCAAGCC.AACGTCGAG
CTGCAAGCC.AAGCACAAC	CTGCAAGCC.AAGCACAAC
CTGCAAGCC.AGTGTGCAC	CTGCAAGCC.AGTGTGCAC
CTGCAAGCC.GACTGCCTG	CTGCAAGCC.GACTGCCTG
CTGCAAGCC.TGGAGTGGA	CTGCAAGCC.TGGAGTGGA
CTGCAGAGC.AGACGCCTG	CTGCAGAGC.AGACGCCTG
CTGCAGAGC.AGAGAGTGG	CTGCAGAGC.AGAGAGTGG
CTGCAGAGC.AGATGTTGG	CTGCAGAGC.AGATGTTGG
CTGCAGAGC.AGCATATGG	CTGCAGAGC.AGCATATGG
CTGCAGAGC.AGGTCACGT	CTGCAGAGC.AGGTCACGT
CTGCAGAGC.ATGAGATCC	CTGCAGAGC.ATGAGATCC
CTGCAGAGC.GAACCAGTT	CTGCAGAGC.GAACCAGTT
CTGCAGAGC.GAGATACAC	CTGCAGAGC.GAGATACAC
CTGCAGAGC.GCTTGGTTC	CTGCAGAGC.GCTTGGTTC
CTGCAGAGC.GGTGTGACC	CTGCAGAGC.GGTGTGACC
CTGCATGTT.AATTGGATC	CTGCATGTT.AATTGGATC
CTGCATGTT.CTTCTGAGT	CTGCATGTT.CTTCTGAGT
CTGCATGTT.GAGCAGGAA	CTGCATGTT.GAGCAGGAA
CTGCATGTT.GCTGACAGA	CTGCATGTT.GCTGACAGA
CTGCATGTT.GCTTCTACG	CTGCATGTT.GCTTCTACG
CTGCATGTT.TACCGCGTT	CTGCATGTT.TACCGCGTT
CTGCGATTC.AAGACTACC	CTGCGATTC.AAGACTACC
CTGCGATTC.CTCGTTCAC	CTGCGATTC.CTCGTTCAC
CTGCGATTC.GAGATTCCT	CTGCGATTC.GAGATTCCT
CTGCGATTC.GTAAGGTCC	CTGCGATTC.GTAAGGTCC
CTGCGTCAC.AACGGTAGC	CTGCGTCAC.AACGGTAGC
CTGCGTCAC.CACACTGCC	CTGCGTCAC.CACACTGCC
CTGCGTCAC.CCGCAACAC	CTGCGTCAC.CCGCAACAC
CTGCGTCAC.GCGTGAGCT	CTGCGTCAC.GCGTGAGCT
CTGCGTCAC.GTTAGAGAC	CTGCGTCAC.GTTAGAGAC
CTGCGTCAC.TTGATCGTA	CTGCGTCAC.TTGATCGTA
CTGCTGCTT.AGTGTGCAC	CTGCTGCTT.AGTGTGCAC
CTGCTGCTT.CATGTGAAC	CTGCTGCTT.CATGTGAAC
CTGCTGCTT.CGATCCAGA	CTGCTGCTT.CGATCCAGA
CTGCTGCTT.CGTAATGAC	CTGCTGCTT.CGTAATGAC
CTGCTGCTT.CGTGACCAG	CTGCTGCTT.CGTGACCAG
CTGCTGCTT.TCATGCAGG	CTGCTGCTT.TCATGCAGG
CTGCTGCTT.TCCATCATT	CTGCTGCTT.TCCATCATT
CTGCTTAGG.AGATATGGA	CTGCTTAGG.AGATATGGA
CTGCTTAGG.ATCATGTTC	CTGCTTAGG.ATCATGTTC
CTGCTTAGG.GAATTGTTG	CTGCTTAGG.GAATTGTTG
CTGCTTAGG.GTAATATCG	CTGCTTAGG.GTAATATCG
CTGCTTAGG.TCGACGTTG	CTGCTTAGG.TCGACGTTG
CTGGACACT.ACACACCGT	CTGGACACT.ACACACCGT
CTGGACACT.ACCGAGACA	CTGGACACT.ACCGAGACA
CTGGACACT.CTCAGTGAT	CTGGACACT.CTCAGTGAT
CTGGACACT.GTCGTGTTA	CTGGACACT.GTCGTGTTA
CTGGACTAA.AGTGGAATG	CTGGACTAA.AGTGGAATG
CTGGACTAA.CAATGCATT	CTGGACTAA.CAATGCATT
CTGGACTAA.CCGACTTGG	CTGGACTAA.CCGACTTGG
CTGGACTAA.TCGCTGATT	CTGGACTAA.TCGCTGATT
CTGGACTAA.TGCGATACT	CTGGACTAA.TGCGATACT
CTGGAGCGA.AATTGGTGA	CTGGAGCGA.AATTGGTGA
CTGGAGCGA.AGGTATTCC	CTGGAGCGA.AGGTATTCC
CTGGAGCGA.CACGTCATA	CTGGAGCGA.CACGTCATA
CTGGAGCGA.GATTAGACA	CTGGAGCGA.GATTAGACA
CTGGAGCGA.TGACAAGTT	CTGGAGCGA.TGACAAGTT
CTGGTAATC.CATCTCGAT	CTGGTAATC.CATCTCGAT
CTGGTAATC.CTGCAGAGC	CTGGTAATC.CTGCAGAGC
CTGGTAATC.GCGAACTCG	CTGGTAATC.GCGAACTCG
CTGGTAATC.TAGCACTAT	CTGGTAATC.TAGCACTAT
CTGGTAATC.TGCCAGACG	CTGGTAATC.TGCCAGACG
CTGGTACAT.AAGCTGAGG	CTGGTACAT.AAGCTGAGG
CTGGTACAT.ACACACGTC	CTGGTACAT.ACACACGTC
CTGGTACAT.CAGTCTAAC	CTGGTACAT.CAGTCTAAC
CTGGTACAT.CTAGTTCCA	CTGGTACAT.CTAGTTCCA
CTGGTACAT.GAAGGATCA	CTGGTACAT.GAAGGATCA
CTGGTACAT.TAACATTGG	CTGGTACAT.TAACATTGG
CTGGTACAT.TGCGCACTG	CTGGTACAT.TGCGCACTG
CTGGTCGGT.ACCGACGGT	CTGGTCGGT.ACCGACGGT
CTGGTCGGT.CTCTAGTAA	CTGGTCGGT.CTCTAGTAA
CTGGTCGGT.CTGGTAATC	CTGGTCGGT.CTGGTAATC
CTGGTCGGT.GAGCCATCC	CTGGTCGGT.GAGCCATCC
CTGGTCGGT.GCGTTCAGA	CTGGTCGGT.GCGTTCAGA
CTGGTCGGT.TCTCAGGAT	CTGGTCGGT.TCTCAGGAT
CTGGTGACA.AACAACTGG	CTGGTGACA.AACAACTGG
CTGGTGACA.ATTCACCTC	CTGGTGACA.ATTCACCTC
CTGGTGACA.GGAGATGAG	CTGGTGACA.GGAGATGAG
CTGGTGACA.TACCGCGTT	CTGGTGACA.TACCGCGTT
CTGTACGAC.ACGTAGTAT	CTGTACGAC.ACGTAGTAT
CTGTACGAC.CACGTCATA	CTGTACGAC.CACGTCATA
CTGTACGAC.GAACGCTGT	CTGTACGAC.GAACGCTGT
CTGTACGAC.TACCATGTA	CTGTACGAC.TACCATGTA
CTGTACGAC.TGCGTCTTA	CTGTACGAC.TGCGTCTTA
CTGTACGAC.TGGAAGATT	CTGTACGAC.TGGAAGATT
CTGTACGAC.TTCCAATTC	CTGTACGAC.TTCCAATTC
CTGTAGAAG.CACCAGAAG	CTGTAGAAG.CACCAGAAG
CTGTAGAAG.GACTCAGTG	CTGTAGAAG.GACTCAGTG
CTGTAGAAG.TTACGGACC	CTGTAGAAG.TTACGGACC
CTGTCACTT.CGACGTGAT	CTGTCACTT.CGACGTGAT
CTGTCACTT.CGGTTCTAT	CTGTCACTT.CGGTTCTAT
CTGTCACTT.TGTATGTAG	CTGTCACTT.TGTATGTAG
CTGTCTAGT.AAGGTGCTG	CTGTCTAGT.AAGGTGCTG
CTGTCTAGT.AAGTAGGAC	CTGTCTAGT.AAGTAGGAC
CTGTCTAGT.CACTAGACT	CTGTCTAGT.CACTAGACT
CTGTCTAGT.TAGTGCACT	CTGTCTAGT.TAGTGCACT
CTGTCTAGT.TGGTCCTAG	CTGTCTAGT.TGGTCCTAG
CTGTCTAGT.TGGTCGCTA	CTGTCTAGT.TGGTCGCTA
CTGTCTAGT.TGGTGCCTG	CTGTCTAGT.TGGTGCCTG
CTGTCTAGT.TTCCAATTC	CTGTCTAGT.TTCCAATTC
CTGTGCTCA.CCTGTCGAC	CTGTGCTCA.CCTGTCGAC
CTGTGCTCA.CGGTCGACA	CTGTGCTCA.CGGTCGACA
CTGTGCTCA.CTGTACGAC	CTGTGCTCA.CTGTACGAC
CTGTGCTCA.CTTCGACTG	CTGTGCTCA.CTTCGACTG
CTGTGCTCA.TATGATGTG	CTGTGCTCA.TATGATGTG
CTGTGGTGG.AGTTCAACC	CTGTGGTGG.AGTTCAACC
CTGTGGTGG.GACTGCCTG	CTGTGGTGG.GACTGCCTG
CTGTTACCA.AATATCGCT	CTGTTACCA.AATATCGCT
CTGTTACCA.ACTTAGCTT	CTGTTACCA.ACTTAGCTT
CTGTTACCA.CGTGTCCGA	CTGTTACCA.CGTGTCCGA
CTTAACAGC.AATATCAGC	CTTAACAGC.AATATCAGC
CTTAACAGC.TAGGTCAAC	CTTAACAGC.TAGGTCAAC
CTTAACAGC.TCGTAGGAA	CTTAACAGC.TCGTAGGAA
CTTAAGTTG.ATCCATTAG	CTTAAGTTG.ATCCATTAG
CTTAAGTTG.CAAGAGAGT	CTTAAGTTG.CAAGAGAGT
CTTAAGTTG.CTCAGGTAC	CTTAAGTTG.CTCAGGTAC
CTTAAGTTG.CTGCATGTT	CTTAAGTTG.CTGCATGTT
CTTAAGTTG.GTAGCCTTG	CTTAAGTTG.GTAGCCTTG
CTTAAGTTG.TCGCTTAAC	CTTAAGTTG.TCGCTTAAC
CTTAAGTTG.TGTGGACAA	CTTAAGTTG.TGTGGACAA
CTTAATCGT.AGTCTGGAA	CTTAATCGT.AGTCTGGAA
CTTAATCGT.CACATGTGC	CTTAATCGT.CACATGTGC
CTTAATCGT.CACGTCATA	CTTAATCGT.CACGTCATA
CTTAATCGT.GATGCGACG	CTTAATCGT.GATGCGACG
CTTAATCGT.GCGAAGCTC	CTTAATCGT.GCGAAGCTC
CTTAATCGT.TGTTACTGA	CTTAATCGT.TGTTACTGA
CTTACATGC.AAGCATTGC	CTTACATGC.AAGCATTGC
CTTACATGC.ACACAGAAC	CTTACATGC.ACACAGAAC
CTTACATGC.ACCGGAGTA	CTTACATGC.ACCGGAGTA
CTTACATGC.AGGTCACGT	CTTACATGC.AGGTCACGT
CTTACATGC.CCAGATCAC	CTTACATGC.CCAGATCAC
CTTACATGC.CCTAGTTAG	CTTACATGC.CCTAGTTAG
CTTACATGC.GGATGCGAA	CTTACATGC.GGATGCGAA
CTTACATGC.TAGATAGCC	CTTACATGC.TAGATAGCC
CTTACCTAG.ATAGCTTGC	CTTACCTAG.ATAGCTTGC
CTTACCTAG.TAACGGATA	CTTACCTAG.TAACGGATA
CTTACCTAG.TGCCACCGA	CTTACCTAG.TGCCACCGA
CTTAGAAGG.CAATCATAC	CTTAGAAGG.CAATCATAC
CTTAGAAGG.GATAAGCTG	CTTAGAAGG.GATAAGCTG
CTTAGAAGG.GATTCCTCT	CTTAGAAGG.GATTCCTCT
CTTAGAAGG.GTCAGACCG	CTTAGAAGG.GTCAGACCG
CTTAGAAGG.GTCGACATT	CTTAGAAGG.GTCGACATT
CTTAGAAGG.TGTTGTCGA	CTTAGAAGG.TGTTGTCGA
CTTAGGACT.AGATGAAGA	CTTAGGACT.AGATGAAGA
CTTAGGACT.TCGTGCCAC	CTTAGGACT.TCGTGCCAC
CTTAGGACT.TTCAACTAC	CTTAGGACT.TTCAACTAC
CTTATCTCA.AACTAACTG	CTTATCTCA.AACTAACTG
CTTATCTCA.AGGTCCGTC	CTTATCTCA.AGGTCCGTC
CTTATCTCA.ATCTGCGTA	CTTATCTCA.ATCTGCGTA
CTTATCTCA.CAGGTTGTC	CTTATCTCA.CAGGTTGTC
CTTATCTCA.GCAACACCT	CTTATCTCA.GCAACACCT
CTTATCTCA.GCCTTAGAG	CTTATCTCA.GCCTTAGAG
CTTATCTCA.TCATGCTCA	CTTATCTCA.TCATGCTCA
CTTATCTCA.TTCCTCGGT	CTTATCTCA.TTCCTCGGT
CTTATTGAG.ATCGGTGGT	CTTATTGAG.ATCGGTGGT
CTTATTGAG.ATCTCTGCT	CTTATTGAG.ATCTCTGCT
CTTATTGAG.GACGCCGTA	CTTATTGAG.GACGCCGTA
CTTATTGAG.GCTGGTAAC	CTTATTGAG.GCTGGTAAC
CTTATTGAG.GTGGACTGG	CTTATTGAG.GTGGACTGG
CTTATTGAG.TATGTACCT	CTTATTGAG.TATGTACCT
CTTCACTGT.CATGTGAAC	CTTCACTGT.CATGTGAAC
CTTCACTGT.CGATACTCT	CTTCACTGT.CGATACTCT
CTTCACTGT.CTTCCGGTA	CTTCACTGT.CTTCCGGTA
CTTCACTGT.GCTTCTGAA	CTTCACTGT.GCTTCTGAA
CTTCACTGT.GGTACTTCC	CTTCACTGT.GGTACTTCC
CTTCACTGT.TACCTCACT	CTTCACTGT.TACCTCACT
CTTCACTGT.TATTGCTAC	CTTCACTGT.TATTGCTAC
CTTCCGGTA.AGGTATTCC	CTTCCGGTA.AGGTATTCC
CTTCCGGTA.ATCCTCCGA	CTTCCGGTA.ATCCTCCGA
CTTCCGGTA.CAAGCCTCG	CTTCCGGTA.CAAGCCTCG
CTTCCGGTA.CACTAGACT	CTTCCGGTA.CACTAGACT
CTTCCGGTA.CGTGCTTGA	CTTCCGGTA.CGTGCTTGA
CTTCCGGTA.TAGCACTAT	CTTCCGGTA.TAGCACTAT
CTTCCGGTA.TCCACGTGC	CTTCCGGTA.TCCACGTGC
CTTCCGGTA.TCCTCGTCG	CTTCCGGTA.TCCTCGTCG
CTTCCGGTA.TGGATAGGT	CTTCCGGTA.TGGATAGGT
CTTCCGTGG.GGAGATGAG	CTTCCGTGG.GGAGATGAG
CTTCCGTGG.TTACCTCTC	CTTCCGTGG.TTACCTCTC
CTTCCGTGG.TTCACTGGA	CTTCCGTGG.TTCACTGGA
CTTCCTGAT.AATGCGTGC	CTTCCTGAT.AATGCGTGC
CTTCCTGAT.ATTGATTGG	CTTCCTGAT.ATTGATTGG
CTTCCTGAT.CACGCGTAA	CTTCCTGAT.CACGCGTAA
CTTCCTGAT.GTTGCATGG	CTTCCTGAT.GTTGCATGG
CTTCGACTG.ATACCGCTT	CTTCGACTG.ATACCGCTT
CTTCGACTG.CAGAGCACC	CTTCGACTG.CAGAGCACC
CTTCTATGA.ATAGCCTAA	CTTCTATGA.ATAGCCTAA
CTTCTATGA.GATCGATAC	CTTCTATGA.GATCGATAC
CTTCTATGA.GCAACACCT	CTTCTATGA.GCAACACCT
CTTCTATGA.GCTTACGTT	CTTCTATGA.GCTTACGTT
CTTCTCATC.CTGTCTAGT	CTTCTCATC.CTGTCTAGT
CTTCTCATC.TAGTCGCAT	CTTCTCATC.TAGTCGCAT
CTTCTCATC.TTCCTAAGG	CTTCTCATC.TTCCTAAGG
CTTCTGAGT.ACGCGTGAC	CTTCTGAGT.ACGCGTGAC
CTTCTGAGT.CGCACTGAA	CTTCTGAGT.CGCACTGAA
CTTCTGAGT.GACGGTGCT	CTTCTGAGT.GACGGTGCT
CTTCTGAGT.TATCCTCAG	CTTCTGAGT.TATCCTCAG
CTTGATCTA.AATATCGCT	CTTGATCTA.AATATCGCT
CTTGATCTA.CCATATGCC	CTTGATCTA.CCATATGCC
CTTGATCTA.CGCTTGTAG	CTTGATCTA.CGCTTGTAG
CTTGATCTA.GGAAGAAGC	CTTGATCTA.GGAAGAAGC
CTTGATCTA.GTTATCGAT	CTTGATCTA.GTTATCGAT
CTTGATCTA.TAAGTACAC	CTTGATCTA.TAAGTACAC
CTTGATCTA.TATAGTGCG	CTTGATCTA.TATAGTGCG
CTTGATCTA.TCCATCATT	CTTGATCTA.TCCATCATT
CTTGATCTA.TGCCAGACG	CTTGATCTA.TGCCAGACG
CTTGCACAA.AATGTGCGT	CTTGCACAA.AATGTGCGT
CTTGCACAA.AGCGCATGA	CTTGCACAA.AGCGCATGA
CTTGCACAA.AGTTAGGTC	CTTGCACAA.AGTTAGGTC
CTTGCACAA.CACAACCAG	CTTGCACAA.CACAACCAG
CTTGCACAA.CCATATCTT	CTTGCACAA.CCATATCTT
CTTGCACAA.CTGAGTCCA	CTTGCACAA.CTGAGTCCA
CTTGCACAA.CTGTACGAC	CTTGCACAA.CTGTACGAC
CTTGCACAA.GGATACAAT	CTTGCACAA.GGATACAAT
CTTGCACAA.GTAACAGTC	CTTGCACAA.GTAACAGTC
CTTGCACAA.TAGGTCAAC	CTTGCACAA.TAGGTCAAC
CTTGCACAA.TCGCGTCAT	CTTGCACAA.TCGCGTCAT
CTTGCACAA.TGTTAAGCC	CTTGCACAA.TGTTAAGCC
CTTGCGACC.AGATCTGAC	CTTGCGACC.AGATCTGAC
CTTGGATCA.AGCCGGATC	CTTGGATCA.AGCCGGATC
CTTGGATCA.ATCCTGCCT	CTTGGATCA.ATCCTGCCT
CTTGGATCA.CCAGCCAAT	CTTGGATCA.CCAGCCAAT
CTTGGTCAT.AGCCGGATC	CTTGGTCAT.AGCCGGATC
CTTGGTCAT.AGTCCAGTG	CTTGGTCAT.AGTCCAGTG
CTTGGTCAT.ATGTGAGAC	CTTGGTCAT.ATGTGAGAC
CTTGGTCAT.CATAAGATC	CTTGGTCAT.CATAAGATC
CTTGGTCAT.CCGTAGTTG	CTTGGTCAT.CCGTAGTTG
CTTGGTCAT.CTAACTAAG	CTTGGTCAT.CTAACTAAG
CTTGGTCAT.CTTGGTCAT	CTTGGTCAT.CTTGGTCAT
CTTGGTCAT.GCACTGGAT	CTTGGTCAT.GCACTGGAT
CTTGGTCAT.GTGAGGACG	CTTGGTCAT.GTGAGGACG
CTTGGTCAT.GTGGTTACC	CTTGGTCAT.GTGGTTACC
CTTGGTCAT.TCTGCGCTG	CTTGGTCAT.TCTGCGCTG
CTTGGTCAT.TTCACTCCT	CTTGGTCAT.TTCACTCCT
CTTGTAACG.ACTTGATCT	CTTGTAACG.ACTTGATCT
CTTGTAACG.AGCCACTTC	CTTGTAACG.AGCCACTTC
CTTGTAACG.CAATGCATT	CTTGTAACG.CAATGCATT
CTTGTAACG.CGCGATGTA	CTTGTAACG.CGCGATGTA
CTTGTAACG.GACGTCAAT	CTTGTAACG.GACGTCAAT
CTTGTAACG.GGATTACGC	CTTGTAACG.GGATTACGC
GAACAACCA.AATCGTGTT	GAACAACCA.AATCGTGTT
GAACAACCA.AGCTTCGAT	GAACAACCA.AGCTTCGAT
GAACAACCA.CATCCAGGA	GAACAACCA.CATCCAGGA
GAACAACCA.CATGCCAGT	GAACAACCA.CATGCCAGT
GAACAACCA.CCGCAATGG	GAACAACCA.CCGCAATGG
GAACAACCA.CCTGTCATT	GAACAACCA.CCTGTCATT
GAACAACCA.TAAGTGTAG	GAACAACCA.TAAGTGTAG
GAACAACCA.TGGAAGATT	GAACAACCA.TGGAAGATT
GAACAACCA.TGTGCCATG	GAACAACCA.TGTGCCATG
GAACATGAC.ATAATCGAG	GAACATGAC.ATAATCGAG
GAACATGAC.CCGCATCCT	GAACATGAC.CCGCATCCT
GAACATGAC.GACCAACAG	GAACATGAC.GACCAACAG
GAACATGAC.TCAGTGCAA	GAACATGAC.TCAGTGCAA
GAACATGAC.TTGGTAACT	GAACATGAC.TTGGTAACT
GAACCAGTT.ACTGGTGCT	GAACCAGTT.ACTGGTGCT
GAACCAGTT.AGACTAGTA	GAACCAGTT.AGACTAGTA
GAACCAGTT.CCGTAGTTG	GAACCAGTT.CCGTAGTTG
GAACCAGTT.CGACAGGAA	GAACCAGTT.CGACAGGAA
GAACCAGTT.CTCCTGACG	GAACCAGTT.CTCCTGACG
GAACCAGTT.GACGCCGTA	GAACCAGTT.GACGCCGTA
GAACCAGTT.GAGACTCGA	GAACCAGTT.GAGACTCGA
GAACCAGTT.GCTAGCTCC	GAACCAGTT.GCTAGCTCC
GAACCAGTT.GGATCAATG	GAACCAGTT.GGATCAATG
GAACCAGTT.GTAACGCGA	GAACCAGTT.GTAACGCGA
GAACCAGTT.TACAACACC	GAACCAGTT.TACAACACC
GAACCAGTT.TTAACGGAG	GAACCAGTT.TTAACGGAG
GAACCAGTT.TTGATGAGT	GAACCAGTT.TTGATGAGT
GAACCTTCA.ACTCACGAA	GAACCTTCA.ACTCACGAA
GAACCTTCA.AGTCCAGTG	GAACCTTCA.AGTCCAGTG
GAACCTTCA.ATAAGTTCG	GAACCTTCA.ATAAGTTCG
GAACCTTCA.GAGCCATCC	GAACCTTCA.GAGCCATCC
GAACCTTCA.GGTCTCATG	GAACCTTCA.GGTCTCATG
GAACCTTCA.GTCGTGTTA	GAACCTTCA.GTCGTGTTA
GAACCTTCA.TGTAGCAAG	GAACCTTCA.TGTAGCAAG
GAACGCTGT.AGTCTGGAA	GAACGCTGT.AGTCTGGAA
GAACGCTGT.CCACGTTCT	GAACGCTGT.CCACGTTCT
GAACTATGG.AGCGTCGTC	GAACTATGG.AGCGTCGTC
GAACTATGG.CCTCCTTGT	GAACTATGG.CCTCCTTGT
GAACTATGG.CGGTTCTAT	GAACTATGG.CGGTTCTAT
GAACTATGG.GGACTATTC	GAACTATGG.GGACTATTC
GAACTATGG.GTAAGTGAG	GAACTATGG.GTAAGTGAG
GAACTATGG.TCCAATCAT	GAACTATGG.TCCAATCAT
GAACTATGG.TCGATTCAG	GAACTATGG.TCGATTCAG
GAACTATGG.TTCATCCAA	GAACTATGG.TTCATCCAA
GAACTCGTA.CAACACCTA	GAACTCGTA.CAACACCTA
GAACTCGTA.CGGTCGACA	GAACTCGTA.CGGTCGACA
GAACTGCAA.AAGTTGCCA	GAACTGCAA.AAGTTGCCA
GAACTGCAA.AATCAGGAG	GAACTGCAA.AATCAGGAG
GAACTGCAA.ACTCGTAGG	GAACTGCAA.ACTCGTAGG
GAACTGCAA.ACTCTAGGA	GAACTGCAA.ACTCTAGGA
GAACTGCAA.GACCGCTTC	GAACTGCAA.GACCGCTTC
GAACTGCAA.TCTATTAGG	GAACTGCAA.TCTATTAGG
GAACTGCAA.TGCAGTTCA	GAACTGCAA.TGCAGTTCA
GAAGAGCAC.ACTACTCAT	GAAGAGCAC.ACTACTCAT
GAAGAGCAC.GATGCGACG	GAAGAGCAC.GATGCGACG
GAAGAGCAC.GTGGATAAG	GAAGAGCAC.GTGGATAAG
GAAGGATCA.CCGCAGAAT	GAAGGATCA.CCGCAGAAT
GAAGGATCA.CGGAACGAG	GAAGGATCA.CGGAACGAG
GAAGGATCA.TGCGACGTT	GAAGGATCA.TGCGACGTT
GAAGTGTGA.TATTCAACG	GAAGTGTGA.TATTCAACG
GAAGTGTGA.TATTGCTAC	GAAGTGTGA.TATTGCTAC
GAAGTGTGA.TGCTTACGG	GAAGTGTGA.TGCTTACGG
GAATAAGAG.ATGTCGCCT	GAATAAGAG.ATGTCGCCT
GAATAAGAG.CTTCCTGAT	GAATAAGAG.CTTCCTGAT
GAATAAGAG.GCCTGGAAT	GAATAAGAG.GCCTGGAAT
GAATAAGAG.GTATTACTG	GAATAAGAG.GTATTACTG
GAATAAGAG.TAACACGAG	GAATAAGAG.TAACACGAG
GAATAAGAG.TAATCACGC	GAATAAGAG.TAATCACGC
GAATAAGAG.TTATCCAAG	GAATAAGAG.TTATCCAAG
GAATCAACC.CATAAGATC	GAATCAACC.CATAAGATC
GAATCAACC.GCTAGTGGA	GAATCAACC.GCTAGTGGA
GAATCACAT.ATCTGCGTA	GAATCACAT.ATCTGCGTA
GAATCACAT.CAGTATGAT	GAATCACAT.CAGTATGAT
GAATCACAT.CCACTGAAG	GAATCACAT.CCACTGAAG
GAATCACAT.TGGTAGCAG	GAATCACAT.TGGTAGCAG
GAATCGAGA.ACCACGCTA	GAATCGAGA.ACCACGCTA
GAATCGAGA.AGCTACTCA	GAATCGAGA.AGCTACTCA
GAATCGAGA.ATAGTCTCC	GAATCGAGA.ATAGTCTCC
GAATCGAGA.ATGTGAGAC	GAATCGAGA.ATGTGAGAC
GAATCGAGA.CGATAGGTG	GAATCGAGA.CGATAGGTG
GAATCGAGA.CTAGAGTCG	GAATCGAGA.CTAGAGTCG
GAATCGAGA.GATGCTCCT	GAATCGAGA.GATGCTCCT
GAATCGAGA.GGATAGTCA	GAATCGAGA.GGATAGTCA
GAATTCAGT.AGGAATTGG	GAATTCAGT.AGGAATTGG
GAATTCAGT.ATTCATGTG	GAATTCAGT.ATTCATGTG
GAATTCAGT.TCTAATACC	GAATTCAGT.TCTAATACC
GAATTCAGT.TGTAGCAAG	GAATTCAGT.TGTAGCAAG
GAATTGTTG.AATCGCCAT	GAATTGTTG.AATCGCCAT
GAATTGTTG.ACGCTCTTA	GAATTGTTG.ACGCTCTTA
GAATTGTTG.GATGCGGTT	GAATTGTTG.GATGCGGTT
GAATTGTTG.GTGCTAAGC	GAATTGTTG.GTGCTAAGC
GAATTGTTG.TCAATCTAG	GAATTGTTG.TCAATCTAG
GACAATGTT.ACGACATCT	GACAATGTT.ACGACATCT
GACAATGTT.CAGCTTCGA	GACAATGTT.CAGCTTCGA
GACAATGTT.CCTAGCAAT	GACAATGTT.CCTAGCAAT
GACAATGTT.TGTAGATCG	GACAATGTT.TGTAGATCG
GACACCGAT.CAACACCTA	GACACCGAT.CAACACCTA
GACACCGAT.GCCTGGAAT	GACACCGAT.GCCTGGAAT
GACACCGAT.GTACCACAA	GACACCGAT.GTACCACAA
GACACCGAT.TCAGCGACC	GACACCGAT.TCAGCGACC
GACACCGAT.TTCGGAGTC	GACACCGAT.TTCGGAGTC
GACAGGTTA.ACGGTGTAC	GACAGGTTA.ACGGTGTAC
GACATAACG.ACTCCAACT	GACATAACG.ACTCCAACT
GACATAACG.TGCTCCTCC	GACATAACG.TGCTCCTCC
