ATGCTCACC.CATCGAAGC	ATGCTCACC.CATCGAAGC
ATGCTCACC.CTCTTCAGC	ATGCTCACC.CTCTTCAGC
ATGCTGTCG.CGTGACCAG	ATGCTGTCG.CGTGACCAG
ATGCTGTCG.GATTGAGTA	ATGCTGTCG.GATTGAGTA
ATGCTGTCG.TAGGTCAAC	ATGCTGTCG.TAGGTCAAC
ATGCTTCAG.ATATGTCCA	ATGCTTCAG.ATATGTCCA
ATGCTTCAG.TACAACACC	ATGCTTCAG.TACAACACC
ATGGACGTT.AGTGGAATG	ATGGACGTT.AGTGGAATG
ATGGACGTT.ATGCCTTCA	ATGGACGTT.ATGCCTTCA
ATGGACGTT.CTCCTGACG	ATGGACGTT.CTCCTGACG
ATGGACGTT.TTGAGCTCT	ATGGACGTT.TTGAGCTCT
ATGGAGAGT.AGCATATGG	ATGGAGAGT.AGCATATGG
ATGGAGAGT.CAATTGTCT	ATGGAGAGT.CAATTGTCT
ATGGAGAGT.CACAACCAG	ATGGAGAGT.CACAACCAG
ATGGAGAGT.CTTCCTGAT	ATGGAGAGT.CTTCCTGAT
ATGGAGAGT.GTGCTAAGC	ATGGAGAGT.GTGCTAAGC
ATGGAGAGT.TAATCTGGA	ATGGAGAGT.TAATCTGGA
ATGGAGGAA.AGCTTGGTG	ATGGAGGAA.AGCTTGGTG
ATGGAGGAA.CGTCTGCTG	ATGGAGGAA.CGTCTGCTG
ATGGAGGAA.GATCGATAC	ATGGAGGAA.GATCGATAC
ATGGAGGAA.GCCTTCCAT	ATGGAGGAA.GCCTTCCAT
ATGGAGGAA.TCATGCAGG	ATGGAGGAA.TCATGCAGG
ATGGAGGAA.TCGTCCGAT	ATGGAGGAA.TCGTCCGAT
ATGGAGGAA.TCTCATCGG	ATGGAGGAA.TCTCATCGG
ATGGATATC.ACCATACTT	ATGGATATC.ACCATACTT
ATGGATATC.ACCTGCAGA	ATGGATATC.ACCTGCAGA
ATGGATATC.ATCGTAGTG	ATGGATATC.ATCGTAGTG
ATGGATATC.CATGTCCTG	ATGGATATC.CATGTCCTG
ATGGATATC.CCGCAATGG	ATGGATATC.CCGCAATGG
ATGGATATC.CCTCGCGTT	ATGGATATC.CCTCGCGTT
ATGGATATC.CCTTCGAGC	ATGGATATC.CCTTCGAGC
ATGGATATC.TATTGACTG	ATGGATATC.TATTGACTG
ATGGATATC.TCCTATTCC	ATGGATATC.TCCTATTCC
ATGGATATC.TTATCCAAG	ATGGATATC.TTATCCAAG
ATGGTTCGA.AACGTCGAG	ATGGTTCGA.AACGTCGAG
ATGGTTCGA.AAGTTGCCA	ATGGTTCGA.AAGTTGCCA
ATGGTTCGA.AGCCACTTC	ATGGTTCGA.AGCCACTTC
ATGGTTCGA.CATAGAGAT	ATGGTTCGA.CATAGAGAT
ATGGTTCGA.CGTGACCAG	ATGGTTCGA.CGTGACCAG
ATGGTTCGA.GATCGATAC	ATGGTTCGA.GATCGATAC
ATGGTTCGA.GTCGCAGGT	ATGGTTCGA.GTCGCAGGT
ATGGTTCGA.TATGAAGAC	ATGGTTCGA.TATGAAGAC
ATGGTTCGA.TCTATGACA	ATGGTTCGA.TCTATGACA
ATGTCCTCC.AACAGATCG	ATGTCCTCC.AACAGATCG
ATGTCCTCC.AACTGATTC	ATGTCCTCC.AACTGATTC
ATGTCCTCC.ATGTCGCCT	ATGTCCTCC.ATGTCGCCT
ATGTCCTCC.CCGAATATG	ATGTCCTCC.CCGAATATG
ATGTCCTCC.CCGACGTCA	ATGTCCTCC.CCGACGTCA
ATGTCCTCC.CTTACATGC	ATGTCCTCC.CTTACATGC
ATGTCCTCC.GCAGCTTGA	ATGTCCTCC.GCAGCTTGA
ATGTCCTCC.TGAGTTAAG	ATGTCCTCC.TGAGTTAAG
ATGTCGCCT.AGAGCGCGA	ATGTCGCCT.AGAGCGCGA
ATGTCGCCT.AGGATCTCA	ATGTCGCCT.AGGATCTCA
ATGTCGCCT.CACGTCATA	ATGTCGCCT.CACGTCATA
ATGTCGCCT.CCGGTGGTT	ATGTCGCCT.CCGGTGGTT
ATGTCGCCT.GCCGAGTCT	ATGTCGCCT.GCCGAGTCT
ATGTCGCCT.GCTGACAGA	ATGTCGCCT.GCTGACAGA
ATGTCGCCT.TCTCCGCGT	ATGTCGCCT.TCTCCGCGT
ATGTCGCCT.TGCGACGTT	ATGTCGCCT.TGCGACGTT
ATGTGACGA.AAGCACAAC	ATGTGACGA.AAGCACAAC
ATGTGACGA.AGTTGTGTA	ATGTGACGA.AGTTGTGTA
ATGTGACGA.GACTCAGTG	ATGTGACGA.GACTCAGTG
ATGTGACGA.GTGTTGGAA	ATGTGACGA.GTGTTGGAA
ATGTGAGAC.AGACTTCGT	ATGTGAGAC.AGACTTCGT
ATGTGAGAC.ATCTCGAAC	ATGTGAGAC.ATCTCGAAC
ATGTGAGAC.CATAGTATG	ATGTGAGAC.CATAGTATG
ATGTGAGAC.GTGGATAAG	ATGTGAGAC.GTGGATAAG
ATGTGAGAC.TAGGAGGAT	ATGTGAGAC.TAGGAGGAT
ATGTGAGAC.TGTACACGA	ATGTGAGAC.TGTACACGA
ATTAAGACC.ACTCTAGGA	ATTAAGACC.ACTCTAGGA
ATTAAGACC.CACGACTCA	ATTAAGACC.CACGACTCA
ATTAAGACC.CGCATCTAC	ATTAAGACC.CGCATCTAC
ATTAAGACC.CTTAGAAGG	ATTAAGACC.CTTAGAAGG
ATTAGCACA.AAGTCATGA	ATTAGCACA.AAGTCATGA
ATTAGCACA.CAATCATAC	ATTAGCACA.CAATCATAC
ATTAGCACA.TCACGCGAC	ATTAGCACA.TCACGCGAC
ATTAGCACA.TTCAACTAC	ATTAGCACA.TTCAACTAC
ATTAGCCAC.AATGCAGCG	ATTAGCCAC.AATGCAGCG
ATTAGCCAC.CACTTCCTT	ATTAGCCAC.CACTTCCTT
ATTAGCCAC.GCCGTGAAC	ATTAGCCAC.GCCGTGAAC
ATTAGCCAC.TAGTAGTCT	ATTAGCCAC.TAGTAGTCT
ATTAGCGGT.AATCTGACC	ATTAGCGGT.AATCTGACC
ATTAGCGGT.AGGAAGGTG	ATTAGCGGT.AGGAAGGTG
ATTAGCGGT.GGAGAATGA	ATTAGCGGT.GGAGAATGA
ATTAGCGGT.GTTAGTCAA	ATTAGCGGT.GTTAGTCAA
ATTAGCGGT.TGACCTCCT	ATTAGCGGT.TGACCTCCT
ATTAGCGGT.TGGACTGCC	ATTAGCGGT.TGGACTGCC
ATTATGCAG.AGACATATC	ATTATGCAG.AGACATATC
ATTATGCAG.ATCAGTCGA	ATTATGCAG.ATCAGTCGA
ATTATGCAG.CACATTCTG	ATTATGCAG.CACATTCTG
ATTATGCAG.GACGTCAAT	ATTATGCAG.GACGTCAAT
ATTATGCAG.TCTCCGCGT	ATTATGCAG.TCTCCGCGT
ATTATGCAG.TGATGACAG	ATTATGCAG.TGATGACAG
ATTATGCAG.TGCGTGCCA	ATTATGCAG.TGCGTGCCA
ATTCACCTC.AGTGAACGG	ATTCACCTC.AGTGAACGG
ATTCATGTG.AGTAACGTA	ATTCATGTG.AGTAACGTA
ATTCATGTG.ATGAGATCC	ATTCATGTG.ATGAGATCC
ATTCATGTG.TAGCAGAGT	ATTCATGTG.TAGCAGAGT
ATTCCGTAC.ATGCAGTTC	ATTCCGTAC.ATGCAGTTC
ATTCCGTAC.CTCTGCGGT	ATTCCGTAC.CTCTGCGGT
ATTCCTACG.AACCGTGAG	ATTCCTACG.AACCGTGAG
ATTCCTACG.ATCCATTAG	ATTCCTACG.ATCCATTAG
ATTCCTACG.CTTCACTGT	ATTCCTACG.CTTCACTGT
ATTCCTACG.GTGGTTACC	ATTCCTACG.GTGGTTACC
ATTCCTACG.TGGACTGCC	ATTCCTACG.TGGACTGCC
ATTCGAAGA.AAGTCATGA	ATTCGAAGA.AAGTCATGA
ATTCGAAGA.CAGCTCTTC	ATTCGAAGA.CAGCTCTTC
ATTCGAAGA.CAGGAGCCT	ATTCGAAGA.CAGGAGCCT
ATTCGAAGA.GAATTCAGT	ATTCGAAGA.GAATTCAGT
ATTCGAAGA.GATTCTCGG	ATTCGAAGA.GATTCTCGG
ATTCGAAGA.TAGAGCGTC	ATTCGAAGA.TAGAGCGTC
ATTCGAAGA.TCCATCATT	ATTCGAAGA.TCCATCATT
ATTCGCTTA.ATTGCCGAC	ATTCGCTTA.ATTGCCGAC
ATTCGCTTA.CTAGTGCTG	ATTCGCTTA.CTAGTGCTG
ATTCGCTTA.TGCCGAACT	ATTCGCTTA.TGCCGAACT
ATTCTCTGG.AGGTCCGTC	ATTCTCTGG.AGGTCCGTC
ATTCTCTGG.CAAGTCGAA	ATTCTCTGG.CAAGTCGAA
ATTCTCTGG.CCTAGAGTA	ATTCTCTGG.CCTAGAGTA
ATTCTCTGG.GCTAGTGGA	ATTCTCTGG.GCTAGTGGA
ATTCTCTGG.GGTGAGTTC	ATTCTCTGG.GGTGAGTTC
ATTGACACG.ACAGCATCA	ATTGACACG.ACAGCATCA
ATTGACACG.AGGTATTCC	ATTGACACG.AGGTATTCC
ATTGACACG.ATGAGGTAT	ATTGACACG.ATGAGGTAT
ATTGACACG.CATCTCACG	ATTGACACG.CATCTCACG
ATTGACACG.CGGAATGCA	ATTGACACG.CGGAATGCA
ATTGACACG.CTGGTAATC	ATTGACACG.CTGGTAATC
ATTGACACG.CTTCTCATC	ATTGACACG.CTTCTCATC
ATTGACACG.GTAGTTGGT	ATTGACACG.GTAGTTGGT
ATTGACACG.TAGTCGCAT	ATTGACACG.TAGTCGCAT
ATTGATCAC.CCATATCTT	ATTGATCAC.CCATATCTT
ATTGATCAC.GAGTATCGC	ATTGATCAC.GAGTATCGC
ATTGATTGG.ACTCCAACT	ATTGATTGG.ACTCCAACT
ATTGATTGG.AGCCGGATC	ATTGATTGG.AGCCGGATC
ATTGATTGG.ATCTTACAG	ATTGATTGG.ATCTTACAG
ATTGATTGG.ATGCTTCAG	ATTGATTGG.ATGCTTCAG
ATTGATTGG.ATGTCGCCT	ATTGATTGG.ATGTCGCCT
ATTGATTGG.CACGGATAG	ATTGATTGG.CACGGATAG
ATTGCCGAC.AAGGAAGTC	ATTGCCGAC.AAGGAAGTC
ATTGCCGAC.AGCGTCGTC	ATTGCCGAC.AGCGTCGTC
ATTGCCGAC.CACATGTGC	ATTGCCGAC.CACATGTGC
ATTGCCGAC.CACTACAGG	ATTGCCGAC.CACTACAGG
ATTGCCGAC.GATCCGCAC	ATTGCCGAC.GATCCGCAC
ATTGCCGAC.GGTCGGTCT	ATTGCCGAC.GGTCGGTCT
ATTGCCGAC.GTATCCTGC	ATTGCCGAC.GTATCCTGC
ATTGCCGAC.TGTCGTGAG	ATTGCCGAC.TGTCGTGAG
ATTGCGCTA.ATGTCCTCC	ATTGCGCTA.ATGTCCTCC
ATTGCGCTA.CAAGGTGTG	ATTGCGCTA.CAAGGTGTG
ATTGCGCTA.CGCCTGCAA	ATTGCGCTA.CGCCTGCAA
ATTGCGCTA.GCGATATGA	ATTGCGCTA.GCGATATGA
ATTGCGCTA.GTTGACCAT	ATTGCGCTA.GTTGACCAT
ATTGCGCTA.TAGCAGAGT	ATTGCGCTA.TAGCAGAGT
ATTGCGCTA.TGCGATACT	ATTGCGCTA.TGCGATACT
ATTGCGCTA.TTAACGTTC	ATTGCGCTA.TTAACGTTC
ATTGGTTCC.CTGCTTAGG	ATTGGTTCC.CTGCTTAGG
ATTGGTTCC.GATGCTCCT	ATTGGTTCC.GATGCTCCT
ATTGGTTCC.TCAAGCGTA	ATTGGTTCC.TCAAGCGTA
ATTGGTTCC.TGATAGAGG	ATTGGTTCC.TGATAGAGG
ATTGGTTCC.TGCCGACTA	ATTGGTTCC.TGCCGACTA
CAACACCTA.ACAAGAATG	CAACACCTA.ACAAGAATG
CAACACCTA.AGGATCTCA	CAACACCTA.AGGATCTCA
CAACACCTA.ATACGAGGT	CAACACCTA.ATACGAGGT
CAACACCTA.CAGCTCTTC	CAACACCTA.CAGCTCTTC
CAACACCTA.CTCAGCTGG	CAACACCTA.CTCAGCTGG
CAACACCTA.GACTCAGTG	CAACACCTA.GACTCAGTG
CAACACCTA.GCCATTAAG	CAACACCTA.GCCATTAAG
CAACACCTA.TAATCACGC	CAACACCTA.TAATCACGC
CAACACCTA.TAGTGCACT	CAACACCTA.TAGTGCACT
CAACACTCC.CAGTCCTAA	CAACACTCC.CAGTCCTAA
CAACACTCC.CGTGCCTAT	CAACACTCC.CGTGCCTAT
CAACACTCC.GCTTCACTC	CAACACTCC.GCTTCACTC
CAACACTCC.TGGAGAGTG	CAACACTCC.TGGAGAGTG
CAACCGGTC.ATATGTCCA	CAACCGGTC.ATATGTCCA
CAACCGGTC.CAAGTCACT	CAACCGGTC.CAAGTCACT
CAACCGGTC.GAGTCACCA	CAACCGGTC.GAGTCACCA
CAACCGGTC.TAGCTGTTG	CAACCGGTC.TAGCTGTTG
CAACCGGTC.TATGGTTGG	CAACCGGTC.TATGGTTGG
CAACCGGTC.TGAGGTCTC	CAACCGGTC.TGAGGTCTC
CAACCTGGT.AGACTTCGT	CAACCTGGT.AGACTTCGT
CAACCTGGT.AGGTATTCC	CAACCTGGT.AGGTATTCC
CAACCTGGT.GCAACTCGC	CAACCTGGT.GCAACTCGC
CAACCTGGT.GCACATGTT	CAACCTGGT.GCACATGTT
CAACCTGGT.GCGAACTCG	CAACCTGGT.GCGAACTCG
CAACCTGGT.GTACGTCTA	CAACCTGGT.GTACGTCTA
CAACCTGGT.TCGTGCCAC	CAACCTGGT.TCGTGCCAC
CAACGATCG.CACGTAGAC	CAACGATCG.CACGTAGAC
CAACGATCG.CCAGCCAAT	CAACGATCG.CCAGCCAAT
CAACGATCG.GACTTCACC	CAACGATCG.GACTTCACC
CAACGATCG.GAGGTCACG	CAACGATCG.GAGGTCACG
CAACGATCG.TTGGACTTC	CAACGATCG.TTGGACTTC
CAACGCACA.ATGGAGAGT	CAACGCACA.ATGGAGAGT
CAACGCACA.CACCAAGAT	CAACGCACA.CACCAAGAT
CAACGCACA.CATAATTGG	CAACGCACA.CATAATTGG
CAACGCACA.CTGATCAAG	CAACGCACA.CTGATCAAG
CAACGCACA.GCCTTAGAG	CAACGCACA.GCCTTAGAG
CAACGCACA.GTCCTTCAT	CAACGCACA.GTCCTTCAT
CAACGCACA.TGTAACAGT	CAACGCACA.TGTAACAGT
CAACGTCTT.ACCTGTACC	CAACGTCTT.ACCTGTACC
CAACGTCTT.AGTGATGCG	CAACGTCTT.AGTGATGCG
CAACGTCTT.CACCTCGGA	CAACGTCTT.CACCTCGGA
CAACGTCTT.CCTTCGAGC	CAACGTCTT.CCTTCGAGC
CAACGTCTT.GAACTGCAA	CAACGTCTT.GAACTGCAA
CAACGTCTT.GGAGATGAG	CAACGTCTT.GGAGATGAG
CAACTAATC.AATGCAGCG	CAACTAATC.AATGCAGCG
CAACTAATC.AGAAGAGTC	CAACTAATC.AGAAGAGTC
CAACTAATC.CGTGTCCGA	CAACTAATC.CGTGTCCGA
CAACTAATC.CGTTGATCC	CAACTAATC.CGTTGATCC
CAACTAATC.CTCTCGATA	CAACTAATC.CTCTCGATA
CAACTAATC.CTTCCGTGG	CAACTAATC.CTTCCGTGG
CAACTAATC.GACTAGCAT	CAACTAATC.GACTAGCAT
CAACTAATC.TCTGATGAA	CAACTAATC.TCTGATGAA
CAACTAATC.TTCACTGGA	CAACTAATC.TTCACTGGA
CAACTCCAG.CTCCTGACG	CAACTCCAG.CTCCTGACG
CAACTCCAG.GAGTCTTCG	CAACTCCAG.GAGTCTTCG
CAACTCCAG.GTTAGATTG	CAACTCCAG.GTTAGATTG
CAACTCCAG.TCAGCTCAG	CAACTCCAG.TCAGCTCAG
CAACTCCAG.TTGTAATGC	CAACTCCAG.TTGTAATGC
CAAGAACCG.AGCGGTAAG	CAAGAACCG.AGCGGTAAG
CAAGAACCG.AGTTGTGTA	CAAGAACCG.AGTTGTGTA
CAAGAACCG.CGGAATGCA	CAAGAACCG.CGGAATGCA
CAAGAACCG.GATACTGTG	CAAGAACCG.GATACTGTG
CAAGAACCG.GATGCAGAA	CAAGAACCG.GATGCAGAA
CAAGAACCG.GGAGCATCT	CAAGAACCG.GGAGCATCT
CAAGAGAGT.ATGAACTAG	CAAGAGAGT.ATGAACTAG
CAAGAGAGT.GATCTTCGC	CAAGAGAGT.GATCTTCGC
CAAGAGAGT.GCACATGTT	CAAGAGAGT.GCACATGTT
CAAGAGAGT.GCTACCTTA	CAAGAGAGT.GCTACCTTA
CAAGAGAGT.GTCATTCTA	CAAGAGAGT.GTCATTCTA
CAAGAGAGT.GTGAGGACG	CAAGAGAGT.GTGAGGACG
CAAGAGAGT.TGCCAGACG	CAAGAGAGT.TGCCAGACG
CAAGAGGAG.ATCCTGCCT	CAAGAGGAG.ATCCTGCCT
CAAGAGGAG.ATGGACGTT	CAAGAGGAG.ATGGACGTT
CAAGAGGAG.CACCTAGCG	CAAGAGGAG.CACCTAGCG
CAAGAGGAG.GACGTCAAT	CAAGAGGAG.GACGTCAAT
CAAGAGGAG.TAGCAGAGT	CAAGAGGAG.TAGCAGAGT
CAAGAGGAG.TCGCATTCG	CAAGAGGAG.TCGCATTCG
CAAGAGGAG.TTCGTGATG	CAAGAGGAG.TTCGTGATG
CAAGCCTCG.ACTGTGTCA	CAAGCCTCG.ACTGTGTCA
CAAGCCTCG.CGAGTAGCA	CAAGCCTCG.CGAGTAGCA
CAAGCCTCG.GAACATGAC	CAAGCCTCG.GAACATGAC
CAAGCCTCG.GCCATCGCT	CAAGCCTCG.GCCATCGCT
CAAGCCTCG.TAAGCCATT	CAAGCCTCG.TAAGCCATT
CAAGCGCAT.ACACGTTGC	CAAGCGCAT.ACACGTTGC
CAAGCGCAT.CGTCATGGA	CAAGCGCAT.CGTCATGGA
CAAGCGCAT.GTAGCTACA	CAAGCGCAT.GTAGCTACA
CAAGCTGCA.GTAGCATAC	CAAGCTGCA.GTAGCATAC
CAAGGTGTG.ACTCGAGTC	CAAGGTGTG.ACTCGAGTC
CAAGGTGTG.AGTGGAATG	CAAGGTGTG.AGTGGAATG
CAAGGTGTG.CATCCACCG	CAAGGTGTG.CATCCACCG
CAAGGTGTG.CTACCTGCG	CAAGGTGTG.CTACCTGCG
CAAGGTGTG.GACTGCGCA	CAAGGTGTG.GACTGCGCA
CAAGGTGTG.GTGTCCGTG	CAAGGTGTG.GTGTCCGTG
CAAGGTGTG.TAGTGCACT	CAAGGTGTG.TAGTGCACT
CAAGGTGTG.TGTACACGA	CAAGGTGTG.TGTACACGA
CAAGGTGTG.TGTCAACCT	CAAGGTGTG.TGTCAACCT
CAAGGTGTG.TTGTCAACC	CAAGGTGTG.TTGTCAACC
CAAGTACGA.CTGGTACAT	CAAGTACGA.CTGGTACAT
CAAGTACGA.GGAACTGCT	CAAGTACGA.GGAACTGCT
CAAGTACGA.GTGTCTGGA	CAAGTACGA.GTGTCTGGA
CAAGTACGA.TATGCCTTC	CAAGTACGA.TATGCCTTC
CAAGTACGA.TGGAGTGGA	CAAGTACGA.TGGAGTGGA
CAAGTCACT.AAGCCACAC	CAAGTCACT.AAGCCACAC
CAAGTCACT.AGTTGTGTA	CAAGTCACT.AGTTGTGTA
CAAGTCACT.CGTGTATTC	CAAGTCACT.CGTGTATTC
CAAGTCACT.CTAGTATAG	CAAGTCACT.CTAGTATAG
CAAGTCACT.CTATTCCGT	CAAGTCACT.CTATTCCGT
CAAGTCACT.GGAGTTAGC	CAAGTCACT.GGAGTTAGC
CAAGTCGAA.AACAATGCA	CAAGTCGAA.AACAATGCA
CAAGTCGAA.GTAACTCAT	CAAGTCGAA.GTAACTCAT
CAAGTCGAA.TGCTCCTCC	CAAGTCGAA.TGCTCCTCC
CAATACCAC.AAGCTGAGG	CAATACCAC.AAGCTGAGG
CAATACCAC.AATGTGCGT	CAATACCAC.AATGTGCGT
CAATACCAC.ACTAACCGA	CAATACCAC.ACTAACCGA
CAATACCAC.ATGATAGCT	CAATACCAC.ATGATAGCT
CAATACCAC.CACTCACTA	CAATACCAC.CACTCACTA
CAATACCAC.GAGTCCAAT	CAATACCAC.GAGTCCAAT
CAATACCAC.GATACACTA	CAATACCAC.GATACACTA
CAATACCAC.GATGTTACA	CAATACCAC.GATGTTACA
CAATACCAC.GCTGACAGA	CAATACCAC.GCTGACAGA
CAATACCAC.TCACAGGTA	CAATACCAC.TCACAGGTA
CAATCAAGT.AACTCCATG	CAATCAAGT.AACTCCATG
CAATCAAGT.CGATTGAAC	CAATCAAGT.CGATTGAAC
CAATCAAGT.GACTCTCAC	CAATCAAGT.GACTCTCAC
CAATCAAGT.GTAGGACGC	CAATCAAGT.GTAGGACGC
CAATCAAGT.GTCACTATG	CAATCAAGT.GTCACTATG
CAATCAAGT.TCCAGAACG	CAATCAAGT.TCCAGAACG
CAATCAAGT.TCCAGCTAT	CAATCAAGT.TCCAGCTAT
CAATCATAC.AGTCAGTTG	CAATCATAC.AGTCAGTTG
CAATCATAC.CACTTCCTT	CAATCATAC.CACTTCCTT
CAATCATAC.CGAGCTTAC	CAATCATAC.CGAGCTTAC
CAATCATAC.CTCAGGTAC	CAATCATAC.CTCAGGTAC
CAATCTCCG.CCGAGCTGA	CAATCTCCG.CCGAGCTGA
CAATCTCCG.TTCTGCCGA	CAATCTCCG.TTCTGCCGA
CAATGCATT.CAACACCTA	CAATGCATT.CAACACCTA
CAATGCATT.GACGTAGCA	CAATGCATT.GACGTAGCA
CAATGCATT.GCCGAGTCT	CAATGCATT.GCCGAGTCT
CAATGCATT.TATCACCTG	CAATGCATT.TATCACCTG
CAATGCATT.TGAAGACCA	CAATGCATT.TGAAGACCA
CAATGTGCT.ATAGTCTCC	CAATGTGCT.ATAGTCTCC
CAATGTGCT.CACATATCA	CAATGTGCT.CACATATCA
CAATGTGCT.GAATAAGAG	CAATGTGCT.GAATAAGAG
CAATGTGCT.GCACAACTC	CAATGTGCT.GCACAACTC
CAATGTGCT.GGAACCTAG	CAATGTGCT.GGAACCTAG
CAATGTGCT.GTAACTCAT	CAATGTGCT.GTAACTCAT
CAATTGTCT.ACAAGGTAC	CAATTGTCT.ACAAGGTAC
CAATTGTCT.ATCAGGATG	CAATTGTCT.ATCAGGATG
CAATTGTCT.CCAGTCTCA	CAATTGTCT.CCAGTCTCA
CAATTGTCT.CTTCGACTG	CAATTGTCT.CTTCGACTG
CAATTGTCT.GCTCTCCAA	CAATTGTCT.GCTCTCCAA
CAATTGTCT.GTATGATCT	CAATTGTCT.GTATGATCT
CAATTGTCT.GTGAACCAC	CAATTGTCT.GTGAACCAC
CACAACCAG.ATATGTCCA	CACAACCAG.ATATGTCCA
CACAACCAG.CCAACAACA	CACAACCAG.CCAACAACA
CACAACCAG.TCGAACGCT	CACAACCAG.TCGAACGCT
CACAACCAG.TGTGCAGTA	CACAACCAG.TGTGCAGTA
CACAACGCT.ACCTGCAGA	CACAACGCT.ACCTGCAGA
CACAACGCT.CCAGCCAAT	CACAACGCT.CCAGCCAAT
CACAACGCT.CTCTACGCA	CACAACGCT.CTCTACGCA
CACAACGCT.GATATGGAC	CACAACGCT.GATATGGAC
CACAACGCT.GCGAGTCTA	CACAACGCT.GCGAGTCTA
CACAACGCT.GTTCACTCC	CACAACGCT.GTTCACTCC
CACAACGCT.TACGTTACC	CACAACGCT.TACGTTACC
CACAACGCT.TATACCACT	CACAACGCT.TATACCACT
CACAATAAC.AACCATGGT	CACAATAAC.AACCATGGT
CACAATAAC.GCTATGTAA	CACAATAAC.GCTATGTAA
CACAATAAC.TGAGATCAT	CACAATAAC.TGAGATCAT
CACACCACA.AATCGCCAT	CACACCACA.AATCGCCAT
CACACCACA.CACGTCATA	CACACCACA.CACGTCATA
CACACCACA.CTTCCGTGG	CACACCACA.CTTCCGTGG
CACACCACA.GAGACATTG	CACACCACA.GAGACATTG
CACACCACA.GCGAAGACA	CACACCACA.GCGAAGACA
CACACCACA.GTAGCTACA	CACACCACA.GTAGCTACA
CACACCACA.GTTGACCAT	CACACCACA.GTTGACCAT
CACACCACA.TACAGGACT	CACACCACA.TACAGGACT
CACACCACA.TTATTCGAC	CACACCACA.TTATTCGAC
CACACCTGT.AGAGCCGCA	CACACCTGT.AGAGCCGCA
CACACCTGT.CGTATTCCT	CACACCTGT.CGTATTCCT
CACACCTGT.TAGTGCACT	CACACCTGT.TAGTGCACT
CACACCTGT.TGTCTACAC	CACACCTGT.TGTCTACAC
CACACCTGT.TGTTAAGCC	CACACCTGT.TGTTAAGCC
CACACTGCC.AACGAGGTG	CACACTGCC.AACGAGGTG
CACACTGCC.AGAGCGGAG	CACACTGCC.AGAGCGGAG
CACACTGCC.AGCTTGGTG	CACACTGCC.AGCTTGGTG
CACACTGCC.ATTAGCACA	CACACTGCC.ATTAGCACA
CACACTGCC.TGTCACATA	CACACTGCC.TGTCACATA
CACAGCGAA.ACGACGATT	CACAGCGAA.ACGACGATT
CACAGCGAA.AGCCTCGCA	CACAGCGAA.AGCCTCGCA
CACAGCGAA.CTGGACTAA	CACAGCGAA.CTGGACTAA
CACAGCGAA.TTCAACTAC	CACAGCGAA.TTCAACTAC
CACATATCA.AGATACGTT	CACATATCA.AGATACGTT
CACATATCA.CTAGTGCTG	CACATATCA.CTAGTGCTG
CACATATCA.TGCTATGAA	CACATATCA.TGCTATGAA
CACATGTGC.AATCCTCGT	CACATGTGC.AATCCTCGT
CACATGTGC.ACATGACTA	CACATGTGC.ACATGACTA
CACATGTGC.ATCGAATCG	CACATGTGC.ATCGAATCG
CACATGTGC.ATGCTTCAG	CACATGTGC.ATGCTTCAG
CACATGTGC.CACCTACGC	CACATGTGC.CACCTACGC
CACATGTGC.CATCTCGAT	CACATGTGC.CATCTCGAT
CACATGTGC.TTATTCGAC	CACATGTGC.TTATTCGAC
CACATGTGC.TTCCAATTC	CACATGTGC.TTCCAATTC
CACATTCTG.GATTCTCGG	CACATTCTG.GATTCTCGG
CACATTCTG.TCGCTGATT	CACATTCTG.TCGCTGATT
CACATTCTG.TCTATTAGG	CACATTCTG.TCTATTAGG
CACATTCTG.TGCAGATGC	CACATTCTG.TGCAGATGC
CACCAAGAT.ACTTCTAAC	CACCAAGAT.ACTTCTAAC
CACCAAGAT.AGCCACTTC	CACCAAGAT.AGCCACTTC
CACCAAGAT.CCAACAACA	CACCAAGAT.CCAACAACA
CACCAAGAT.CTAGTGCTG	CACCAAGAT.CTAGTGCTG
CACCAAGAT.GGTACTTCC	CACCAAGAT.GGTACTTCC
CACCAAGAT.TCCTCGTCG	CACCAAGAT.TCCTCGTCG
CACCAAGAT.TCGTCATTC	CACCAAGAT.TCGTCATTC
CACCAAGAT.TGATCTCGG	CACCAAGAT.TGATCTCGG
CACCAGAAG.AGTTGTGTA	CACCAGAAG.AGTTGTGTA
CACCAGAAG.ATCACTTCC	CACCAGAAG.ATCACTTCC
CACCAGAAG.CTGAGTAGC	CACCAGAAG.CTGAGTAGC
CACCAGAAG.GCTAGCTCC	CACCAGAAG.GCTAGCTCC
CACCAGAAG.TGCCTGGTT	CACCAGAAG.TGCCTGGTT
CACCAGAAG.TGGATTAGC	CACCAGAAG.TGGATTAGC
CACCTACGC.CCAGCCAAT	CACCTACGC.CCAGCCAAT
CACCTACGC.CCTAAGTCT	CACCTACGC.CCTAAGTCT
CACCTACGC.CTCAGTGAT	CACCTACGC.CTCAGTGAT
CACCTACGC.GGATTACGC	CACCTACGC.GGATTACGC
CACCTACGC.GTGACGTAA	CACCTACGC.GTGACGTAA
CACCTACGC.TCGCTTAAC	CACCTACGC.TCGCTTAAC
CACCTAGCG.ATCCTCCGA	CACCTAGCG.ATCCTCCGA
CACCTAGCG.CCTAAGAAG	CACCTAGCG.CCTAAGAAG
CACCTAGCG.GTCGTTGCG	CACCTAGCG.GTCGTTGCG
CACCTAGCG.TGAGAGGAC	CACCTAGCG.TGAGAGGAC
CACCTAGCG.TGCGCACTG	CACCTAGCG.TGCGCACTG
CACCTAGCG.TTCATCCAA	CACCTAGCG.TTCATCCAA
CACCTCAAC.ATAGTCAGT	CACCTCAAC.ATAGTCAGT
CACCTCAAC.CAAGTCACT	CACCTCAAC.CAAGTCACT
CACCTCAAC.GATGCAGAA	CACCTCAAC.GATGCAGAA
CACCTCAAC.GTTCACTCC	CACCTCAAC.GTTCACTCC
CACCTCAAC.TCGACGTTG	CACCTCAAC.TCGACGTTG
CACCTCGGA.AATTGGTGA	CACCTCGGA.AATTGGTGA
CACCTCGGA.ACGAGAGCA	CACCTCGGA.ACGAGAGCA
CACCTCGGA.ACTCACGAA	CACCTCGGA.ACTCACGAA
CACCTCGGA.CCACACAGA	CACCTCGGA.CCACACAGA
CACCTCGGA.CGGAGACTT	CACCTCGGA.CGGAGACTT
CACCTCGGA.CTACGAGAA	CACCTCGGA.CTACGAGAA
CACCTCGGA.CTGGTACAT	CACCTCGGA.CTGGTACAT
CACCTCGGA.GAGACGATC	CACCTCGGA.GAGACGATC
CACCTCGGA.GGAAGGTAT	CACCTCGGA.GGAAGGTAT
CACCTCGGA.TGAAGACCA	CACCTCGGA.TGAAGACCA
CACCTTCCT.AATACCTTG	CACCTTCCT.AATACCTTG
CACCTTCCT.AATCTGACC	CACCTTCCT.AATCTGACC
CACCTTCCT.CGTGAGACT	CACCTTCCT.CGTGAGACT
CACCTTCCT.GCTCTCCAA	CACCTTCCT.GCTCTCCAA
CACGACTCA.ACAGGAACT	CACGACTCA.ACAGGAACT
CACGACTCA.AGACATCCA	CACGACTCA.AGACATCCA
CACGACTCA.AGCTTCGAT	CACGACTCA.AGCTTCGAT
CACGACTCA.ATCGTAGTG	CACGACTCA.ATCGTAGTG
CACGACTCA.CTTCACTGT	CACGACTCA.CTTCACTGT
CACGACTCA.GAGTCTTCG	CACGACTCA.GAGTCTTCG
CACGACTCA.GTCTACCAA	CACGACTCA.GTCTACCAA
CACGATAGA.AAGCCACAC	CACGATAGA.AAGCCACAC
CACGATAGA.ACTCTGCTC	CACGATAGA.ACTCTGCTC
CACGATAGA.CAATGCATT	CACGATAGA.CAATGCATT
CACGATAGA.CACAGCGAA	CACGATAGA.CACAGCGAA
CACGATAGA.CCGATCAGC	CACGATAGA.CCGATCAGC
CACGATAGA.CTAGAGGTA	CACGATAGA.CTAGAGGTA
CACGATAGA.GAATCAACC	CACGATAGA.GAATCAACC
CACGATAGA.TGAGACAGC	CACGATAGA.TGAGACAGC
CACGATAGA.TTCACCTTG	CACGATAGA.TTCACCTTG
CACGCGTAA.ACCTGCAGA	CACGCGTAA.ACCTGCAGA
CACGCGTAA.GAACTCGTA	CACGCGTAA.GAACTCGTA
CACGCGTAA.GCCGAACCA	CACGCGTAA.GCCGAACCA
CACGCGTAA.TCTAGCTGG	CACGCGTAA.TCTAGCTGG
CACGGAAGT.AATCCTCGT	CACGGAAGT.AATCCTCGT
CACGGAAGT.ACGTGTAGT	CACGGAAGT.ACGTGTAGT
CACGGAAGT.ACTTCTTGG	CACGGAAGT.ACTTCTTGG
CACGGAAGT.AGCCTCGCA	CACGGAAGT.AGCCTCGCA
CACGGAAGT.GTAAGTGAG	CACGGAAGT.GTAAGTGAG
CACGGAAGT.TGAGGTCTC	CACGGAAGT.TGAGGTCTC
CACGGATAG.AACCATGGT	CACGGATAG.AACCATGGT
CACGGATAG.ACGCTCTTA	CACGGATAG.ACGCTCTTA
CACGGATAG.AGACATCCA	CACGGATAG.AGACATCCA
CACGGATAG.GACTTCACC	CACGGATAG.GACTTCACC
CACGGATAG.GTAGAAGTT	CACGGATAG.GTAGAAGTT
CACGTAGAC.AACTAACTG	CACGTAGAC.AACTAACTG
CACGTAGAC.AATATCAGC	CACGTAGAC.AATATCAGC
CACGTAGAC.AGTCCAGTG	CACGTAGAC.AGTCCAGTG
CACGTAGAC.ATCCAGCTG	CACGTAGAC.ATCCAGCTG
CACGTAGAC.CAGAAGTGA	CACGTAGAC.CAGAAGTGA
CACGTAGAC.CCAGTACTC	CACGTAGAC.CCAGTACTC
CACGTAGAC.CCAGTTACG	CACGTAGAC.CCAGTTACG
CACGTAGAC.GCGAGTCTA	CACGTAGAC.GCGAGTCTA
CACGTAGAC.TACCTCCTC	CACGTAGAC.TACCTCCTC
CACGTAGAC.TCTCCGCGT	CACGTAGAC.TCTCCGCGT
CACGTAGAC.TTCAGTGCC	CACGTAGAC.TTCAGTGCC
CACGTCATA.AATGTGCGT	CACGTCATA.AATGTGCGT
CACGTCATA.AGCACCAGC	CACGTCATA.AGCACCAGC
CACGTCATA.GACCTTGTG	CACGTCATA.GACCTTGTG
CACTACAGG.AATACCTTG	CACTACAGG.AATACCTTG
CACTACAGG.CAGTGAGGA	CACTACAGG.CAGTGAGGA
CACTACAGG.TACAAGAGG	CACTACAGG.TACAAGAGG
CACTAGACT.ACACACCGT	CACTAGACT.ACACACCGT
CACTAGACT.ACGCACACT	CACTAGACT.ACGCACACT
CACTAGACT.ATATTCGCA	CACTAGACT.ATATTCGCA
CACTAGACT.CGGAACGAG	CACTAGACT.CGGAACGAG
CACTAGACT.CGTCATGGA	CACTAGACT.CGTCATGGA
CACTAGACT.CTTCGACTG	CACTAGACT.CTTCGACTG
CACTAGACT.GCACAACTC	CACTAGACT.GCACAACTC
CACTAGACT.GGTACGAGC	CACTAGACT.GGTACGAGC
CACTAGACT.GTCCTTCAT	CACTAGACT.GTCCTTCAT
CACTAGACT.TGATCTCGG	CACTAGACT.TGATCTCGG
CACTCACTA.GGACGAGCA	CACTCACTA.GGACGAGCA
CACTCACTA.TCAGCTCAG	CACTCACTA.TCAGCTCAG
CACTCACTA.TGTGTCTAC	CACTCACTA.TGTGTCTAC
CACTGCTTA.AATGCCTCA	CACTGCTTA.AATGCCTCA
CACTGCTTA.CTAACACTG	CACTGCTTA.CTAACACTG
CACTGCTTA.CTTGATCTA	CACTGCTTA.CTTGATCTA
CACTGCTTA.TAACGGATA	CACTGCTTA.TAACGGATA
CACTGCTTA.TGATTGTGC	CACTGCTTA.TGATTGTGC
CACTGGTCC.ACGATGACC	CACTGGTCC.ACGATGACC
CACTGGTCC.ACTACCATC	CACTGGTCC.ACTACCATC
CACTGGTCC.CGTAATGAC	CACTGGTCC.CGTAATGAC
CACTGGTCC.CTTGTAACG	CACTGGTCC.CTTGTAACG
CACTGGTCC.GAGTGCATA	CACTGGTCC.GAGTGCATA
CACTGGTCC.GATTCCTCT	CACTGGTCC.GATTCCTCT
CACTGGTCC.GGAACTGCT	CACTGGTCC.GGAACTGCT
CACTGGTCC.TAGACCTAC	CACTGGTCC.TAGACCTAC
CACTGGTCC.TCTGCAACA	CACTGGTCC.TCTGCAACA
CACTGTATC.ACATTCCAC	CACTGTATC.ACATTCCAC
CACTGTATC.AGACCAGCT	CACTGTATC.AGACCAGCT
CACTGTATC.ATTGATTGG	CACTGTATC.ATTGATTGG
CACTGTATC.GATATGGAC	CACTGTATC.GATATGGAC
CACTGTATC.GGTTCAGAC	CACTGTATC.GGTTCAGAC
CACTGTATC.GTGTCGAGC	CACTGTATC.GTGTCGAGC
CACTGTATC.TAATGTAGC	CACTGTATC.TAATGTAGC
CACTTCCTT.ACGCTATGT	CACTTCCTT.ACGCTATGT
CACTTCCTT.AGCCTCGCA	CACTTCCTT.AGCCTCGCA
CACTTCCTT.CAACACTCC	CACTTCCTT.CAACACTCC
CACTTCCTT.CAACGTCTT	CACTTCCTT.CAACGTCTT
CACTTCCTT.TTAGATCGG	CACTTCCTT.TTAGATCGG
CACTTGGAT.ATCGTAGTG	CACTTGGAT.ATCGTAGTG
CACTTGGAT.CAGGAGCCT	CACTTGGAT.CAGGAGCCT
CACTTGGAT.CGGTCGACA	CACTTGGAT.CGGTCGACA
CAGAAGTGA.ACTTCGCAG	CAGAAGTGA.ACTTCGCAG
CAGAAGTGA.CCTCATAAC	CAGAAGTGA.CCTCATAAC
