TGAACTTGC.ATTAGCACA	TGAACTTGC.ATTAGCACA
TGAACTTGC.GTTATCGAT	TGAACTTGC.GTTATCGAT
TGAAGACCA.ATTCTCTGG	TGAAGACCA.ATTCTCTGG
TGAAGACCA.CACACCACA	TGAAGACCA.CACACCACA
TGAAGACCA.CCTAGCAAT	TGAAGACCA.CCTAGCAAT
TGAAGACCA.CGACAGACC	TGAAGACCA.CGACAGACC
TGAAGACCA.GGATGCTCG	TGAAGACCA.GGATGCTCG
TGAAGACCA.TTGGAGAAC	TGAAGACCA.TTGGAGAAC
TGACAAGTT.AACTTCTGC	TGACAAGTT.AACTTCTGC
TGACAAGTT.ACTACCATC	TGACAAGTT.ACTACCATC
TGACAAGTT.AGCGCATGA	TGACAAGTT.AGCGCATGA
TGACAAGTT.CGTATAGCG	TGACAAGTT.CGTATAGCG
TGACAAGTT.CTAACTAAG	TGACAAGTT.CTAACTAAG
TGACAAGTT.GAGCATACA	TGACAAGTT.GAGCATACA
TGACAAGTT.GGTCGGATA	TGACAAGTT.GGTCGGATA
TGACAAGTT.TGTATGTAG	TGACAAGTT.TGTATGTAG
TGACCAAGT.AACGGAGAT	TGACCAAGT.AACGGAGAT
TGACCAAGT.AACGTCGAG	TGACCAAGT.AACGTCGAG
TGACCAAGT.ATTGACACG	TGACCAAGT.ATTGACACG
TGACCAAGT.CAGTACATC	TGACCAAGT.CAGTACATC
TGACCAAGT.TAGCTAAGA	TGACCAAGT.TAGCTAAGA
TGACCAAGT.TATCTAGGT	TGACCAAGT.TATCTAGGT
TGACCAAGT.TATTACAGC	TGACCAAGT.TATTACAGC
TGACCAAGT.TGTCATAGC	TGACCAAGT.TGTCATAGC
TGACCTATG.AAGACGAAG	TGACCTATG.AAGACGAAG
TGACCTATG.ACCGTCCTA	TGACCTATG.ACCGTCCTA
TGACCTATG.CATAGAGAT	TGACCTATG.CATAGAGAT
TGACCTATG.GCTCAGCCA	TGACCTATG.GCTCAGCCA
TGACCTATG.GGAAGAAGC	TGACCTATG.GGAAGAAGC
TGACCTATG.GTGTCACAC	TGACCTATG.GTGTCACAC
TGACCTATG.TCACGCGAC	TGACCTATG.TCACGCGAC
TGACCTCCT.AGATGTTGG	TGACCTCCT.AGATGTTGG
TGACCTCCT.ATCCGTCTC	TGACCTCCT.ATCCGTCTC
TGACCTCCT.GCACAACTC	TGACCTCCT.GCACAACTC
TGACCTCCT.TCAGGACTG	TGACCTCCT.TCAGGACTG
TGACGATGA.AACTTAGCT	TGACGATGA.AACTTAGCT
TGACGATGA.AGTCTAAGC	TGACGATGA.AGTCTAAGC
TGACGATGA.CATTATGTC	TGACGATGA.CATTATGTC
TGACGATGA.CCTAGAGTA	TGACGATGA.CCTAGAGTA
TGACGATGA.GGTCCTAAG	TGACGATGA.GGTCCTAAG
TGACGATGA.TCCAGAACG	TGACGATGA.TCCAGAACG
TGACGGTTG.ATCGTAGTG	TGACGGTTG.ATCGTAGTG
TGACGGTTG.GATGCTCCT	TGACGGTTG.GATGCTCCT
TGACGGTTG.GTTGCATGG	TGACGGTTG.GTTGCATGG
TGACTGAGA.ACGGTGCCT	TGACTGAGA.ACGGTGCCT
TGACTGAGA.GAACGCTGT	TGACTGAGA.GAACGCTGT
TGACTGAGA.GCAGCAGTG	TGACTGAGA.GCAGCAGTG
TGACTGAGA.TAAGTGTAG	TGACTGAGA.TAAGTGTAG
TGAGAATCC.AACGAGGTG	TGAGAATCC.AACGAGGTG
TGAGAATCC.AAGGATACG	TGAGAATCC.AAGGATACG
TGAGAATCC.AAGTTGCCA	TGAGAATCC.AAGTTGCCA
TGAGAATCC.AATTAGAGG	TGAGAATCC.AATTAGAGG
TGAGAATCC.ACATCGTCC	TGAGAATCC.ACATCGTCC
TGAGAATCC.ACTACCATC	TGAGAATCC.ACTACCATC
TGAGAATCC.ATCAGGATG	TGAGAATCC.ATCAGGATG
TGAGAATCC.ATGGATATC	TGAGAATCC.ATGGATATC
TGAGAGGAC.ATTAGCCAC	TGAGAGGAC.ATTAGCCAC
TGAGAGGAC.CGATTCGAG	TGAGAGGAC.CGATTCGAG
TGAGAGGAC.GTAGACTCT	TGAGAGGAC.GTAGACTCT
TGAGAGGAC.TCAGCTCAG	TGAGAGGAC.TCAGCTCAG
TGAGAGGAC.TCAGTGCAA	TGAGAGGAC.TCAGTGCAA
TGAGAGGAC.TTGGTAACT	TGAGAGGAC.TTGGTAACT
TGAGATCAT.AATGCGTGC	TGAGATCAT.AATGCGTGC
TGAGATCAT.AGGAGCAAT	TGAGATCAT.AGGAGCAAT
TGAGATCAT.AGGATCTCA	TGAGATCAT.AGGATCTCA
TGAGATCAT.ATTCGCTTA	TGAGATCAT.ATTCGCTTA
TGAGATCAT.CACCTACGC	TGAGATCAT.CACCTACGC
TGAGATCAT.CATCCGACA	TGAGATCAT.CATCCGACA
TGAGATCAT.TACGTTGGA	TGAGATCAT.TACGTTGGA
TGAGATCAT.TACTACTGT	TGAGATCAT.TACTACTGT
TGAGATCAT.TATAGTGCG	TGAGATCAT.TATAGTGCG
TGAGATCAT.TCTGCAACA	TGAGATCAT.TCTGCAACA
TGAGCAGAT.ACTCGTAGG	TGAGCAGAT.ACTCGTAGG
TGAGCAGAT.GATGCGACG	TGAGCAGAT.GATGCGACG
TGAGCAGAT.GCGTATAGG	TGAGCAGAT.GCGTATAGG
TGAGCTAGA.CCTACTAGA	TGAGCTAGA.CCTACTAGA
TGAGCTAGA.CGCGAGTGT	TGAGCTAGA.CGCGAGTGT
TGAGGTCTC.AAGGATACG	TGAGGTCTC.AAGGATACG
TGAGGTCTC.AGGTACCAA	TGAGGTCTC.AGGTACCAA
TGAGGTCTC.CGCACTGAA	TGAGGTCTC.CGCACTGAA
TGAGGTCTC.CGCGAGTGT	TGAGGTCTC.CGCGAGTGT
TGAGGTCTC.GTAGTTGGT	TGAGGTCTC.GTAGTTGGT
TGAGGTCTC.TTGGACTTC	TGAGGTCTC.TTGGACTTC
TGAGTGACT.ATAGCTTGC	TGAGTGACT.ATAGCTTGC
TGAGTGACT.CGACGTGAT	TGAGTGACT.CGACGTGAT
TGAGTGACT.CTATAGCTC	TGAGTGACT.CTATAGCTC
TGAGTGACT.GTTCCAACA	TGAGTGACT.GTTCCAACA
TGAGTTAAG.AATCTCCTA	TGAGTTAAG.AATCTCCTA
TGAGTTAAG.CCACTACCA	TGAGTTAAG.CCACTACCA
TGAGTTAAG.CCTTGCTTG	TGAGTTAAG.CCTTGCTTG
TGAGTTAAG.CGGACAAGT	TGAGTTAAG.CGGACAAGT
TGAGTTAAG.CTGAGATAG	TGAGTTAAG.CTGAGATAG
TGAGTTAAG.GATGCAGAA	TGAGTTAAG.GATGCAGAA
TGAGTTAAG.GCCAATGAA	TGAGTTAAG.GCCAATGAA
TGAGTTAAG.TGAGCAGAT	TGAGTTAAG.TGAGCAGAT
TGATACCGT.AAGTCATGA	TGATACCGT.AAGTCATGA
TGATACCGT.AGCTTGGTG	TGATACCGT.AGCTTGGTG
TGATACCGT.CCATAAGTA	TGATACCGT.CCATAAGTA
TGATACCGT.GAGTCTTCG	TGATACCGT.GAGTCTTCG
TGATACCGT.TAGGATGCC	TGATACCGT.TAGGATGCC
TGATAGAGG.ACACATCTG	TGATAGAGG.ACACATCTG
TGATAGAGG.CAGCAGTAC	TGATAGAGG.CAGCAGTAC
TGATAGAGG.GTACAATGC	TGATAGAGG.GTACAATGC
TGATAGAGG.TACCTCACT	TGATAGAGG.TACCTCACT
TGATAGAGG.TGGACGAGA	TGATAGAGG.TGGACGAGA
TGATCGGAA.CATAGGTGT	TGATCGGAA.CATAGGTGT
TGATCGGAA.TGCCTTCAG	TGATCGGAA.TGCCTTCAG
TGATCTCGG.AAGTACAGA	TGATCTCGG.AAGTACAGA
TGATCTCGG.CCTGTTAGC	TGATCTCGG.CCTGTTAGC
TGATCTCGG.CGTTCCATT	TGATCTCGG.CGTTCCATT
TGATCTCGG.TCAGGACTG	TGATCTCGG.TCAGGACTG
TGATGACAG.CATTCAGTT	TGATGACAG.CATTCAGTT
TGATGACAG.CGCCATTAC	TGATGACAG.CGCCATTAC
TGATGACAG.GAACGCTGT	TGATGACAG.GAACGCTGT
TGATGACAG.GCACCATCG	TGATGACAG.GCACCATCG
TGATGACAG.TATTGCTAC	TGATGACAG.TATTGCTAC
TGATGGACA.AACGATGAC	TGATGGACA.AACGATGAC
TGATGGACA.ACTCCTGAG	TGATGGACA.ACTCCTGAG
TGATGGACA.AGCTGCACT	TGATGGACA.AGCTGCACT
TGATGGACA.AGTGGAATG	TGATGGACA.AGTGGAATG
TGATGGACA.CCGGATTGC	TGATGGACA.CCGGATTGC
TGATGGACA.GATGCGACG	TGATGGACA.GATGCGACG
TGATGGACA.GTAGGACGC	TGATGGACA.GTAGGACGC
TGATGGACA.TAGGAGCTA	TGATGGACA.TAGGAGCTA
TGATGGACA.TCACTACGT	TGATGGACA.TCACTACGT
TGATGGACA.TTGTATCAC	TGATGGACA.TTGTATCAC
TGATGTGTG.AGCTTGGTG	TGATGTGTG.AGCTTGGTG
TGATGTGTG.CACCTAGCG	TGATGTGTG.CACCTAGCG
TGATGTGTG.CAGGTTGTC	TGATGTGTG.CAGGTTGTC
TGATGTGTG.CATGGTTAC	TGATGTGTG.CATGGTTAC
TGATGTGTG.GAAGAGCAC	TGATGTGTG.GAAGAGCAC
TGATGTGTG.GCGGTAGTC	TGATGTGTG.GCGGTAGTC
TGATGTGTG.TACCGCGTT	TGATGTGTG.TACCGCGTT
TGATGTGTG.TCAGAGCGT	TGATGTGTG.TCAGAGCGT
TGATGTGTG.TGAGAGGAC	TGATGTGTG.TGAGAGGAC
TGATTATCG.AAGTTGCCA	TGATTATCG.AAGTTGCCA
TGATTATCG.ACTCCGGTT	TGATTATCG.ACTCCGGTT
TGATTATCG.AGCAGACAA	TGATTATCG.AGCAGACAA
TGATTATCG.GATTCCTCT	TGATTATCG.GATTCCTCT
TGATTATCG.GCCGAGTCT	TGATTATCG.GCCGAGTCT
TGATTATCG.TTATGAGGA	TGATTATCG.TTATGAGGA
TGATTCACC.ACGGACCAT	TGATTCACC.ACGGACCAT
TGATTCACC.GATGCTCCT	TGATTCACC.GATGCTCCT
TGATTCACC.TACAGTTAG	TGATTCACC.TACAGTTAG
TGATTGCTG.AGACGCCTG	TGATTGCTG.AGACGCCTG
TGATTGCTG.CATAATTGG	TGATTGCTG.CATAATTGG
TGATTGCTG.CTGACGATG	TGATTGCTG.CTGACGATG
TGATTGCTG.CTGTGGTGG	TGATTGCTG.CTGTGGTGG
TGATTGCTG.TAAGGTCCG	TGATTGCTG.TAAGGTCCG
TGATTGTGC.ACTGTAATC	TGATTGTGC.ACTGTAATC
TGATTGTGC.CGTCAGCAC	TGATTGTGC.CGTCAGCAC
TGATTGTGC.TCAGGACTG	TGATTGTGC.TCAGGACTG
TGCAACTCT.GTCGAGTAC	TGCAACTCT.GTCGAGTAC
TGCAACTCT.TAACACGAG	TGCAACTCT.TAACACGAG
TGCAACTCT.TACCTCACT	TGCAACTCT.TACCTCACT
TGCAACTCT.TGTGAGTAT	TGCAACTCT.TGTGAGTAT
TGCACGATG.AACCGTGAG	TGCACGATG.AACCGTGAG
TGCACGATG.GAACTGCAA	TGCACGATG.GAACTGCAA
TGCAGATGC.AGATATGGA	TGCAGATGC.AGATATGGA
TGCAGATGC.ATTAAGACC	TGCAGATGC.ATTAAGACC
TGCAGATGC.CCTCGGTCA	TGCAGATGC.CCTCGGTCA
TGCAGATGC.GACAATGTT	TGCAGATGC.GACAATGTT
TGCAGATGC.GCCGTTGTT	TGCAGATGC.GCCGTTGTT
TGCAGATGC.TACGGTCGT	TGCAGATGC.TACGGTCGT
TGCAGCCTT.AGTAATCAG	TGCAGCCTT.AGTAATCAG
TGCAGCCTT.ATTGACACG	TGCAGCCTT.ATTGACACG
TGCAGCCTT.CACATGTGC	TGCAGCCTT.CACATGTGC
TGCAGCCTT.CCGATACCG	TGCAGCCTT.CCGATACCG
TGCAGCCTT.CTGTGGTGG	TGCAGCCTT.CTGTGGTGG
TGCAGCCTT.GATTAGACA	TGCAGCCTT.GATTAGACA
TGCAGCCTT.GTGTCTGGA	TGCAGCCTT.GTGTCTGGA
TGCAGTCGG.AGACGCTAT	TGCAGTCGG.AGACGCTAT
TGCAGTCGG.CATATGCGA	TGCAGTCGG.CATATGCGA
TGCAGTCGG.CCACAAGGT	TGCAGTCGG.CCACAAGGT
TGCAGTCGG.GGACTATTC	TGCAGTCGG.GGACTATTC
TGCAGTCGG.GTACGCGAT	TGCAGTCGG.GTACGCGAT
TGCAGTCGG.TGTGTCTAC	TGCAGTCGG.TGTGTCTAC
TGCAGTTCA.AGAGGACGT	TGCAGTTCA.AGAGGACGT
TGCAGTTCA.CACCTAGCG	TGCAGTTCA.CACCTAGCG
TGCAGTTCA.CCACGCCAT	TGCAGTTCA.CCACGCCAT
TGCAGTTCA.CCGTCCACT	TGCAGTTCA.CCGTCCACT
TGCAGTTCA.GCGTGAGCT	TGCAGTTCA.GCGTGAGCT
TGCAGTTCA.GTAGCTACA	TGCAGTTCA.GTAGCTACA
TGCATACAT.CAGCTGGAG	TGCATACAT.CAGCTGGAG
TGCATACAT.CGTTACACC	TGCATACAT.CGTTACACC
TGCATACAT.GATCTGTTC	TGCATACAT.GATCTGTTC
TGCATACAT.TCGTAATAG	TGCATACAT.TCGTAATAG
TGCATCGGA.AGGTCCGTC	TGCATCGGA.AGGTCCGTC
TGCATCGGA.GCGACACAG	TGCATCGGA.GCGACACAG
TGCATCGGA.GGATAATAC	TGCATCGGA.GGATAATAC
TGCATCGGA.TACCTCCTC	TGCATCGGA.TACCTCCTC
TGCCAATGG.AATCCTCGT	TGCCAATGG.AATCCTCGT
TGCCAATGG.ACCGATCGA	TGCCAATGG.ACCGATCGA
TGCCAATGG.CAACGATCG	TGCCAATGG.CAACGATCG
TGCCAATGG.CAGCTTACC	TGCCAATGG.CAGCTTACC
TGCCAATGG.CGATTCGAG	TGCCAATGG.CGATTCGAG
TGCCAATGG.GATGTTACA	TGCCAATGG.GATGTTACA
TGCCAATGG.TAACACGAG	TGCCAATGG.TAACACGAG
TGCCAATGG.TAGCACACG	TGCCAATGG.TAGCACACG
TGCCAATGG.TGGAAGATT	TGCCAATGG.TGGAAGATT
TGCCACCGA.AATATCGCT	TGCCACCGA.AATATCGCT
TGCCACCGA.CACTGCTTA	TGCCACCGA.CACTGCTTA
TGCCACCGA.CCTATTCAA	TGCCACCGA.CCTATTCAA
TGCCACCGA.TGTGGTCCT	TGCCACCGA.TGTGGTCCT
TGCCACCGA.TTGATCGTA	TGCCACCGA.TTGATCGTA
TGCCAGACG.CTGAGTAGC	TGCCAGACG.CTGAGTAGC
TGCCAGACG.GACAGGTTA	TGCCAGACG.GACAGGTTA
TGCCAGACG.GCGAAGCTC	TGCCAGACG.GCGAAGCTC
TGCCAGACG.GTAGCTACA	TGCCAGACG.GTAGCTACA
TGCCAGACG.TCAAGGTCG	TGCCAGACG.TCAAGGTCG
TGCCATCTC.AGATGTTGG	TGCCATCTC.AGATGTTGG
TGCCATCTC.AGGTACCAA	TGCCATCTC.AGGTACCAA
TGCCATCTC.GTTAGATTG	TGCCATCTC.GTTAGATTG
TGCCGAACT.ACTTCTAAC	TGCCGAACT.ACTTCTAAC
TGCCGAACT.GGATACCTA	TGCCGAACT.GGATACCTA
TGCCGAACT.TCCACCGGT	TGCCGAACT.TCCACCGGT
TGCCGACTA.AATCGCCAT	TGCCGACTA.AATCGCCAT
TGCCGACTA.AGATGTTGG	TGCCGACTA.AGATGTTGG
TGCCGACTA.AGGATCATG	TGCCGACTA.AGGATCATG
TGCCGACTA.AGTCGTCCG	TGCCGACTA.AGTCGTCCG
TGCCGACTA.CAACGATCG	TGCCGACTA.CAACGATCG
TGCCGACTA.CGTGGTACC	TGCCGACTA.CGTGGTACC
TGCCGACTA.CTCGACTGC	TGCCGACTA.CTCGACTGC
TGCCGACTA.GAACCAGTT	TGCCGACTA.GAACCAGTT
TGCCGACTA.GGTTCAGAC	TGCCGACTA.GGTTCAGAC
TGCCGACTA.GTAATATCG	TGCCGACTA.GTAATATCG
TGCCGACTA.TAACCGTGA	TGCCGACTA.TAACCGTGA
TGCCGCTAC.GATCTGAAT	TGCCGCTAC.GATCTGAAT
TGCCGCTAC.GTCATTCTA	TGCCGCTAC.GTCATTCTA
TGCCGCTAC.TGGAACTAA	TGCCGCTAC.TGGAACTAA
TGCCTGGTT.CGTGACCAG	TGCCTGGTT.CGTGACCAG
TGCCTGGTT.CTCAGCTGG	TGCCTGGTT.CTCAGCTGG
TGCCTGGTT.GAATCGAGA	TGCCTGGTT.GAATCGAGA
TGCCTGGTT.GAGCTCTCA	TGCCTGGTT.GAGCTCTCA
TGCCTGGTT.GGACTATTC	TGCCTGGTT.GGACTATTC
TGCCTGGTT.TCGTCCGAT	TGCCTGGTT.TCGTCCGAT
TGCCTTCAG.ATAGACCGA	TGCCTTCAG.ATAGACCGA
TGCCTTCAG.CGTGTATTC	TGCCTTCAG.CGTGTATTC
TGCGACGTT.GCGTTCAGA	TGCGACGTT.GCGTTCAGA
TGCGATACT.CACTCACTA	TGCGATACT.CACTCACTA
TGCGATACT.CAGGAGCCT	TGCGATACT.CAGGAGCCT
TGCGATACT.CCGAGTACT	TGCGATACT.CCGAGTACT
TGCGATACT.GAGTTATAG	TGCGATACT.GAGTTATAG
TGCGATACT.TGTGTAGAG	TGCGATACT.TGTGTAGAG
TGCGCACTG.CCGTTCCAA	TGCGCACTG.CCGTTCCAA
TGCGCACTG.CTGCGATTC	TGCGCACTG.CTGCGATTC
TGCGCACTG.TGCAGATGC	TGCGCACTG.TGCAGATGC
TGCGCTGCA.AATGCCTCA	TGCGCTGCA.AATGCCTCA
TGCGCTGCA.ATGCTCACC	TGCGCTGCA.ATGCTCACC
TGCGCTGCA.CAGCGTAAG	TGCGCTGCA.CAGCGTAAG
TGCGCTGCA.CGTCAGCAC	TGCGCTGCA.CGTCAGCAC
TGCGCTGCA.GCAACTCGC	TGCGCTGCA.GCAACTCGC
TGCGCTGCA.GGTAACTAC	TGCGCTGCA.GGTAACTAC
TGCGTAATC.AACAGCAGT	TGCGTAATC.AACAGCAGT
TGCGTAATC.AACGGAGAT	TGCGTAATC.AACGGAGAT
TGCGTAATC.AGTCCGTGT	TGCGTAATC.AGTCCGTGT
TGCGTAATC.CCTTGTTGC	TGCGTAATC.CCTTGTTGC
TGCGTAATC.CTAGTCGTC	TGCGTAATC.CTAGTCGTC
TGCGTAATC.CTCATTAGT	TGCGTAATC.CTCATTAGT
TGCGTAATC.GCTACCTTA	TGCGTAATC.GCTACCTTA
TGCGTAATC.TAGGTTAGT	TGCGTAATC.TAGGTTAGT
TGCGTATCT.GGAGAATGA	TGCGTATCT.GGAGAATGA
TGCGTATCT.TACAGTTAG	TGCGTATCT.TACAGTTAG
TGCGTATCT.TGGAATCGT	TGCGTATCT.TGGAATCGT
TGCGTATCT.TTAACGGAG	TGCGTATCT.TTAACGGAG
TGCGTCTTA.CAATGCATT	TGCGTCTTA.CAATGCATT
TGCGTCTTA.CAATTGTCT	TGCGTCTTA.CAATTGTCT
TGCGTCTTA.CCAGCCAAT	TGCGTCTTA.CCAGCCAAT
TGCGTCTTA.CGTACACAC	TGCGTCTTA.CGTACACAC
TGCGTCTTA.GACTCAGTG	TGCGTCTTA.GACTCAGTG
TGCGTCTTA.GATTAGTGT	TGCGTCTTA.GATTAGTGT
TGCGTGCCA.ACATTGACA	TGCGTGCCA.ACATTGACA
TGCGTGCCA.AGCACCGTG	TGCGTGCCA.AGCACCGTG
TGCGTGCCA.ATAGTCAGT	TGCGTGCCA.ATAGTCAGT
TGCGTGCCA.CCTCGACCT	TGCGTGCCA.CCTCGACCT
TGCGTGCCA.CCTGCTCCA	TGCGTGCCA.CCTGCTCCA
TGCGTGCCA.GCGTCGTCT	TGCGTGCCA.GCGTCGTCT
TGCTATGAA.AACGAGAAT	TGCTATGAA.AACGAGAAT
TGCTATGAA.AAGCAACTA	TGCTATGAA.AAGCAACTA
TGCTATGAA.ATCTACATC	TGCTATGAA.ATCTACATC
TGCTATGAA.CATTATGTC	TGCTATGAA.CATTATGTC
TGCTCACAC.CATACGCAG	TGCTCACAC.CATACGCAG
TGCTCACAC.CTGAGTCCA	TGCTCACAC.CTGAGTCCA
TGCTCACAC.GACGCCGTA	TGCTCACAC.GACGCCGTA
TGCTCAGCG.AGCTATATG	TGCTCAGCG.AGCTATATG
TGCTCAGCG.ATCAAGCAT	TGCTCAGCG.ATCAAGCAT
TGCTCAGCG.CCGGTGGTT	TGCTCAGCG.CCGGTGGTT
TGCTCAGCG.GATGCGGTT	TGCTCAGCG.GATGCGGTT
TGCTCAGCG.GCAGCAGTG	TGCTCAGCG.GCAGCAGTG
TGCTCAGCG.TCAGCTCAG	TGCTCAGCG.TCAGCTCAG
TGCTCCTCC.AGACCACGC	TGCTCCTCC.AGACCACGC
TGCTCCTCC.ATGGACGTT	TGCTCCTCC.ATGGACGTT
TGCTCCTCC.CGTCTGCTG	TGCTCCTCC.CGTCTGCTG
TGCTCCTCC.CTGTTACCA	TGCTCCTCC.CTGTTACCA
TGCTCCTCC.GACGTAGCA	TGCTCCTCC.GACGTAGCA
TGCTCCTCC.GCTGAGCAG	TGCTCCTCC.GCTGAGCAG
TGCTCCTCC.TGACAAGTT	TGCTCCTCC.TGACAAGTT
TGCTCCTCC.TGCATACAT	TGCTCCTCC.TGCATACAT
TGCTGCGTC.ACAAGAATG	TGCTGCGTC.ACAAGAATG
TGCTGCGTC.AGACTAGTA	TGCTGCGTC.AGACTAGTA
TGCTGCGTC.CCACAAGGT	TGCTGCGTC.CCACAAGGT
TGCTGCGTC.GACTTCACC	TGCTGCGTC.GACTTCACC
TGCTGCGTC.GATTCTCGG	TGCTGCGTC.GATTCTCGG
TGCTTACGG.ACGCACACT	TGCTTACGG.ACGCACACT
TGCTTACGG.CAATCATAC	TGCTTACGG.CAATCATAC
TGCTTACGG.CGTGCCTAT	TGCTTACGG.CGTGCCTAT
TGCTTACGG.CTATGGATG	TGCTTACGG.CTATGGATG
TGCTTACGG.GAACTGCAA	TGCTTACGG.GAACTGCAA
TGGAACTAA.CGCCACCAT	TGGAACTAA.CGCCACCAT
TGGAACTAA.CTCATGCCA	TGGAACTAA.CTCATGCCA
TGGAACTAA.CTCTAGTAA	TGGAACTAA.CTCTAGTAA
TGGAACTAA.GAAGGATCA	TGGAACTAA.GAAGGATCA
TGGAACTAA.TGTAGCAAG	TGGAACTAA.TGTAGCAAG
TGGAACTAA.TGTGCAGTA	TGGAACTAA.TGTGCAGTA
TGGAACTAA.TGTTAAGCC	TGGAACTAA.TGTTAAGCC
TGGAAGATT.ATGCCTGTC	TGGAAGATT.ATGCCTGTC
TGGAAGATT.CACCTAGCG	TGGAAGATT.CACCTAGCG
TGGAAGATT.CACTTGGAT	TGGAAGATT.CACTTGGAT
TGGAAGATT.GACCAACAG	TGGAAGATT.GACCAACAG
TGGAAGATT.GAGTCACCA	TGGAAGATT.GAGTCACCA
TGGAAGATT.GGTAGCATC	TGGAAGATT.GGTAGCATC
TGGAAGATT.GTCGCAGGT	TGGAAGATT.GTCGCAGGT
TGGAAGATT.TACCTCACT	TGGAAGATT.TACCTCACT
TGGAATCGT.AGCACCGTG	TGGAATCGT.AGCACCGTG
TGGAATCGT.AGGTACCAA	TGGAATCGT.AGGTACCAA
TGGAATCGT.CCACGAAGG	TGGAATCGT.CCACGAAGG
TGGAATCGT.TAGCACACG	TGGAATCGT.TAGCACACG
TGGACGAGA.ACCGACGGT	TGGACGAGA.ACCGACGGT
TGGACGAGA.ATCGATCCT	TGGACGAGA.ATCGATCCT
TGGACGAGA.CCGCATCCT	TGGACGAGA.CCGCATCCT
TGGACGAGA.CCTCTTGTA	TGGACGAGA.CCTCTTGTA
TGGACGAGA.CGAAGAGGT	TGGACGAGA.CGAAGAGGT
TGGACGAGA.GATATGGAC	TGGACGAGA.GATATGGAC
TGGACTGCC.ACCATTCAC	TGGACTGCC.ACCATTCAC
TGGACTGCC.AGCCGGATC	TGGACTGCC.AGCCGGATC
TGGACTGCC.CCACTTCGC	TGGACTGCC.CCACTTCGC
TGGACTGCC.GCTAGTGGA	TGGACTGCC.GCTAGTGGA
TGGAGAACC.CATAAGATC	TGGAGAACC.CATAAGATC
TGGAGAACC.TCGATTCAG	TGGAGAACC.TCGATTCAG
TGGAGAGTG.CACAACCAG	TGGAGAGTG.CACAACCAG
TGGAGAGTG.CGCAGTGTC	TGGAGAGTG.CGCAGTGTC
TGGAGAGTG.CGTTCGTAC	TGGAGAGTG.CGTTCGTAC
TGGAGAGTG.CTTCCGGTA	TGGAGAGTG.CTTCCGGTA
TGGAGTGGA.AGTCGTCCG	TGGAGTGGA.AGTCGTCCG
TGGAGTGGA.CACAACCAG	TGGAGTGGA.CACAACCAG
TGGAGTGGA.CTAGAGTCG	TGGAGTGGA.CTAGAGTCG
TGGAGTGGA.GGACTATTC	TGGAGTGGA.GGACTATTC
TGGAGTGGA.GTGTCCGTG	TGGAGTGGA.GTGTCCGTG
TGGAGTGGA.TGAACCAAT	TGGAGTGGA.TGAACCAAT
TGGAGTGGA.TGAGACAGC	TGGAGTGGA.TGAGACAGC
TGGATAGGT.AATACGTCT	TGGATAGGT.AATACGTCT
TGGATAGGT.ATAAGACAG	TGGATAGGT.ATAAGACAG
TGGATAGGT.CCTTCCTCA	TGGATAGGT.CCTTCCTCA
TGGATAGGT.GACCGGTAG	TGGATAGGT.GACCGGTAG
TGGATAGGT.GCATACTCC	TGGATAGGT.GCATACTCC
TGGATAGGT.GCCACATGG	TGGATAGGT.GCCACATGG
TGGATAGGT.TACAGTTAG	TGGATAGGT.TACAGTTAG
TGGATTAGC.ACTGGTGCT	TGGATTAGC.ACTGGTGCT
TGGATTAGC.CCATATCTT	TGGATTAGC.CCATATCTT
TGGATTAGC.CGTCTGTCC	TGGATTAGC.CGTCTGTCC
TGGATTAGC.GATCTGTTC	TGGATTAGC.GATCTGTTC
TGGATTAGC.GCTGGTAAC	TGGATTAGC.GCTGGTAAC
TGGATTAGC.GGTGTTCAT	TGGATTAGC.GGTGTTCAT
TGGATTAGC.GTCCTAGTT	TGGATTAGC.GTCCTAGTT
TGGATTAGC.TCAATGGAC	TGGATTAGC.TCAATGGAC
TGGATTAGC.TTGCAGTCA	TGGATTAGC.TTGCAGTCA
TGGTAACCA.ATTCTCTGG	TGGTAACCA.ATTCTCTGG
TGGTAACCA.CAAGAGAGT	TGGTAACCA.CAAGAGAGT
TGGTAACCA.CTAGGTACT	TGGTAACCA.CTAGGTACT
TGGTAACCA.GATATGGAC	TGGTAACCA.GATATGGAC
TGGTAACCA.GCCGCCTAA	TGGTAACCA.GCCGCCTAA
TGGTAGCAG.AACGGTAGC	TGGTAGCAG.AACGGTAGC
TGGTAGCAG.AGCCGGATC	TGGTAGCAG.AGCCGGATC
TGGTAGCAG.GCCTTATCT	TGGTAGCAG.GCCTTATCT
TGGTAGCAG.GCTACCGAG	TGGTAGCAG.GCTACCGAG
TGGTAGCAG.GGTCGGATA	TGGTAGCAG.GGTCGGATA
TGGTCCTAG.ACGCACACT	TGGTCCTAG.ACGCACACT
TGGTCCTAG.CCGTCAGGT	TGGTCCTAG.CCGTCAGGT
TGGTCCTAG.GAGACATTG	TGGTCCTAG.GAGACATTG
TGGTCCTAG.GTCTACCAA	TGGTCCTAG.GTCTACCAA
TGGTCCTAG.TCACACTGC	TGGTCCTAG.TCACACTGC
TGGTCCTAG.TCACGCGAC	TGGTCCTAG.TCACGCGAC
TGGTCGCTA.CAAGCCTCG	TGGTCGCTA.CAAGCCTCG
TGGTCGCTA.CCGGATTGC	TGGTCGCTA.CCGGATTGC
TGGTCGCTA.CCGTAGTTG	TGGTCGCTA.CCGTAGTTG
TGGTCGCTA.GCTGTTCGG	TGGTCGCTA.GCTGTTCGG
TGGTCTACG.AATCGCCAT	TGGTCTACG.AATCGCCAT
TGGTCTACG.AGGTCACGT	TGGTCTACG.AGGTCACGT
TGGTCTACG.CTACGGTAT	TGGTCTACG.CTACGGTAT
TGGTCTACG.GTGGTTACC	TGGTCTACG.GTGGTTACC
TGGTGCCTG.ATGCCTTCA	TGGTGCCTG.ATGCCTTCA
TGGTGCCTG.GAGTCAAGG	TGGTGCCTG.GAGTCAAGG
TGGTGCCTG.TTCGCATCC	TGGTGCCTG.TTCGCATCC
TGGTGGATC.AAGACTGGT	TGGTGGATC.AAGACTGGT
TGGTGGATC.ATAATGTGG	TGGTGGATC.ATAATGTGG
TGGTGGATC.CAGGAGCCT	TGGTGGATC.CAGGAGCCT
TGGTGGATC.CGCCTGCAA	TGGTGGATC.CGCCTGCAA
TGGTGGATC.GCTACAATG	TGGTGGATC.GCTACAATG
TGGTGGATC.GTTGCTCAG	TGGTGGATC.GTTGCTCAG
TGGTGGATC.TAACCGTGA	TGGTGGATC.TAACCGTGA
TGGTGGATC.TGAGATCAT	TGGTGGATC.TGAGATCAT
TGGTGGTAA.GAATCGAGA	TGGTGGTAA.GAATCGAGA
TGGTGGTAA.TGAGAATCC	TGGTGGTAA.TGAGAATCC
TGGTTATAC.AGATGAAGA	TGGTTATAC.AGATGAAGA
TGGTTATAC.AGCTACTCA	TGGTTATAC.AGCTACTCA
TGGTTATAC.AGGAATTGG	TGGTTATAC.AGGAATTGG
TGGTTATAC.ATCGAATCG	TGGTTATAC.ATCGAATCG
TGGTTATAC.ATGCTTCAG	TGGTTATAC.ATGCTTCAG
TGGTTATAC.CAGTAATGT	TGGTTATAC.CAGTAATGT
TGGTTATAC.CTGTGGTGG	TGGTTATAC.CTGTGGTGG
TGGTTATAC.GATATGGAC	TGGTTATAC.GATATGGAC
TGGTTATAC.GCCTTATCT	TGGTTATAC.GCCTTATCT
TGGTTATAC.GTACGCGAT	TGGTTATAC.GTACGCGAT
TGGTTATAC.TACGTTACC	TGGTTATAC.TACGTTACC
TGGTTATAC.TACTACTGT	TGGTTATAC.TACTACTGT
TGGTTATAC.TGTGCTAAC	TGGTTATAC.TGTGCTAAC
TGTAACAGT.ACTATTGTC	TGTAACAGT.ACTATTGTC
TGTAACAGT.AGTGAACGG	TGTAACAGT.AGTGAACGG
TGTAACAGT.AGTTAGGTC	TGTAACAGT.AGTTAGGTC
TGTAACAGT.TACAGTTAG	TGTAACAGT.TACAGTTAG
TGTACACGA.GCCTGCATC	TGTACACGA.GCCTGCATC
TGTACACGA.GGAATTCAC	TGTACACGA.GGAATTCAC
TGTACACGA.GTAAGGTCC	TGTACACGA.GTAAGGTCC
TGTACACGA.GTGCGAGTA	TGTACACGA.GTGCGAGTA
TGTACACGA.GTTGCTCAG	TGTACACGA.GTTGCTCAG
TGTACACGA.TAGCGAGAA	TGTACACGA.TAGCGAGAA
TGTAGATCG.CATTGACAA	TGTAGATCG.CATTGACAA
TGTAGATCG.GAATTGTTG	TGTAGATCG.GAATTGTTG
TGTAGATCG.GGATACAAT	TGTAGATCG.GGATACAAT
TGTAGATCG.TGTCATAGC	TGTAGATCG.TGTCATAGC
TGTAGATCG.TTAACGGAG	TGTAGATCG.TTAACGGAG
TGTAGCAAG.AGGTATTCC	TGTAGCAAG.AGGTATTCC
TGTAGCAAG.AGTAACGTA	TGTAGCAAG.AGTAACGTA
TGTAGCAAG.CATCGCTGG	TGTAGCAAG.CATCGCTGG
TGTAGCAAG.CCTTCCTCA	TGTAGCAAG.CCTTCCTCA
TGTAGCAAG.CTAGGTACT	TGTAGCAAG.CTAGGTACT
TGTAGCAAG.GACCTTGTG	TGTAGCAAG.GACCTTGTG
TGTAGCAAG.GCCGAGTCT	TGTAGCAAG.GCCGAGTCT
TGTAGGTTA.ACAGTATTG	TGTAGGTTA.ACAGTATTG
TGTAGGTTA.TATGCCTTC	TGTAGGTTA.TATGCCTTC
TGTATCGTG.ATTGACACG	TGTATCGTG.ATTGACACG
TGTATCGTG.CTCATGCCA	TGTATCGTG.CTCATGCCA
TGTATCGTG.CTCCAGCGT	TGTATCGTG.CTCCAGCGT
TGTATCGTG.GACCGTAGT	TGTATCGTG.GACCGTAGT
TGTATCGTG.GATCGCACT	TGTATCGTG.GATCGCACT
TGTATCGTG.GTACAATGC	TGTATCGTG.GTACAATGC
TGTATCGTG.TCGCAAGCA	TGTATCGTG.TCGCAAGCA
TGTATCGTG.TGGAATCGT	TGTATCGTG.TGGAATCGT
TGTATCGTG.TTACTTACG	TGTATCGTG.TTACTTACG
TGTATGTAG.ACACGTTGC	TGTATGTAG.ACACGTTGC
TGTATGTAG.CTGTCACTT	TGTATGTAG.CTGTCACTT
TGTCAACCT.ACCGAGTAG	TGTCAACCT.ACCGAGTAG
TGTCAACCT.ATTCGAAGA	TGTCAACCT.ATTCGAAGA
TGTCAACCT.CCTAGTTAG	TGTCAACCT.CCTAGTTAG
TGTCAACCT.GATGTCTAG	TGTCAACCT.GATGTCTAG
TGTCAACCT.GATGTTACA	TGTCAACCT.GATGTTACA
TGTCAACCT.GCCATACAA	TGTCAACCT.GCCATACAA
TGTCAACCT.GCGCTTCTC	TGTCAACCT.GCGCTTCTC
TGTCAACCT.GTAGCATAC	TGTCAACCT.GTAGCATAC
TGTCAACCT.TAGTTGACG	TGTCAACCT.TAGTTGACG
TGTCAACCT.TGGTCCTAG	TGTCAACCT.TGGTCCTAG
TGTCACATA.AGCGCATGA	TGTCACATA.AGCGCATGA
TGTCACATA.CACAACCAG	TGTCACATA.CACAACCAG
TGTCACATA.GCTGATGTC	TGTCACATA.GCTGATGTC
TGTCATAGC.AACAATGCA	TGTCATAGC.AACAATGCA
TGTCATAGC.CTTCTGAGT	TGTCATAGC.CTTCTGAGT
TGTCATAGC.TAAGTACAC	TGTCATAGC.TAAGTACAC
TGTCATAGC.TACTTACCA	TGTCATAGC.TACTTACCA
TGTCATAGC.TGTATCGTG	TGTCATAGC.TGTATCGTG
TGTCCATAG.ACAGAAGAG	TGTCCATAG.ACAGAAGAG
TGTCCATAG.AGGTCAGCA	TGTCCATAG.AGGTCAGCA
TGTCCATAG.CCATAGCCA	TGTCCATAG.CCATAGCCA
TGTCCATAG.GCGGTAAGT	TGTCCATAG.GCGGTAAGT
TGTCCATAG.TGGTCTACG	TGTCCATAG.TGGTCTACG
TGTCGTACA.ACGCAAGAT	TGTCGTACA.ACGCAAGAT
TGTCGTACA.CCTGCTCCA	TGTCGTACA.CCTGCTCCA
TGTCGTACA.GTACGAACG	TGTCGTACA.GTACGAACG
TGTCGTACA.GTATGTATC	TGTCGTACA.GTATGTATC
TGTCGTACA.GTCGTTAGA	TGTCGTACA.GTCGTTAGA
TGTCGTACA.TAAGCACTA	TGTCGTACA.TAAGCACTA
TGTCGTACA.TCGCATTCG	TGTCGTACA.TCGCATTCG
TGTCGTACA.TCGTCATTC	TGTCGTACA.TCGTCATTC
TGTCGTACA.TGAGAGGAC	TGTCGTACA.TGAGAGGAC
TGTCGTGAG.AGCATTCCA	TGTCGTGAG.AGCATTCCA
TGTCGTGAG.ATTCGAAGA	TGTCGTGAG.ATTCGAAGA
TGTCGTGAG.GAGACTCGA	TGTCGTGAG.GAGACTCGA
TGTCGTGAG.TCGGTATCA	TGTCGTGAG.TCGGTATCA
TGTCGTGAG.TTATCGCAC	TGTCGTGAG.TTATCGCAC
TGTCTACAC.ACATCGTCC	TGTCTACAC.ACATCGTCC
TGTCTACAC.CACCAGAAG	TGTCTACAC.CACCAGAAG
TGTCTACAC.CCTCTTGTA	TGTCTACAC.CCTCTTGTA
TGTCTACAC.CGTAATGAC	TGTCTACAC.CGTAATGAC
TGTCTACAC.TCACTACGT	TGTCTACAC.TCACTACGT
TGTGAGTAT.CTCGCAAGA	TGTGAGTAT.CTCGCAAGA
TGTGCAGTA.ACGGTGCCT	TGTGCAGTA.ACGGTGCCT
TGTGCAGTA.GTATGCCTT	TGTGCAGTA.GTATGCCTT
TGTGCAGTA.TTCTGAATG	TGTGCAGTA.TTCTGAATG
TGTGCCATG.CTTAATCGT	TGTGCCATG.CTTAATCGT
TGTGCCATG.GAACTGCAA	TGTGCCATG.GAACTGCAA
TGTGCCATG.TCGATTCAG	TGTGCCATG.TCGATTCAG
