TACAACACC.ACCTAGCAC	TACAACACC.ACCTAGCAC
TACAACACC.AGCGGTAAG	TACAACACC.AGCGGTAAG
TACAACACC.ATAACGACA	TACAACACC.ATAACGACA
TACAACACC.CCGGTTCTA	TACAACACC.CCGGTTCTA
TACAACACC.CGATACTCT	TACAACACC.CGATACTCT
TACAACACC.CGCATAACT	TACAACACC.CGCATAACT
TACAACACC.GAACTATGG	TACAACACC.GAACTATGG
TACAACACC.GCGAGTCTA	TACAACACC.GCGAGTCTA
TACAACACC.GTTGATGCA	TACAACACC.GTTGATGCA
TACAAGAGG.CAGGATCAA	TACAAGAGG.CAGGATCAA
TACAAGAGG.CATTCCGAG	TACAAGAGG.CATTCCGAG
TACAAGAGG.CGCATCTAC	TACAAGAGG.CGCATCTAC
TACAAGAGG.GCACCATCG	TACAAGAGG.GCACCATCG
TACAAGAGG.TTAGTCGGA	TACAAGAGG.TTAGTCGGA
TACACGGTC.AATTCGGAA	TACACGGTC.AATTCGGAA
TACACGGTC.CTAATACGC	TACACGGTC.CTAATACGC
TACAGGACT.AGCGTCGTC	TACAGGACT.AGCGTCGTC
TACAGGACT.CGACAGGAA	TACAGGACT.CGACAGGAA
TACAGGACT.CTTGCACAA	TACAGGACT.CTTGCACAA
TACAGGACT.TAAGTACAC	TACAGGACT.TAAGTACAC
TACAGGACT.TGAGATCAT	TACAGGACT.TGAGATCAT
TACAGGACT.TGGTAACCA	TACAGGACT.TGGTAACCA
TACAGTTAG.AACGAGGTG	TACAGTTAG.AACGAGGTG
TACAGTTAG.AACGATGAC	TACAGTTAG.AACGATGAC
TACAGTTAG.CAGTAATGT	TACAGTTAG.CAGTAATGT
TACAGTTAG.GTATTACTG	TACAGTTAG.GTATTACTG
TACATGCAC.ACTCCGTCG	TACATGCAC.ACTCCGTCG
TACATGCAC.CAGCCGCAA	TACATGCAC.CAGCCGCAA
TACATGCAC.CCAGATCAC	TACATGCAC.CCAGATCAC
TACATGCAC.CCAGCCAAT	TACATGCAC.CCAGCCAAT
TACATGCAC.CCTAGTTAG	TACATGCAC.CCTAGTTAG
TACATGCAC.TGTGCAGTA	TACATGCAC.TGTGCAGTA
TACCAGCCA.CCTCTGCAT	TACCAGCCA.CCTCTGCAT
TACCAGCCA.CTCTACGCA	TACCAGCCA.CTCTACGCA
TACCAGCCA.GATTCCTCT	TACCAGCCA.GATTCCTCT
TACCATGTA.AGTCGCCGA	TACCATGTA.AGTCGCCGA
TACCATGTA.CCTAGCAAT	TACCATGTA.CCTAGCAAT
TACCATGTA.CGGACAAGT	TACCATGTA.CGGACAAGT
TACCATGTA.TAACGGATA	TACCATGTA.TAACGGATA
TACCATGTA.TACAAGAGG	TACCATGTA.TACAAGAGG
TACCGATTG.AAGCTGAGG	TACCGATTG.AAGCTGAGG
TACCGATTG.AGGTCACGT	TACCGATTG.AGGTCACGT
TACCGATTG.CATCAATAG	TACCGATTG.CATCAATAG
TACCGATTG.CCAATATAC	TACCGATTG.CCAATATAC
TACCGATTG.GACGTTCAG	TACCGATTG.GACGTTCAG
TACCGATTG.TACATGCAC	TACCGATTG.TACATGCAC
TACCGATTG.TCACCGAGG	TACCGATTG.TCACCGAGG
TACCGATTG.TCAGTGCAA	TACCGATTG.TCAGTGCAA
TACCGCGTT.ACCGTCCTA	TACCGCGTT.ACCGTCCTA
TACCGCGTT.GCACAGTAA	TACCGCGTT.GCACAGTAA
TACCGCGTT.GTGGTACGG	TACCGCGTT.GTGGTACGG
TACCGCGTT.GTTGCTCAG	TACCGCGTT.GTTGCTCAG
TACCGCGTT.TAATCTGGA	TACCGCGTT.TAATCTGGA
TACCTATCC.GGTAGCATC	TACCTATCC.GGTAGCATC
TACCTATCC.TGTGCAGTA	TACCTATCC.TGTGCAGTA
TACCTCACT.ACCATACTT	TACCTCACT.ACCATACTT
TACCTCACT.CCACGCCAT	TACCTCACT.CCACGCCAT
TACCTCACT.CCGGTGGTT	TACCTCACT.CCGGTGGTT
TACCTCACT.CTGATGCAC	TACCTCACT.CTGATGCAC
TACCTCACT.GATAAGCTG	TACCTCACT.GATAAGCTG
TACCTCACT.TAGTAGTCT	TACCTCACT.TAGTAGTCT
TACCTCACT.TGATGTGTG	TACCTCACT.TGATGTGTG
TACCTCCTC.ATCAGTCGA	TACCTCCTC.ATCAGTCGA
TACCTCCTC.CAGCTTCGA	TACCTCCTC.CAGCTTCGA
TACCTCCTC.CGTTAATGG	TACCTCCTC.CGTTAATGG
TACCTCCTC.TCAGTGTTC	TACCTCCTC.TCAGTGTTC
TACGAACTC.AGTAACGTA	TACGAACTC.AGTAACGTA
TACGAACTC.AGTCATACT	TACGAACTC.AGTCATACT
TACGAACTC.ATATGCAGC	TACGAACTC.ATATGCAGC
TACGAACTC.CTAATACGC	TACGAACTC.CTAATACGC
TACGAACTC.GCATTGATC	TACGAACTC.GCATTGATC
TACGAACTC.GGTACTTCC	TACGAACTC.GGTACTTCC
TACGAACTC.TATGACCGA	TACGAACTC.TATGACCGA
TACGACCAT.ACGCGACAG	TACGACCAT.ACGCGACAG
TACGACCAT.ACGTATGTC	TACGACCAT.ACGTATGTC
TACGACCAT.AGGAAGGTG	TACGACCAT.AGGAAGGTG
TACGACCAT.ATCTCTGCT	TACGACCAT.ATCTCTGCT
TACGACCAT.CACGGATAG	TACGACCAT.CACGGATAG
TACGACCAT.CCAAGTCGA	TACGACCAT.CCAAGTCGA
TACGACCAT.CCTCATAAC	TACGACCAT.CCTCATAAC
TACGACCAT.CCTCTGCAT	TACGACCAT.CCTCTGCAT
TACGACCAT.CCTTCGAGC	TACGACCAT.CCTTCGAGC
TACGACCAT.GACTGCCTG	TACGACCAT.GACTGCCTG
TACGACCAT.TAGCTGTTG	TACGACCAT.TAGCTGTTG
TACGACCAT.TAGTCAGAC	TACGACCAT.TAGTCAGAC
TACGACCAT.TATAGTGCG	TACGACCAT.TATAGTGCG
TACGACCAT.TATGAAGAC	TACGACCAT.TATGAAGAC
TACGACCAT.TTACGCTCG	TACGACCAT.TTACGCTCG
TACGACTTG.AACAGCAGT	TACGACTTG.AACAGCAGT
TACGACTTG.AGCTATATG	TACGACTTG.AGCTATATG
TACGACTTG.CGTACACAC	TACGACTTG.CGTACACAC
TACGACTTG.TCCAATCAT	TACGACTTG.TCCAATCAT
TACGACTTG.TGACGATGA	TACGACTTG.TGACGATGA
TACGAGTGA.CAGCTGGAG	TACGAGTGA.CAGCTGGAG
TACGAGTGA.CCTCGCGTT	TACGAGTGA.CCTCGCGTT
TACGAGTGA.CTAGGTACT	TACGAGTGA.CTAGGTACT
TACGAGTGA.CTGATCAAG	TACGAGTGA.CTGATCAAG
TACGAGTGA.CTTCGACTG	TACGAGTGA.CTTCGACTG
TACGAGTGA.GTTCAGAAG	TACGAGTGA.GTTCAGAAG
TACGAGTGA.TACCTATCC	TACGAGTGA.TACCTATCC
TACGGTCGT.ACACCGCCA	TACGGTCGT.ACACCGCCA
TACGGTCGT.ACGTACTGC	TACGGTCGT.ACGTACTGC
TACGGTCGT.AGATATGGA	TACGGTCGT.AGATATGGA
TACGGTCGT.CCTCGGTCA	TACGGTCGT.CCTCGGTCA
TACGGTCGT.TCGTAATAG	TACGGTCGT.TCGTAATAG
TACGGTCGT.TTCCAGATT	TACGGTCGT.TTCCAGATT
TACGTTACC.GGAATTCAC	TACGTTACC.GGAATTCAC
TACGTTACC.GTTGCATGG	TACGTTACC.GTTGCATGG
TACGTTACC.TGCCAATGG	TACGTTACC.TGCCAATGG
TACGTTGGA.ACTCCGGTT	TACGTTGGA.ACTCCGGTT
TACGTTGGA.ATGCGCCGT	TACGTTGGA.ATGCGCCGT
TACGTTGGA.CTATCTTGA	TACGTTGGA.CTATCTTGA
TACGTTGGA.GCTCTCCAA	TACGTTGGA.GCTCTCCAA
TACGTTGGA.GTAAGTGAG	TACGTTGGA.GTAAGTGAG
TACGTTGGA.TATACCACT	TACGTTGGA.TATACCACT
TACGTTGGA.TCATGCAGG	TACGTTGGA.TCATGCAGG
TACGTTGGA.TGTGAGTAT	TACGTTGGA.TGTGAGTAT
TACTACTGT.AAGCCAAGT	TACTACTGT.AAGCCAAGT
TACTACTGT.ATCCGTCTC	TACTACTGT.ATCCGTCTC
TACTACTGT.CTAACACTG	TACTACTGT.CTAACACTG
TACTAGTAG.ACGTCTATG	TACTAGTAG.ACGTCTATG
TACTAGTAG.CTTAATCGT	TACTAGTAG.CTTAATCGT
TACTAGTAG.GCAATCACG	TACTAGTAG.GCAATCACG
TACTAGTAG.GTCAACTGA	TACTAGTAG.GTCAACTGA
TACTAGTAG.TGTCGTGAG	TACTAGTAG.TGTCGTGAG
TACTCGACC.CTTCCGGTA	TACTCGACC.CTTCCGGTA
TACTCGACC.CTTCCTGAT	TACTCGACC.CTTCCTGAT
TACTCGACC.GAACCAGTT	TACTCGACC.GAACCAGTT
TACTCGACC.GACTTGATT	TACTCGACC.GACTTGATT
TACTCGACC.TCAGCGACC	TACTCGACC.TCAGCGACC
TACTCGACC.TCAGTAAGC	TACTCGACC.TCAGTAAGC
TACTCGACC.TTATGAGGA	TACTCGACC.TTATGAGGA
TACTCGCTG.AATTCGGAA	TACTCGCTG.AATTCGGAA
TACTCGCTG.ATGCCTGTC	TACTCGCTG.ATGCCTGTC
TACTCGCTG.GCCTGGAAT	TACTCGCTG.GCCTGGAAT
TACTCGCTG.TACAAGAGG	TACTCGCTG.TACAAGAGG
TACTCGCTG.TAGCACTAT	TACTCGCTG.TAGCACTAT
TACTGATGA.GGACTCCTT	TACTGATGA.GGACTCCTT
TACTGATGA.TACCTCCTC	TACTGATGA.TACCTCCTC
TACTTACCA.AAGAGAGAG	TACTTACCA.AAGAGAGAG
TACTTACCA.AAGCAATCG	TACTTACCA.AAGCAATCG
TACTTCCAG.GACGCCGTA	TACTTCCAG.GACGCCGTA
TACTTCCAG.GGATTCGTC	TACTTCCAG.GGATTCGTC
TAGACACGT.CTCTCAGTC	TAGACACGT.CTCTCAGTC
TAGACACGT.GAGTGCATA	TAGACACGT.GAGTGCATA
TAGACACGT.TGTAGATCG	TAGACACGT.TGTAGATCG
TAGACCATG.CACACCACA	TAGACCATG.CACACCACA
TAGACCATG.GTGTATCTG	TAGACCATG.GTGTATCTG
TAGACCATG.GTTAGAGAC	TAGACCATG.GTTAGAGAC
TAGACCATG.TGTTGTCGA	TAGACCATG.TGTTGTCGA
TAGACCGCA.CGATTGAAC	TAGACCGCA.CGATTGAAC
TAGACCGCA.CGGTCGACA	TAGACCGCA.CGGTCGACA
TAGACCGCA.CTGATCCGA	TAGACCGCA.CTGATCCGA
TAGACCGCA.CTGTCTAGT	TAGACCGCA.CTGTCTAGT
TAGACCTAC.ACCGATCGA	TAGACCTAC.ACCGATCGA
TAGACCTAC.AGCTCGTCT	TAGACCTAC.AGCTCGTCT
TAGACCTAC.CCTAGTCTC	TAGACCTAC.CCTAGTCTC
TAGACCTAC.CGCACTGAA	TAGACCTAC.CGCACTGAA
TAGACCTAC.GCGTATAGG	TAGACCTAC.GCGTATAGG
TAGAGACTA.AGTACTACA	TAGAGACTA.AGTACTACA
TAGAGACTA.CAGTGCTGC	TAGAGACTA.CAGTGCTGC
TAGAGACTA.CATTCCGAG	TAGAGACTA.CATTCCGAG
TAGAGACTA.CCTAGTTAG	TAGAGACTA.CCTAGTTAG
TAGAGACTA.GGAGCATCT	TAGAGACTA.GGAGCATCT
TAGAGACTA.TACGACTTG	TAGAGACTA.TACGACTTG
TAGAGCCAG.ACAAGGTAC	TAGAGCCAG.ACAAGGTAC
TAGAGCCAG.ACTCTAGGA	TAGAGCCAG.ACTCTAGGA
TAGAGCCAG.ATGAGGTAT	TAGAGCCAG.ATGAGGTAT
TAGAGCGTC.ACCGAGACA	TAGAGCGTC.ACCGAGACA
TAGAGCGTC.ACGGTGTAC	TAGAGCGTC.ACGGTGTAC
TAGAGCGTC.TGCGTAATC	TAGAGCGTC.TGCGTAATC
TAGATAGCC.AAGGTCTGA	TAGATAGCC.AAGGTCTGA
TAGATAGCC.ACACGTTGC	TAGATAGCC.ACACGTTGC
TAGATAGCC.ACGACAGTC	TAGATAGCC.ACGACAGTC
TAGATAGCC.ATTCGAAGA	TAGATAGCC.ATTCGAAGA
TAGATAGCC.CACCTTCCT	TAGATAGCC.CACCTTCCT
TAGATAGCC.CCTTGCTTG	TAGATAGCC.CCTTGCTTG
TAGATAGCC.CGACCTGTA	TAGATAGCC.CGACCTGTA
TAGATAGCC.CTTCCGTGG	TAGATAGCC.CTTCCGTGG
TAGATAGCC.TAAGGTGAT	TAGATAGCC.TAAGGTGAT
TAGATCTGT.AACGGAGAT	TAGATCTGT.AACGGAGAT
TAGATCTGT.AGGATTACT	TAGATCTGT.AGGATTACT
TAGATCTGT.ATCATGTTC	TAGATCTGT.ATCATGTTC
TAGATCTGT.ATGTGACGA	TAGATCTGT.ATGTGACGA
TAGATCTGT.CCAGATCAC	TAGATCTGT.CCAGATCAC
TAGATCTGT.CCTCATAAC	TAGATCTGT.CCTCATAAC
TAGATCTGT.TTCTGCCGA	TAGATCTGT.TTCTGCCGA
TAGCACACG.ACAGGTATC	TAGCACACG.ACAGGTATC
TAGCACACG.CTAGTATAG	TAGCACACG.CTAGTATAG
TAGCACACG.TACTGATGA	TAGCACACG.TACTGATGA
TAGCACACG.TAGTGATCC	TAGCACACG.TAGTGATCC
TAGCACACG.TGCCTGGTT	TAGCACACG.TGCCTGGTT
TAGCACTAT.AAGACGAAG	TAGCACTAT.AAGACGAAG
TAGCACTAT.ACAGAGATG	TAGCACTAT.ACAGAGATG
TAGCACTAT.GTGTCTGGA	TAGCACTAT.GTGTCTGGA
TAGCACTAT.TCGCGTCAT	TAGCACTAT.TCGCGTCAT
TAGCACTAT.TGTGCAGTA	TAGCACTAT.TGTGCAGTA
TAGCAGAGT.CAGGTTGTC	TAGCAGAGT.CAGGTTGTC
TAGCAGAGT.GTCAATACA	TAGCAGAGT.GTCAATACA
TAGCAGAGT.TAGTCAGAC	TAGCAGAGT.TAGTCAGAC
TAGCCAGTG.AGACTTCGT	TAGCCAGTG.AGACTTCGT
TAGCCAGTG.ATACTTGCT	TAGCCAGTG.ATACTTGCT
TAGCCAGTG.CCGATCTCT	TAGCCAGTG.CCGATCTCT
TAGCCAGTG.GTAGCTACA	TAGCCAGTG.GTAGCTACA
TAGCCAGTG.GTCGTTAGA	TAGCCAGTG.GTCGTTAGA
TAGCCAGTG.TAGGAGGAT	TAGCCAGTG.TAGGAGGAT
TAGCCAGTG.TTCTGCCGA	TAGCCAGTG.TTCTGCCGA
TAGCCTTGT.AACGTTCTT	TAGCCTTGT.AACGTTCTT
TAGCCTTGT.AGCACCGTG	TAGCCTTGT.AGCACCGTG
TAGCCTTGT.ATGGACGTT	TAGCCTTGT.ATGGACGTT
TAGCCTTGT.GCTAGTGGA	TAGCCTTGT.GCTAGTGGA
TAGCCTTGT.TGTCTACAC	TAGCCTTGT.TGTCTACAC
TAGCGAGAA.ATCCACAGT	TAGCGAGAA.ATCCACAGT
TAGCGAGAA.CTTAAGTTG	TAGCGAGAA.CTTAAGTTG
TAGCGAGAA.TCGGAACGA	TAGCGAGAA.TCGGAACGA
TAGCGCAGC.AACAGATCG	TAGCGCAGC.AACAGATCG
TAGCGCAGC.AATGAGTCG	TAGCGCAGC.AATGAGTCG
TAGCGCAGC.ATGAGGTAT	TAGCGCAGC.ATGAGGTAT
TAGCGCAGC.TCACTACGT	TAGCGCAGC.TCACTACGT
TAGCGCAGC.TGAGCTAGA	TAGCGCAGC.TGAGCTAGA
TAGCGCAGC.TGGAAGATT	TAGCGCAGC.TGGAAGATT
TAGCTAAGA.ACAGTATTG	TAGCTAAGA.ACAGTATTG
TAGCTAAGA.AGAAGCTGC	TAGCTAAGA.AGAAGCTGC
TAGCTAAGA.ATGCAGTTC	TAGCTAAGA.ATGCAGTTC
TAGCTAAGA.GAGTTATAG	TAGCTAAGA.GAGTTATAG
TAGCTAAGA.TATTGCTAC	TAGCTAAGA.TATTGCTAC
TAGCTAAGA.TGATACCGT	TAGCTAAGA.TGATACCGT
TAGCTGTTG.ATATCCGAT	TAGCTGTTG.ATATCCGAT
TAGCTGTTG.ATCCATTAG	TAGCTGTTG.ATCCATTAG
TAGCTGTTG.CAAGGTGTG	TAGCTGTTG.CAAGGTGTG
TAGCTGTTG.CATGCCAGT	TAGCTGTTG.CATGCCAGT
TAGCTGTTG.GCAACACCT	TAGCTGTTG.GCAACACCT
TAGCTGTTG.TGTAGATCG	TAGCTGTTG.TGTAGATCG
TAGGAGCTA.AAGCACAAC	TAGGAGCTA.AAGCACAAC
TAGGAGCTA.CTGCAAGCC	TAGGAGCTA.CTGCAAGCC
TAGGAGCTA.GTTCACTCC	TAGGAGCTA.GTTCACTCC
TAGGAGCTA.TATGGTTGG	TAGGAGCTA.TATGGTTGG
TAGGAGGAT.AGAAGCTGC	TAGGAGGAT.AGAAGCTGC
TAGGAGGAT.CCTGCGTTA	TAGGAGGAT.CCTGCGTTA
TAGGAGGAT.CTCCAGCGT	TAGGAGGAT.CTCCAGCGT
TAGGAGGAT.CTTCGTGCA	TAGGAGGAT.CTTCGTGCA
TAGGAGGAT.GCTATGTAA	TAGGAGGAT.GCTATGTAA
TAGGATTAG.AATTAGAGG	TAGGATTAG.AATTAGAGG
TAGGATTAG.ACAGCGTAT	TAGGATTAG.ACAGCGTAT
TAGGATTAG.CCAGGAGTT	TAGGATTAG.CCAGGAGTT
TAGGATTAG.CCTATTGGT	TAGGATTAG.CCTATTGGT
TAGGATTAG.CTATGGATG	TAGGATTAG.CTATGGATG
TAGGATTAG.GGAACCTAG	TAGGATTAG.GGAACCTAG
TAGGATTAG.TATCTGTCA	TAGGATTAG.TATCTGTCA
TAGGTCAAC.ATGCCTGTC	TAGGTCAAC.ATGCCTGTC
TAGGTCAAC.CCGAAGCGT	TAGGTCAAC.CCGAAGCGT
TAGGTCAAC.CGTATAGCG	TAGGTCAAC.CGTATAGCG
TAGGTCAAC.GATTAGACA	TAGGTCAAC.GATTAGACA
TAGGTTAGT.AAGAGAACT	TAGGTTAGT.AAGAGAACT
TAGGTTAGT.CCTTCCTCA	TAGGTTAGT.CCTTCCTCA
TAGGTTAGT.CGCACTGAA	TAGGTTAGT.CGCACTGAA
TAGTAACGG.ACAGCGGTC	TAGTAACGG.ACAGCGGTC
TAGTAACGG.CACAATAAC	TAGTAACGG.CACAATAAC
TAGTAACGG.CACGCGTAA	TAGTAACGG.CACGCGTAA
TAGTAACGG.CTTGATCTA	TAGTAACGG.CTTGATCTA
TAGTAACGG.GATCTTCGC	TAGTAACGG.GATCTTCGC
TAGTAACGG.GCTTAGAAC	TAGTAACGG.GCTTAGAAC
TAGTAACGG.TATGATGTG	TAGTAACGG.TATGATGTG
TAGTACGTA.ACCTCCTAG	TAGTACGTA.ACCTCCTAG
TAGTACGTA.AGGTGTACA	TAGTACGTA.AGGTGTACA
TAGTACGTA.CAGGATCAA	TAGTACGTA.CAGGATCAA
TAGTACGTA.CATGGTCGA	TAGTACGTA.CATGGTCGA
TAGTACGTA.CATTCCGAG	TAGTACGTA.CATTCCGAG
TAGTACGTA.CGCATCTAC	TAGTACGTA.CGCATCTAC
TAGTACGTA.GCTGACAGA	TAGTACGTA.GCTGACAGA
TAGTACGTA.TCACCGAGG	TAGTACGTA.TCACCGAGG
TAGTACGTA.TCATGCAGG	TAGTACGTA.TCATGCAGG
TAGTAGTCT.ATCTGGTAG	TAGTAGTCT.ATCTGGTAG
TAGTAGTCT.CAAGAACCG	TAGTAGTCT.CAAGAACCG
TAGTAGTCT.CAGAGCACC	TAGTAGTCT.CAGAGCACC
TAGTAGTCT.CATGGTCGA	TAGTAGTCT.CATGGTCGA
TAGTAGTCT.CCGATCAGC	TAGTAGTCT.CCGATCAGC
TAGTAGTCT.CTCAGCTGG	TAGTAGTCT.CTCAGCTGG
TAGTAGTCT.GTAGCTACA	TAGTAGTCT.GTAGCTACA
TAGTAGTCT.TATCGAGCC	TAGTAGTCT.TATCGAGCC
TAGTCAGAC.AAGCTTGCA	TAGTCAGAC.AAGCTTGCA
TAGTCAGAC.AAGGTGCTG	TAGTCAGAC.AAGGTGCTG
TAGTCAGAC.CAGTCCTAA	TAGTCAGAC.CAGTCCTAA
TAGTCAGAC.CGCAACCTC	TAGTCAGAC.CGCAACCTC
TAGTCAGAC.GAGTCGTAC	TAGTCAGAC.GAGTCGTAC
TAGTCAGAC.GCTGACAGA	TAGTCAGAC.GCTGACAGA
TAGTCAGAC.TGTGGTCCT	TAGTCAGAC.TGTGGTCCT
TAGTCGCAT.AACGAGAAT	TAGTCGCAT.AACGAGAAT
TAGTCGCAT.AATAACTCC	TAGTCGCAT.AATAACTCC
TAGTCGCAT.GGAGCATCT	TAGTCGCAT.GGAGCATCT
TAGTGATCC.AGCCTCTAG	TAGTGATCC.AGCCTCTAG
TAGTGATCC.GGAACCTAG	TAGTGATCC.GGAACCTAG
TAGTGATCC.GTTGCTCAG	TAGTGATCC.GTTGCTCAG
TAGTGCACT.AAGCTTGCA	TAGTGCACT.AAGCTTGCA
TAGTGCACT.AAGTTGCCA	TAGTGCACT.AAGTTGCCA
TAGTGCACT.ACCAGCGTT	TAGTGCACT.ACCAGCGTT
TAGTGCACT.AGTATGACG	TAGTGCACT.AGTATGACG
TAGTGCACT.ATATGTCCA	TAGTGCACT.ATATGTCCA
TAGTGCACT.TAGAGACTA	TAGTGCACT.TAGAGACTA
TAGTGCACT.TGTCAACCT	TAGTGCACT.TGTCAACCT
TAGTTGACG.AAGCACAAC	TAGTTGACG.AAGCACAAC
TAGTTGACG.CCGACTGTT	TAGTTGACG.CCGACTGTT
TAGTTGACG.GCAGCTTGA	TAGTTGACG.GCAGCTTGA
TATAATCGC.ACGAGAGCA	TATAATCGC.ACGAGAGCA
TATAATCGC.ACTTCTAAC	TATAATCGC.ACTTCTAAC
TATAATCGC.AGGAGGTGA	TATAATCGC.AGGAGGTGA
TATAATCGC.CATAAGATC	TATAATCGC.CATAAGATC
TATAATCGC.CGCGCACAT	TATAATCGC.CGCGCACAT
TATAATCGC.GTTGACCAT	TATAATCGC.GTTGACCAT
TATAATCGC.TCGCTGATT	TATAATCGC.TCGCTGATT
TATACCACT.AAGGATACG	TATACCACT.AAGGATACG
TATACCACT.ACGACGATT	TATACCACT.ACGACGATT
TATACCACT.AGAAGTCCT	TATACCACT.AGAAGTCCT
TATACCACT.CGGTTGCGA	TATACCACT.CGGTTGCGA
TATACCACT.GAACGCTGT	TATACCACT.GAACGCTGT
TATACCACT.TCACCGAGG	TATACCACT.TCACCGAGG
TATACCACT.TGGATTAGC	TATACCACT.TGGATTAGC
TATACGGAT.AGGTATTCC	TATACGGAT.AGGTATTCC
TATACGGAT.ATCATAGAC	TATACGGAT.ATCATAGAC
TATACGGAT.GCGGAGATT	TATACGGAT.GCGGAGATT
TATACGGAT.TAGAGCGTC	TATACGGAT.TAGAGCGTC
TATACGGAT.TTGGACTTC	TATACGGAT.TTGGACTTC
TATACGTGG.ACACACCGT	TATACGTGG.ACACACCGT
TATACGTGG.ATAGAGCAG	TATACGTGG.ATAGAGCAG
TATACGTGG.CACATTCTG	TATACGTGG.CACATTCTG
TATACGTGG.CACGGATAG	TATACGTGG.CACGGATAG
TATACGTGG.GACGCTTGC	TATACGTGG.GACGCTTGC
TATACGTGG.GACTGCGCA	TATACGTGG.GACTGCGCA
TATACGTGG.GATAAGCTG	TATACGTGG.GATAAGCTG
TATACGTGG.GATCGTTGA	TATACGTGG.GATCGTTGA
TATACGTGG.GGTGCGTAG	TATACGTGG.GGTGCGTAG
TATACGTGG.TATTCAACG	TATACGTGG.TATTCAACG
TATACGTGG.TCTTGGTAG	TATACGTGG.TCTTGGTAG
TATAGTGCG.CCACGTTCT	TATAGTGCG.CCACGTTCT
TATAGTGCG.GGTTAACAG	TATAGTGCG.GGTTAACAG
TATAGTGCG.TTGTTAGAG	TATAGTGCG.TTGTTAGAG
TATCACCTG.CAGGTTGTC	TATCACCTG.CAGGTTGTC
TATCACCTG.TAGCAGAGT	TATCACCTG.TAGCAGAGT
TATCAGTGC.AACGATGAC	TATCAGTGC.AACGATGAC
TATCAGTGC.ACAAGTACA	TATCAGTGC.ACAAGTACA
TATCAGTGC.ATAGAGCAG	TATCAGTGC.ATAGAGCAG
TATCAGTGC.CAACCTGGT	TATCAGTGC.CAACCTGGT
TATCAGTGC.CCGCTATCC	TATCAGTGC.CCGCTATCC
TATCAGTGC.CCTAGTTAG	TATCAGTGC.CCTAGTTAG
TATCAGTGC.CTAGAGTCG	TATCAGTGC.CTAGAGTCG
TATCAGTGC.GACGTGGTC	TATCAGTGC.GACGTGGTC
TATCATGCT.AACCGTGAG	TATCATGCT.AACCGTGAG
TATCATGCT.CTGCAGAGC	TATCATGCT.CTGCAGAGC
TATCATGCT.GCCTTATCT	TATCATGCT.GCCTTATCT
TATCATGCT.TAACGTGTC	TATCATGCT.TAACGTGTC
TATCATGCT.TATTACTCG	TATCATGCT.TATTACTCG
TATCATGCT.TGTACACGA	TATCATGCT.TGTACACGA
TATCCTCAG.CACCTCAAC	TATCCTCAG.CACCTCAAC
TATCCTCAG.CAGCTGGAG	TATCCTCAG.CAGCTGGAG
TATCCTCAG.CCAATATAC	TATCCTCAG.CCAATATAC
TATCCTCAG.CCAGTTACG	TATCCTCAG.CCAGTTACG
TATCCTCAG.GACTAGCAT	TATCCTCAG.GACTAGCAT
TATCCTCAG.GCGTGATAC	TATCCTCAG.GCGTGATAC
TATCCTCAG.GTAGAGAGC	TATCCTCAG.GTAGAGAGC
TATCCTCAG.GTAGGACGC	TATCCTCAG.GTAGGACGC
TATCCTCAG.TGAGACAGC	TATCCTCAG.TGAGACAGC
TATCGAGCC.GAACTCGTA	TATCGAGCC.GAACTCGTA
TATCGAGCC.GGTTACGCA	TATCGAGCC.GGTTACGCA
TATCGAGCC.TTCACTGGA	TATCGAGCC.TTCACTGGA
TATCGGAAC.AGTAACGTA	TATCGGAAC.AGTAACGTA
TATCGGAAC.CAAGGTGTG	TATCGGAAC.CAAGGTGTG
TATCGGAAC.CCGTAGTTG	TATCGGAAC.CCGTAGTTG
TATCGGAAC.CGCGATGTA	TATCGGAAC.CGCGATGTA
TATCGGAAC.CGTGAGACT	TATCGGAAC.CGTGAGACT
TATCGGAAC.GGTTGCTAT	TATCGGAAC.GGTTGCTAT
TATCGGAAC.TCAGTGTTC	TATCGGAAC.TCAGTGTTC
TATCTAGGT.ATCCACAGT	TATCTAGGT.ATCCACAGT
TATCTAGGT.GACTTCACC	TATCTAGGT.GACTTCACC
TATCTAGGT.GTCTGAGCC	TATCTAGGT.GTCTGAGCC
TATCTAGGT.TACCATGTA	TATCTAGGT.TACCATGTA
TATCTAGGT.TGAGACAGC	TATCTAGGT.TGAGACAGC
TATCTAGGT.TTAGTCGGA	TATCTAGGT.TTAGTCGGA
TATCTGTCA.AGCTTGGTG	TATCTGTCA.AGCTTGGTG
TATCTGTCA.AGTGACGAT	TATCTGTCA.AGTGACGAT
TATCTGTCA.CATACAACC	TATCTGTCA.CATACAACC
TATCTGTCA.CGCTTCACG	TATCTGTCA.CGCTTCACG
TATCTGTCA.CTGTGGTGG	TATCTGTCA.CTGTGGTGG
TATGAAGAC.AATATCAGC	TATGAAGAC.AATATCAGC
TATGAAGAC.AATGCGTGC	TATGAAGAC.AATGCGTGC
TATGAAGAC.CTAGTGCTG	TATGAAGAC.CTAGTGCTG
TATGAAGAC.GCGAGTCTA	TATGAAGAC.GCGAGTCTA
TATGAAGAC.TGACAAGTT	TATGAAGAC.TGACAAGTT
TATGAAGAC.TTCGTGATG	TATGAAGAC.TTCGTGATG
TATGACCGA.ATACAACCG	TATGACCGA.ATACAACCG
TATGACCGA.GCTGGTTCG	TATGACCGA.GCTGGTTCG
TATGACCGA.GTATCGTCG	TATGACCGA.GTATCGTCG
TATGACCGA.TCAAGCGTA	TATGACCGA.TCAAGCGTA
TATGACCGA.TGACCTCCT	TATGACCGA.TGACCTCCT
TATGACCGA.TGATGACAG	TATGACCGA.TGATGACAG
TATGAGACC.AGGTGTACA	TATGAGACC.AGGTGTACA
TATGAGACC.AGTTATCGC	TATGAGACC.AGTTATCGC
TATGAGACC.ATCTGCGTA	TATGAGACC.ATCTGCGTA
TATGAGACC.ATGATAGCT	TATGAGACC.ATGATAGCT
TATGAGACC.CCTGACCTC	TATGAGACC.CCTGACCTC
TATGAGACC.CGTATAGCG	TATGAGACC.CGTATAGCG
TATGAGACC.GAAGGATCA	TATGAGACC.GAAGGATCA
TATGAGACC.TCTTGGTAG	TATGAGACC.TCTTGGTAG
TATGATGTG.ACCGCTGTG	TATGATGTG.ACCGCTGTG
TATGATGTG.ATCAAGCAT	TATGATGTG.ATCAAGCAT
TATGATGTG.ATTCTCTGG	TATGATGTG.ATTCTCTGG
TATGATGTG.CAAGTACGA	TATGATGTG.CAAGTACGA
TATGATGTG.TAACATTGG	TATGATGTG.TAACATTGG
TATGATGTG.TTCCGAGCG	TATGATGTG.TTCCGAGCG
TATGCCTTC.AACAACCTA	TATGCCTTC.AACAACCTA
TATGCCTTC.AGACTTCGT	TATGCCTTC.AGACTTCGT
TATGCCTTC.CCACTTCGC	TATGCCTTC.CCACTTCGC
TATGCCTTC.CTAACTAAG	TATGCCTTC.CTAACTAAG
TATGCCTTC.CTGAGTAGC	TATGCCTTC.CTGAGTAGC
TATGCCTTC.GATTCTCGG	TATGCCTTC.GATTCTCGG
TATGCCTTC.GTGACTCTC	TATGCCTTC.GTGACTCTC
TATGCCTTC.TGATAGAGG	TATGCCTTC.TGATAGAGG
TATGCCTTC.TGGAGAACC	TATGCCTTC.TGGAGAACC
TATGCCTTC.TGTTACTGA	TATGCCTTC.TGTTACTGA
TATGGTTGG.TACCTCCTC	TATGGTTGG.TACCTCCTC
TATGGTTGG.TTCCTCGGT	TATGGTTGG.TTCCTCGGT
TATGTACCT.ACCGGAAGG	TATGTACCT.ACCGGAAGG
TATGTACCT.CTAGTATAG	TATGTACCT.CTAGTATAG
TATGTACCT.GTAGGACGC	TATGTACCT.GTAGGACGC
TATGTACCT.GTGACGTAA	TATGTACCT.GTGACGTAA
TATGTACCT.TGATGTGTG	TATGTACCT.TGATGTGTG
TATGTATGC.GCAATCACG	TATGTATGC.GCAATCACG
TATGTATGC.TTCATTCGC	TATGTATGC.TTCATTCGC
TATTACAGC.AATATCAGC	TATTACAGC.AATATCAGC
TATTACAGC.AGCTCGTCT	TATTACAGC.AGCTCGTCT
TATTACAGC.ATTAGCCAC	TATTACAGC.ATTAGCCAC
TATTACAGC.CCGATCTCT	TATTACAGC.CCGATCTCT
TATTACAGC.CCTAGCAAT	TATTACAGC.CCTAGCAAT
TATTACAGC.GAGATACAC	TATTACAGC.GAGATACAC
TATTACAGC.GCCAACAAT	TATTACAGC.GCCAACAAT
TATTACAGC.GCGTTCAGA	TATTACAGC.GCGTTCAGA
TATTACAGC.GTGGACTGG	TATTACAGC.GTGGACTGG
TATTACAGC.TCGACGTTG	TATTACAGC.TCGACGTTG
TATTACAGC.TGAACGGTT	TATTACAGC.TGAACGGTT
TATTACAGC.TTAGTCGGA	TATTACAGC.TTAGTCGGA
TATTACTCG.CCTCGACCT	TATTACTCG.CCTCGACCT
TATTACTCG.CTCGAACTG	TATTACTCG.CTCGAACTG
TATTACTCG.GCTGAGCAG	TATTACTCG.GCTGAGCAG
TATTACTCG.GTCACAGAG	TATTACTCG.GTCACAGAG
TATTCAACG.AGTCATACT	TATTCAACG.AGTCATACT
TATTCAACG.CAGGTTGTC	TATTCAACG.CAGGTTGTC
TATTCAACG.CGCTTGTAG	TATTCAACG.CGCTTGTAG
TATTCAACG.GCCAATGAA	TATTCAACG.GCCAATGAA
TATTCAACG.GTGTTGGAA	TATTCAACG.GTGTTGGAA
TATTGACTG.CCACGTTCT	TATTGACTG.CCACGTTCT
TATTGACTG.CTAGGTACT	TATTGACTG.CTAGGTACT
TATTGACTG.TAAGTACAC	TATTGACTG.TAAGTACAC
TATTGACTG.TCACGCGAC	TATTGACTG.TCACGCGAC
TATTGACTG.TTACGGACC	TATTGACTG.TTACGGACC
TATTGACTG.TTACTTACG	TATTGACTG.TTACTTACG
TATTGCTAC.CGCATAACT	TATTGCTAC.CGCATAACT
TATTGCTAC.GGACACTGG	TATTGCTAC.GGACACTGG
TATTGCTAC.GGAGTACAG	TATTGCTAC.GGAGTACAG
TCAACACTC.AGCGGTCTA	TCAACACTC.AGCGGTCTA
TCAACACTC.CAGCTTACC	TCAACACTC.CAGCTTACC
TCAACACTC.CGCGATGTA	TCAACACTC.CGCGATGTA
TCAAGCGTA.CTCAGTGAT	TCAAGCGTA.CTCAGTGAT
TCAAGCGTA.CTCCAGCGT	TCAAGCGTA.CTCCAGCGT
TCAAGCGTA.GCGCTCTAT	TCAAGCGTA.GCGCTCTAT
TCAAGCGTA.GTACAATGC	TCAAGCGTA.GTACAATGC
TCAAGCGTA.TGCACGATG	TCAAGCGTA.TGCACGATG
TCAAGCGTA.TTATTCGAC	TCAAGCGTA.TTATTCGAC
TCAAGGAGT.ACCTGCAGA	TCAAGGAGT.ACCTGCAGA
TCAAGGAGT.TCACGCGAC	TCAAGGAGT.TCACGCGAC
TCAAGGAGT.TCCAAGTAA	TCAAGGAGT.TCCAAGTAA
TCAAGGTCG.ATAGCTTGC	TCAAGGTCG.ATAGCTTGC
TCAAGGTCG.CCTAGCAAT	TCAAGGTCG.CCTAGCAAT
TCAAGGTCG.CCTCGCGTT	TCAAGGTCG.CCTCGCGTT
TCAAGGTCG.GCGACACAG	TCAAGGTCG.GCGACACAG
TCAAGGTCG.TCGTCCGAT	TCAAGGTCG.TCGTCCGAT
TCAATCTAG.AATAGACGC	TCAATCTAG.AATAGACGC
TCAATCTAG.CCAGTACTC	TCAATCTAG.CCAGTACTC
TCAATCTAG.CTTAATCGT	TCAATCTAG.CTTAATCGT
TCAATCTAG.GAGTCGTAC	TCAATCTAG.GAGTCGTAC
TCAATCTAG.GGAAGAAGC	TCAATCTAG.GGAAGAAGC
TCAATGGAC.CAATACCAC	TCAATGGAC.CAATACCAC
TCAATGGAC.CACACTGCC	TCAATGGAC.CACACTGCC
TCAATGGAC.CGTCTGTCC	TCAATGGAC.CGTCTGTCC
TCAATGGAC.GAGCTCTCA	TCAATGGAC.GAGCTCTCA
TCAATGGAC.GATGTTACA	TCAATGGAC.GATGTTACA
TCAATGGAC.GCGTGAGCT	TCAATGGAC.GCGTGAGCT
TCAATGGAC.GCTGACAGA	TCAATGGAC.GCTGACAGA
TCAATGGAC.TGTCTACAC	TCAATGGAC.TGTCTACAC
TCACACTGC.ACAGCATCA	TCACACTGC.ACAGCATCA
TCACACTGC.AGCAAGTCC	TCACACTGC.AGCAAGTCC
TCACACTGC.TATTGCTAC	TCACACTGC.TATTGCTAC
TCACACTGC.TCATGCAGG	TCACACTGC.TCATGCAGG
TCACACTGC.TGGAATCGT	TCACACTGC.TGGAATCGT
TCACAGGTA.ACCGGAAGG	TCACAGGTA.ACCGGAAGG
TCACAGGTA.ATACTTGCT	TCACAGGTA.ATACTTGCT
TCACAGGTA.CTAATACGC	TCACAGGTA.CTAATACGC
TCACAGGTA.TAATGTAGC	TCACAGGTA.TAATGTAGC
TCACAGGTA.TACCGCGTT	TCACAGGTA.TACCGCGTT
TCACATACT.AACGGTAGC	TCACATACT.AACGGTAGC
TCACATACT.ATAGTCTCC	TCACATACT.ATAGTCTCC
TCACATACT.ATTCGAAGA	TCACATACT.ATTCGAAGA
